"report_date","previous_day_total_doses_administered","previous_day_at_least_one","previous_day_fully_vaccinated","previous_day_3doses","total_doses_administered","total_individuals_at_least_one","total_individuals_partially_vaccinated","total_doses_in_fully_vaccinated_individuals","total_individuals_fully_vaccinated","total_individuals_3doses"
2021-01-01,6252,6242,2,,32213,32158,32147,22,11,
2021-01-02,4616,4604,6,,36829,36710,36697,26,13,
2021-01-03,5396,5389,3,,42225,42099,42083,32,16,
2021-01-04,5996,5993,0,,48221,48091,48076,30,15,
2021-01-05,9687,9662,21,,57908,57751,57716,70,35,
2021-01-06,12793,12328,450,,70701,70076,69594,964,482,
2021-01-07,16219,15508,697,,86920,85583,84404,2358,1179,
2021-01-08,18039,17024,1002,,104959,102607,100426,4362,2181,
2021-01-09,19502,18425,1064,,124461,121031,117786,6490,3245,
2021-01-10,11373,11332,39,,135834,132355,129071,6568,3284,
2021-01-11,11712,11661,48,,147546,144016,140684,6664,3332,
2021-01-12,14469,14162,298,,162015,158170,154540,7260,3630,
2021-01-13,15438,13814,1594,,177453,171970,166748,10444,5222,
2021-01-14,19193,16740,2437,,196646,188704,181046,15316,7658,
2021-01-15,20077,18019,2038,,216723,206712,197016,19392,9696,
2021-01-16,17121,15937,1171,,233844,222633,211766,21734,10867,
2021-01-17,11261,10017,1237,,245105,232635,220533,24204,12102,
2021-01-18,6795,6712,73,,251900,239324,227152,24344,12172,
2021-01-19,11830,9721,2095,,263730,249024,234757,28534,14267,
2021-01-20,10804,7215,3572,,274534,256216,238378,35676,17838,
2021-01-21,10977,6856,4093,,285511,263056,241125,43862,21931,
2021-01-22,9039,4322,4697,,294550,267341,240715,53252,26626,
2021-01-23,7462,3044,4390,,302012,270355,239340,62030,31015,
2021-01-24,4390,1833,2536,,306402,272170,238619,67102,33551,
2021-01-25,5323,1049,4265,,311725,273187,235372,75630,37815,
2021-01-26,9394,2867,6499,,321119,276022,231709,88626,44313,
2021-01-27,9898,2866,7004,,331017,278859,227543,102632,51316,
2021-01-28,13122,5744,7336,,344139,284570,225918,117304,58652,
2021-01-29,10708,3293,7379,,354847,287832,221802,132060,66030,
2021-01-30,9192,2731,6424,,364039,290521,218070,144902,72451,
2021-01-31,3384,1570,1768,,367423,292057,217839,148436,74218,
2021-02-01,2126,489,1609,,369549,292512,216689,151646,75823,
2021-02-02,4420,1367,2996,,373969,293841,215026,157630,78815,
2021-02-03,6239,1719,4458,,380208,295519,212253,166532,83266,
2021-02-04,9095,1723,7293,,389303,297199,206646,181106,90553,
2021-02-05,8447,1469,6904,,397750,298628,201177,194902,97451,
2021-02-06,10670,1872,8737,,408420,300445,194266,212358,106179,
2021-02-07,7578,1730,5796,,415998,302135,190172,223926,111963,
2021-02-08,8221,3096,5081,,424219,305183,188152,234062,117031,
2021-02-09,15011,3860,11083,,439230,309001,180903,256196,128098,
2021-02-10,15514,4935,10518,,454744,313884,175293,277182,138591,
2021-02-11,16366,3899,12409,,471110,317731,166762,301938,150969,
2021-02-12,17678,2099,15528,,488788,319791,153314,332954,166477,
2021-02-13,16214,2446,13752,,505002,322192,141982,360420,180210,
2021-02-14,12883,924,11926,,517885,323068,130962,384212,192106,
2021-02-15,7862,486,7328,,525747,323506,124098,398816,199408,
2021-02-16,5995,1042,4903,,531742,324505,120217,408576,204288,
2021-02-17,10169,1610,8525,,541911,326071,113286,425570,212785,
2021-02-18,13874,2957,10873,,555785,328980,105352,447256,223628,
2021-02-19,18490,6213,12210,,574275,335141,99334,471614,235807,
2021-02-20,22632,11135,11444,,596907,346213,99000,494426,247213,
2021-02-21,17243,10386,6823,,614150,356539,102545,507988,253994,
2021-02-22,13589,8759,4777,,627739,365229,106507,517444,258722,
2021-02-23,17869,11126,6672,,645608,376299,110941,530716,265358,
2021-02-24,18578,13613,4884,,664186,389856,119656,540400,270200,
2021-02-25,20811,16490,4264,,684997,406280,131864,548832,274416,
2021-02-26,24912,21841,3009,,709909,428061,150673,554776,277388,
2021-02-27,27469,23586,3840,,737378,451583,170403,562360,281180,
2021-02-28,20587,19146,1406,,757965,470675,188131,565088,282544,
2021-03-01,18227,17030,1148,,776192,487643,203998,567290,283645,
2021-03-02,24693,22281,2327,,800885,509863,223937,571852,285926,
2021-03-03,30602,27966,2579,,831487,537778,249306,576944,288472,
2021-03-04,34699,32465,2147,,866186,570177,279608,581138,290569,
2021-03-05,40008,38173,1786,,906194,608302,315981,584642,292321,
2021-03-06,44159,41950,2171,,950353,650197,355746,588902,294451,
2021-03-07,32738,31559,1175,,983091,681682,386114,591136,295568,
2021-03-08,24040,22164,1861,,1007131,703778,406403,594750,297375,
2021-03-09,33299,29848,3423,,1040430,733560,432808,601504,300752,
2021-03-10,38347,34084,4218,,1078777,767570,462648,609844,304922,
2021-03-11,43985,40712,3234,,1122762,808216,500112,616208,308104,
2021-03-12,47717,46005,1689,,1170479,854157,544414,619486,309743,
2021-03-13,57937,55060,2850,,1228416,909146,596607,625078,312539,
2021-03-14,43422,42182,1222,,1271838,951245,637552,627386,313693,
2021-03-15,32814,31116,1682,,1304652,982302,666970,630664,315332,
2021-03-16,53963,51664,2282,,1358615,1033901,716330,635142,317571,
2021-03-17,61071,58530,2497,,1419686,1092365,772347,640036,320018,
2021-03-18,61559,59095,2436,,1481245,1151388,828987,644802,322401,
2021-03-19,64483,61151,3274,,1545728,1212461,886839,651244,325622,
2021-03-20,62578,59986,2560,,1608306,1272391,944257,656268,328134,
2021-03-21,44007,42480,1540,,1652313,1314806,985169,659274,329637,
2021-03-22,31002,30035,978,,1683315,1344753,1014194,661118,330559,
2021-03-23,54626,51852,2723,,1737941,1396510,1063291,666438,333219,
2021-03-24,76438,73256,3134,,1814379,1469676,1133380,672592,336296,
2021-03-25,82919,80338,2534,,1897298,1549935,1211162,677546,338773,
2021-03-26,87020,83490,3490,,1984318,1633344,1291133,684422,342211,
2021-03-27,80866,77912,2868,,2065184,1711153,1366139,690028,345014,
2021-03-28,67002,65412,1555,,2132186,1776475,1429963,693024,346512,
2021-03-29,51741,49050,2652,,2183927,1825445,1476327,698236,349118,
2021-03-30,73588,70176,3350,,2257515,1895544,1543117,704854,352427,
2021-03-31,93159,89507,3586,,2350674,1984953,1628993,711920,355960,
2021-04-01,89322,85443,3840,,2439996,2070298,1710551,719494,359747,
2021-04-02,93096,88865,4213,,2533092,2159077,1795169,727816,363908,
2021-04-03,61012,59333,1735,,2594104,2218319,1852727,731184,365592,
2021-04-04,72333,70677,1651,,2666437,2288885,1921700,734370,367185,
2021-04-05,53733,53262,470,,2720170,2342063,1974456,735214,367607,
2021-04-06,79591,77718,1889,,2799761,2419679,2050237,738884,369442,
2021-04-07,108016,104947,3056,,2907777,2524501,2152061,744880,372440,
2021-04-08,114085,110110,4028,,3021862,2634500,2258088,752824,376412,
2021-04-09,109858,105626,4303,,3131720,2740008,2359358,761300,380650,
2021-04-10,109253,105489,3854,,3240973,2845369,2460931,768876,384438,
2021-04-11,98633,95514,3259,,3339606,2940758,2553120,775276,387638,
2021-04-12,76075,75010,1158,,3415681,3015620,2626892,777456,388728,
2021-04-13,99480,96095,3402,,3515161,3111606,2719524,784164,392082,
2021-04-14,117052,113288,3649,,3632213,3224776,2829085,791382,395691,
2021-04-15,113568,109508,3898,,3745781,3334158,2934626,799064,399532,
2021-04-16,118091,113717,4194,,3863872,3447765,3044083,807364,403682,
2021-04-17,112428,107834,4454,,3976300,3555465,3147388,816154,408077,
2021-04-18,88750,86512,2102,,4065050,3641854,3231729,820250,410125,
2021-04-19,68976,67441,1453,,4134026,3709165,3297638,823054,411527,
2021-04-20,102121,98794,3121,,4236147,3807797,3393214,829166,414583,
2021-04-21,142054,137773,4045,,4378201,3945396,3526836,837120,418560,
2021-04-22,139508,135352,3914,,4517709,4080619,3658201,844836,422418,
2021-04-23,138226,131802,6176,,4655935,4212267,3783731,857072,428536,
2021-04-24,130302,126236,3891,,4786237,4338355,3905984,864742,432371,
2021-04-25,102024,98612,3180,,4888261,4436819,4001335,870968,435484,
2021-04-26,71008,69302,1558,,4959269,4505990,4069008,873964,436982,
2021-04-27,98520,95426,2900,,5057789,4601255,4161436,879638,439819,
2021-04-28,120587,115957,4437,,5178376,4717044,4272860,888368,444184,
2021-04-29,124496,119295,5050,,5302872,4836172,4387007,898330,449165,
2021-04-30,115835,110578,5015,,5418707,4946577,4492474,908206,454103,
2021-05-01,111315,107438,3654,,5530022,5053834,4596154,915360,457680,
2021-05-02,79149,76172,2864,,5609171,5129849,4669371,920956,460478,
2021-05-03,56796,55124,1599,,5665967,5184818,4722801,924034,462017,
2021-05-04,91940,88567,3285,,5757907,5273207,4807982,930450,465225,
2021-05-05,138010,133298,4620,,5895917,5406336,4936554,939564,469782,
2021-05-06,141843,136886,4819,,6037760,5543038,5068499,949078,474539,
2021-05-07,150297,145253,4839,,6188057,5688131,5208812,958638,479319,
2021-05-08,142475,137783,4440,,6330532,5825719,5342039,967360,483680,
2021-05-09,124820,121165,3484,,6455352,5946720,5459620,974200,487100,
2021-05-10,97817,95827,1885,,6553169,6042358,5553440,977836,488918,
2021-05-11,113547,108862,4497,,6666716,6151018,5657674,986688,493344,
2021-05-12,145062,138026,6886,,6811778,6288865,5788701,1000328,500164,
2021-05-13,142717,135323,7238,,6954495,6424013,5916685,1014656,507328,
2021-05-14,148878,138785,9922,,7103373,6562610,6045425,1034370,517185,
2021-05-15,159752,149701,9870,,7263125,6712124,6185144,1053960,526980,
2021-05-16,144369,136098,8064,,7407494,6848054,6313090,1069928,534964,
2021-05-17,114985,110887,3944,,7522479,6958752,6419920,1077664,538832,
2021-05-18,111354,100486,10665,,7633833,7059042,6509607,1098870,549435,
2021-05-19,149892,133475,16238,,7783725,7192365,6626766,1131198,565599,
2021-05-20,151583,131584,19778,,7935308,7323760,6738452,1170616,585308,
2021-05-21,165407,140897,24250,,8100715,7464476,6854995,1218962,609481,
2021-05-22,199460,172257,26975,,8300175,7636535,7000160,1272750,636375,
2021-05-23,139845,127472,12227,,8440020,7763829,7115289,1297080,648540,
2021-05-24,100302,93330,6827,,8540322,7856986,7201689,1310594,655297,
2021-05-25,90482,82994,7277,,8630804,7939817,7277310,1325014,662507,
2021-05-26,139797,113026,26507,,8770601,8052656,7363712,1377888,688944,
2021-05-27,152073,123053,28768,,8922674,8175552,7457909,1435286,717643,
2021-05-28,163881,132322,31250,,9086555,8307701,7558867,1497668,748834,
2021-05-29,153401,117138,36030,,9239956,8424689,7639881,1569616,784808,
2021-05-30,149733,119026,30479,,9389689,8543545,7728320,1630450,815225,
2021-05-31,99222,79827,19202,,9488911,8623202,7788839,1668726,834363,
2021-06-01,124217,90627,33251,,9613128,8713634,7846095,1735078,867539,
2021-06-02,145334,102164,42917,,9758462,8815617,7905230,1820774,910387,
2021-06-03,155388,99929,55178,,9913850,8915361,7949867,1930988,965494,
2021-06-04,181736,115548,65915,,10095586,9030710,7999389,2062642,1031321,
2021-06-05,172050,103448,68318,,10267636,9133960,8034406,2199108,1099554,
2021-06-06,163404,91877,71246,,10431040,9225659,8054929,2341460,1170730,
2021-06-07,119571,63063,56290,,10550611,9288525,8061580,2453890,1226945,
2021-06-08,161909,72464,89005,,10712520,9360800,8044930,2631740,1315870,
2021-06-09,181478,70816,110191,,10893998,9431439,8005459,2851960,1425980,
2021-06-10,185601,66436,118672,,11079599,9497672,7953111,3089122,1544561,
2021-06-11,204808,67528,136517,,11284407,9565014,7884018,3361992,1680996,
2021-06-12,199756,62688,136465,,11484163,9627520,7810151,3634738,1817369,
2021-06-13,190356,58902,130920,,11674519,9686247,7738038,3896418,1948209,
2021-06-14,137696,38701,98595,,11812215,9724752,7678053,4093398,2046699,
2021-06-15,189569,42624,146586,,12001784,9767157,7573969,4386376,2193188,
2021-06-16,206274,42442,163184,,12208058,9809403,7453134,4712538,2356269,
2021-06-17,210491,37952,171953,,12418549,9847140,7319010,5056260,2528130,
2021-06-18,217220,35375,181240,,12635769,9882325,7173047,5418556,2709278,
2021-06-19,215911,35507,179726,,12851680,9917626,7028734,5777784,2888892,
2021-06-20,186292,35582,150132,,13037972,9953010,6914094,6077832,3038916,
2021-06-21,120443,20835,99103,,13158415,9973650,6835723,6275854,3137927,
2021-06-22,204958,27531,176668,,13363373,10000987,6686501,6628972,3314486,
2021-06-23,230556,28641,201166,,13593929,10029428,6513884,7031088,3515544,
2021-06-24,227724,26686,200273,,13821653,10055918,6340211,7431414,3715707,
2021-06-25,251143,28005,222386,,14072796,10083721,6145747,7875948,3937974,
2021-06-26,261326,30021,230596,,14334122,10113516,5945087,8336858,4168429,
2021-06-27,205022,27805,176609,,14539144,10141139,5796211,8689856,4344928,
2021-06-28,199264,20958,177737,,14738408,10161899,5639359,9045080,4522540,
2021-06-29,250125,24498,224890,,14988533,10186156,5438880,9494552,4747276,
2021-06-30,275557,24182,250806,,15264090,10210135,5212182,9995906,4997953,
2021-07-01,271984,25315,246113,,15536074,10235232,4991305,10487854,5243927,
2021-07-02,144741,11596,132913,,15680815,10246654,4869916,10753476,5376738,
2021-07-03,216911,19938,196742,,15897726,10266370,4693039,11146662,5573331,
2021-07-04,196234,19468,176539,,16093960,10285652,4535901,11499502,5749751,
2021-07-05,148729,12449,136136,,16242689,10297911,4412152,11771518,5885759,
2021-07-06,220050,20003,199829,,16462739,10317698,4232256,12170884,6085442,
2021-07-07,246629,22975,223410,,16709368,10340447,4031743,12617408,6308704,
2021-07-08,231232,21371,209645,,16940600,10361612,3843398,13036428,6518214,
2021-07-09,227018,21517,205330,,17167618,10382927,3659515,13446824,6723412,
2021-07-10,209075,20543,188375,,17376693,10403266,3491616,13823300,6911650,
2021-07-11,171690,17589,153973,,17548383,10420654,3355178,14130952,7065476,
2021-07-12,123139,11445,111593,,17671522,10431910,3254978,14353864,7176932,
2021-07-13,178529,19044,159341,,17850051,10450732,3114614,14672236,7336118,
2021-07-14,180049,19308,160583,,18030100,10469825,2973287,14993076,7496538,
2021-07-15,167220,19594,147450,,18197320,10489208,2845384,15287648,7643824,
2021-07-16,169380,19923,149305,,18366700,10508929,2715953,15585952,7792976,
2021-07-17,173033,20278,152624,,18539733,10528958,2583550,15890816,7945408,
2021-07-18,133650,15944,117567,,18673383,10544718,2481891,16125654,8062827,
2021-07-19,91992,10422,81462,,18765375,10554927,2410813,16288228,8144114,
2021-07-20,133553,16961,116537,,18898928,10571648,2311173,16520950,8260475,
2021-07-21,140091,16988,123033,,19039019,10588421,2205075,16766692,8383346,
2021-07-22,125647,17665,107843,,19164666,10605862,2114850,16982024,8491012,
2021-07-23,120287,16999,103080,,19284953,10622620,2028727,17187786,8593893,
2021-07-24,126709,18338,108133,,19411662,10640755,1938892,17403726,8701863,
2021-07-25,103657,14871,88655,,19515319,10655402,1865065,17580674,8790337,
2021-07-26,66699,9892,56712,,19582018,10665077,1818208,17693738,8846869,
2021-07-27,92400,15325,76913,,19674418,10680141,1756576,17847130,8923565,
2021-07-28,93960,16477,77412,,19768378,10696383,1695597,18001572,9000786,
2021-07-29,89412,16709,72540,,19857790,10712860,1639722,18146276,9073138,
2021-07-30,84079,16108,67856,,19941869,10728740,1587934,18281612,9140806,
2021-07-31,83881,15740,67994,,20025750,10744262,1535652,18417220,9208610,
2021-08-01,61884,11325,50373,,20087634,10755361,1496569,18517584,9258792,
2021-08-02,42501,7424,34956,,20130135,10762587,1469005,18587164,9293582,
2021-08-03,33309,5963,27173,,20163444,10768317,1447772,18641090,9320545,
2021-08-04,61335,12381,48763,,20224779,10780463,1411353,18738220,9369110,
2021-08-05,59471,12559,46760,,20284250,10792814,1377108,18831412,9415706,
2021-08-06,56036,11861,43960,,20340286,10804415,1344978,18918874,9459437,
2021-08-07,62385,12137,50053,,20402671,10816291,1307019,19018544,9509272,
2021-08-08,48710,9282,39236,,20451381,10825345,1277042,19096606,9548303,
2021-08-09,30866,5941,24747,,20482247,10831072,1258209,19145726,9572863,
2021-08-10,49278,10519,38455,,20531525,10841311,1230239,19222144,9611072,
2021-08-11,48733,10769,37713,,20580258,10851833,1203264,19297138,9648569,
2021-08-12,49270,11211,37825,,20629528,10862793,1176608,19372370,9686185,
2021-08-13,49647,11740,37632,,20679175,10874292,1150686,19447212,9723606,
2021-08-14,51233,12139,38882,,20730408,10886181,1123917,19524528,9762264,
2021-08-15,41784,9860,31697,,20772192,10895839,1102050,19587578,9793789,
2021-08-16,26747,6190,20407,,20798939,10901806,1087807,19627998,9813999,
2021-08-17,40519,11065,29185,,20839458,10912621,1069663,19685916,9842958,
2021-08-18,41909,11978,29688,,20881367,10924357,1051921,19744872,9872436,
2021-08-19,45911,16543,29103,,20927278,10940649,1039333,19802632,9901316,
2021-08-20,46467,16304,29750,,20973745,10956697,1025860,19861674,9930837,
2021-08-21,47968,15154,32447,,21021713,10971591,1008534,19926114,9963057,
2021-08-22,34409,10813,23323,,21056122,10982157,996000,19972314,9986157,
2021-08-23,23228,7008,16001,,21079350,10988930,986986,20003888,10001944,
2021-08-24,37657,13376,23824,,21117007,11002052,976515,20051074,10025537,
2021-08-25,41369,14427,26331,,21158376,11016223,964592,20103262,10051631,
2021-08-26,39285,13558,24982,,21197661,11029505,953133,20152744,10076372,
2021-08-27,37685,12949,23690,,21235346,11042213,942365,20199696,10099848,
2021-08-28,40138,13428,25530,,21275484,11055362,930239,20250246,10125123,
2021-08-29,30566,10257,19947,,21306050,11065387,920530,20289714,10144857,
2021-08-30,18244,6144,11848,,21324294,11071283,914797,20312972,10156486,
2021-08-31,32720,11940,19625,,21357014,11082955,907084,20351742,10175871,
2021-09-01,36263,12955,21962,,21393277,11095677,898061,20395232,10197616,
2021-09-02,37795,15651,19676,,21431072,11111076,894011,20434130,10217065,
2021-09-03,46902,21102,22448,,21477974,11131929,892646,20478566,10239283,
2021-09-04,46893,20592,24784,,21524867,11152275,888431,20527688,10263844,
2021-09-05,33091,14210,18586,,21557958,11166241,884035,20564412,10282206,
2021-09-06,21725,9493,12040,,21579683,11175485,881471,20588028,10294014,
2021-09-07,15021,6733,8102,,21594704,11181961,880085,20603752,10301876,
2021-09-08,41156,17117,20939,,21635860,11198814,876245,20645138,10322569,
2021-09-09,41472,16990,19684,,21677332,11215527,873526,20684002,10342001,
2021-09-10,39668,15516,19017,,21717000,11230780,870007,20721546,10360773,
2021-09-11,42393,15940,23342,,21759393,11246441,862584,20767714,10383857,
2021-09-12,29982,11537,17876,,21789375,11257684,856215,20802938,10401469,
2021-09-13,16097,6408,9188,,21805472,11263858,853420,20820876,10410438,
2021-09-14,29921,11566,15298,,21835393,11275122,849661,20850922,10425461,
2021-09-15,39287,14025,19427,,21874680,11288887,844243,20889288,10444644,
2021-09-16,39357,13991,19250,,21914037,11302643,838961,20927364,10463682,
2021-09-17,38941,13615,19345,,21952978,11316015,833219,20965592,10482796,
2021-09-18,41268,14091,23553,,21994246,11329833,823736,21012194,10506097,
2021-09-19,30670,10830,18988,,22024916,11340404,815565,21049678,10524839,
2021-09-20,16737,6100,10179,,22041653,11346250,811463,21069574,10534787,
2021-09-21,31370,11218,16996,,22073023,11357203,805669,21103068,10551534,
2021-09-22,41822,14820,22931,,22114845,11371727,797537,21148380,10574190,
2021-09-23,47236,16139,26035,,22162081,11387601,787622,21199958,10599979,
2021-09-24,46331,15640,26667,,22208412,11402981,776576,21252810,10626405,
2021-09-25,48208,15258,29955,,22256620,11417986,761860,21312252,10656126,
2021-09-26,37518,12425,24498,,22294138,11430136,749766,21360740,10680370,
2021-09-27,19165,6532,12326,,22313303,11436414,743956,21384916,10692458,
2021-09-28,30970,11295,17891,,22344273,11447450,737348,21420204,10710102,
2021-09-29,37897,12477,21734,,22382170,11459656,728071,21463170,10731585,
2021-09-30,37356,11658,21381,,22419526,11471055,718329,21505452,10752726,
2021-10-01,30888,9811,18419,,22450414,11480639,709708,21541862,10770931,
2021-10-02,37147,11160,23592,,22487561,11491529,697258,21588542,10794271,
2021-10-03,27211,8167,18325,,22514772,11499455,687087,21624736,10812368,
2021-10-04,14870,4748,9803,,22529642,11503956,682014,21643884,10821942,
2021-10-05,26851,8601,15888,,22556493,11512296,674712,21675168,10837584,
2021-10-06,31680,9642,18522,,22588173,11521679,665824,21711710,10855855,
2021-10-07,30359,9402,17124,,22618532,11530830,658089,21745482,10872741,
2021-10-08,32850,10745,18859,,22651382,11541304,649961,21782686,10891343,
2021-10-09,34156,10668,21026,,22685538,11551709,639589,21824240,10912120,
2021-10-10,23422,7662,15091,,22708960,11559120,632148,21853944,10926972,
2021-10-11,12006,3839,7868,,22720966,11562709,628103,21869212,10934606,
2021-10-12,5125,1631,3276,,22726091,11564062,626443,21875238,10937619,
2021-10-13,29123,9193,18099,,22755214,11572965,617521,21910888,10955444,
2021-10-14,29024,8905,17754,,22784238,11581594,608662,21945864,10972932,
2021-10-15,29109,8833,18175,,22813347,11590164,599307,21981714,10990857,
2021-10-16,31144,8988,19873,,22844491,11598861,588410,22020902,11010451,
2021-10-17,23723,7264,15386,,22868214,11605871,580275,22051192,11025596,
2021-10-18,12311,3747,8151,,22880525,11609337,575859,22066956,11033478,
2021-10-19,21288,6631,12644,,22901813,11615685,569833,22091704,11045852,
2021-10-20,25678,7541,14928,,22927491,11622979,562433,22121092,11060546,
2021-10-21,23187,6684,13037,,22950678,11629394,556069,22146650,11073325,
2021-10-22,26137,7319,15122,,22976815,11636390,548250,22176280,11088140,
2021-10-23,28194,7607,17166,,23005009,11643735,538684,22210102,11105051,
2021-10-24,19359,5729,12606,,23024368,11649208,531795,22234826,11117413,
2021-10-25,9932,2710,6477,,23034300,11651649,528020,22247258,11123629,
2021-10-26,18930,5395,11108,,23053230,11656766,522298,22268936,11134468,
2021-10-27,22869,6082,13222,,23076099,11662593,515144,22294898,11147449,
2021-10-28,22313,5792,12648,,23098412,11668097,508277,22319640,11159820,
2021-10-29,22824,5733,13057,,23121236,11673528,500938,22345180,11172590,
2021-10-30,24127,6048,14624,,23145363,11679304,492350,22373908,11186954,
2021-10-31,16490,4596,10607,,23161853,11683606,486334,22394544,11197272,
2021-11-01,7877,2082,5058,,23169730,11685408,483345,22404126,11202063,
2021-11-02,15631,4364,7748,,23185361,11689483,479950,22419066,11209533,
2021-11-03,18636,5070,9608,,23203997,11694250,475402,22437696,11218848,
2021-11-04,19512,4875,10037,,23223509,11698849,470225,22457248,11228624,
2021-11-05,21475,4405,9526,,23244984,11702965,465090,22475750,11237875,
2021-11-06,25343,5209,12158,,23270327,11707905,458124,22499562,11249781,
2021-11-07,21459,4027,8928,,23291786,11711651,453211,22516880,11258440,
2021-11-08,11993,2111,4733,,23303779,11713467,450573,22525788,11262894,
2021-11-09,24140,3855,7657,,23327919,11717001,446761,22540480,11270240,
2021-11-10,28488,4510,9002,,23356407,11721235,442255,22557960,11278980,
2021-11-11,28773,4311,9103,,23385180,11725249,437454,22575590,11287795,
2021-11-12,26754,4166,8246,,23411934,11729124,433360,22591528,11295764,
2021-11-13,34321,5083,11416,,23446255,11733901,427018,22613766,11306883,
2021-11-14,23230,3901,8613,,23469485,11737539,422299,22630480,11315240,
2021-11-15,12704,2187,4496,,23482189,11739466,419982,22638968,11319484,
2021-11-16,26193,3935,7490,,23508382,11743145,416423,22653444,11326722,
2021-11-17,31184,4046,7832,,23539566,11746909,412627,22668564,11334282,
2021-11-18,32514,3868,7533,,23572080,11750470,408948,22683044,11341522,
2021-11-19,35489,3866,7760,,23607569,11754035,405042,22697986,11348993,
2021-11-20,40123,4383,8825,,23647692,11758137,400591,22715092,11357546,
2021-11-21,28127,3439,6952,,23675819,11761314,397064,22728500,11364250,
2021-11-22,14902,1951,3896,,23690721,11762988,395113,22735750,11367875,
2021-11-23,33065,3279,6015,,23723786,11765987,392369,22747236,11373618,
2021-11-24,42676,3762,6816,,23766462,11769445,389304,22760282,11380141,
2021-11-25,46051,3936,6578,,23812513,11773106,386659,22772894,11386447,
2021-11-26,52870,11348,6618,,23865383,11784183,391382,22785602,11392801,
2021-11-27,63533,22361,7043,,23928916,11806263,406690,22799146,11399573,
2021-11-28,51465,27742,5320,,23980381,11833713,429100,22809226,11404613,
2021-11-29,33532,18933,2887,,24013913,11852385,445135,22814500,11407250,
2021-11-30,56054,20690,5142,,24069967,11872794,460673,22824242,11412121,
2021-12-01,69551,26244,5643,,24139518,11898732,481260,22834944,11417472,
2021-12-02,71643,26489,5042,,24211161,11924923,502694,22844458,11422229,
2021-12-03,73435,25099,5175,,24284596,11949726,522612,22854228,11427114,
2021-12-04,81165,27785,6078,47282,24365761,11977217,544310,,11432907,807783
2021-12-05,62643,31933,4418,26270,24428404,12008855,571817,,11437038,833949
2021-12-06,38631,19144,2714,16758,24467035,12027709,588240,,11439469,850629
2021-12-07,60302,14853,4486,40949,24527337,12042290,598597,,11443693,891504
2021-12-08,73456,19058,4682,49713,24600793,12061071,612963,,11448108,941139
2021-12-09,74512,18279,4347,51866,24675305,12079041,626887,,11452154,992920
2021-12-10,77514,17590,4661,55251,24752819,12096350,639811,,11456539,1048090
2021-12-11,83202,20407,5842,56942,24836021,12116468,654362,,11462106,1104946
2021-12-12,60769,22699,4164,33863,24896790,12138887,672891,,11465996,1138720
2021-12-13,34941,11603,2415,20900,24931731,12150193,682069,,11468124,1159525
2021-12-14,101992,9002,3876,89070,25033723,12158884,687180,,11471704,1248475
2021-12-15,127708,12430,4516,110724,25161431,12171010,695084,,11475926,1359099
2021-12-16,139378,12470,4257,122634,25300809,12183194,703287,,11479907,1481634
2021-12-17,159187,12405,4526,142234,25459996,12195324,711157,,11484167,1623771
2021-12-18,175600,13524,4928,157103,25635596,12208554,719741,,11488813,1780779
2021-12-19,140447,18160,3936,118313,25776043,12226413,733957,,11492456,1898981
2021-12-20,106827,10305,2748,93727,25882870,12236450,741504,,11494946,1992610
2021-12-21,215406,12968,4325,198091,26098276,12249102,750140,,11498962,2190580
2021-12-22,237270,14427,5205,217754,26335546,12263229,759348,,11503881,2408216
2021-12-23,257795,11734,5095,240868,26593341,12274657,765981,,11508676,2648978
2021-12-24,223649,9465,4579,209537,26816990,12283825,770863,,11512962,2858399
2021-12-25,89739,3891,2514,83346,26906729,12287441,772235,,11515206,2941638
2021-12-26,11901,389,360,11142,26918630,12287538,772256,,11515282,2952650
2021-12-27,46947,1491,1116,44309,26965577,12288784,772624,,11516160,2996839
2021-12-28,144794,6101,4013,134617,27110371,12294591,774701,,11519890,3131325
2021-12-29,175479,9377,4586,161446,27285850,12303672,779488,,11524184,3292643
2021-12-30,200080,10136,5355,184547,27485930,12313505,784254,,11529251,3477056
2021-12-31,195222,10009,5809,179151,27681152,12323225,788445,,11534780,3656081
2022-01-01,96961,5384,3885,87365,27778113,12328300,789936,,11538364,3743297
2022-01-02,19454,944,932,17448,27797567,12328953,789939,,11539014,3760599
2022-01-03,88260,4774,4594,78811,27885827,12333417,790111,,11543306,3839257
2022-01-04,146386,6003,5327,135017,28032213,12339092,790774,,11548318,3974118
2022-01-05,177527,7637,7299,162417,28209740,12346375,791101,,11555274,4136375
2022-01-06,191561,7217,6790,177027,28401301,12353273,791517,,11561756,4313247
2022-01-07,191317,7971,7009,175523,28592618,12360900,792467,,11568433,4488597
2022-01-08,181701,8634,6647,165231,28774319,12369202,794441,,11574761,4653672
2022-01-09,131115,9872,7192,113958,28905434,12378752,797116,,11581636,4767470
2022-01-10,90565,5108,4490,80836,28995999,12383537,797724,,11585813,4848153
2022-01-11,138911,6167,6584,125454,29134910,12389357,797294,,11592063,4973417
2022-01-12,157054,8169,8064,138698,29291964,12397197,797394,,11599803,5111947
2022-01-13,162699,9216,9221,141552,29454663,12406051,797375,,11608676,5253316
2022-01-14,159907,10757,10390,136069,29614570,12416446,797737,,11618709,5389187
2022-01-15,161221,11017,11679,135891,29775791,12427091,797064,,11630027,5524885
2022-01-16,109794,9296,9679,89458,29885585,12436025,796674,,11639351,5614125
2022-01-17,65790,5940,6567,52642,29951375,12441629,796037,,11645592,5666582
2022-01-18,36131,2009,2138,31161,29987506,12443283,795897,,11647386,5697547
2022-01-19,101339,5590,6724,85965,30088845,12448473,794745,,11653728,5783285
2022-01-20,103622,6328,7010,85746,30192467,12454417,794055,,11660362,5868808
2022-01-21,102123,6237,8060,82514,30294590,12460250,792218,,11668032,5951094
2022-01-22,102607,8729,12078,78123,30397197,12468590,788862,,11679728,6028989
2022-01-23,76711,7310,14000,54802,30473908,12475557,782165,,11693392,6083569
2022-01-24,42269,3199,7936,30746,30516177,12478392,777410,,11700982,6114108
2022-01-25,62581,3761,8374,48125,30578758,12481771,772782,,11708989,6162013
2022-01-26,77900,4921,13172,55696,30656658,12486315,764526,,11721789,6217467
2022-01-27,78090,4899,13250,56055,30734748,12490842,756165,,11734677,6273285
2022-01-28,77300,4678,13679,53904,30812048,12495162,747151,,11748011,6326970
2022-01-29,84837,5533,17719,58121,30896885,12500331,734958,,11765373,6384846
2022-01-30,66516,5026,20633,40160,30963401,12505015,719337,,11785678,6424781
2022-01-31,34758,2179,9889,22351,30998159,12506875,711618,,11795257,6446943
2022-02-01,51360,3269,9665,36531,31049519,12509791,705212,,11804579,6483249
2022-02-02,57726,3849,12404,38685,31107245,12513309,696642,,11816667,6521734
2022-02-03,52592,3612,11514,34305,31159837,12516544,688728,,11827816,6555788
2022-02-04,43104,2946,10569,27287,31202941,12519178,681095,,11838083,6582880
2022-02-05,58738,3752,14476,37566,31261679,12522598,670359,,11852239,6620233
2022-02-06,49868,3643,16120,29574,31311547,12525918,657877,,11868041,6649583
2022-02-07,23246,1694,7812,13448,31334793,12527286,651746,,11875540,6662807
2022-02-08,33415,2363,7256,21976,31368208,12529319,646846,,11882473,6684550
2022-02-09,38897,2788,8925,24411,31407105,12531748,640703,,11891045,6708709
2022-02-10,37549,2766,8839,22558,31444654,12534177,634626,,11899551,6731036
2022-02-11,39455,2725,10297,23007,31484109,12536554,627044,,11909510,6753804
2022-02-12,42059,2961,11460,25320,31526168,12539181,618534,,11920647,6778900
2022-02-13,36334,2805,13148,19943,31562502,12541699,608188,,11933511,6798645
2022-02-14,16987,1177,6124,9475,31579489,12542601,603233,,11939368,6807920
2022-02-15,19372,1389,4759,11880,31598861,12543666,599853,,11943813,6819573
2022-02-16,26035,1768,7741,14949,31624896,12545137,593876,,11951261,6834321
2022-02-17,26777,1685,7528,14987,31651673,12546467,588024,,11958443,6849053
2022-02-18,23960,1356,6617,13682,31675633,12547506,582751,,11964755,6862526
2022-02-19,37846,1904,8344,26056,31713479,12549077,576306,,11972771,6888339
2022-02-20,32582,1499,7964,22808,31746061,12550275,569833,,11980442,6910942
2022-02-21,17506,914,3679,12759,31763567,12550893,567059,,11983834,6923489
2022-02-22,9114,431,1555,6958,31772681,12551034,565930,,11985104,6930236
2022-02-23,25348,1328,4800,17300,31798029,12552052,562451,,11989601,6947300
2022-02-24,24582,1402,5234,15486,31822611,12553132,558614,,11994518,6962543
2022-02-25,23113,1397,5138,14509,31845724,12554235,554866,,11999369,6976826
2022-02-26,25239,1386,5911,16560,31870963,12555311,550334,,12004977,6993160
2022-02-27,26964,1372,7373,17705,31897927,12556414,544322,,12012092,7010670
2022-02-28,10130,594,2531,6745,31908057,12556755,542377,,12014378,7017232
2022-03-01,13207,950,3152,8168,31921264,12557400,540165,,12017235,7025183
2022-03-02,15421,1165,3577,9622,31936685,12558303,537746,,12020557,7034627
2022-03-03,14306,1081,3228,8689,31950991,12559072,535591,,12023481,7043085
2022-03-04,14483,993,3446,8319,31965474,12559744,533134,,12026610,7051151
2022-03-05,18542,1278,5000,11188,31984016,12560712,529401,,12031311,7062115
2022-03-06,16521,1090,5526,9608,32000537,12561521,524959,,12036562,7071516
2022-03-07,5951,469,1862,3509,32006488,12561705,523559,,12038146,7074808
2022-03-08,7373,701,1946,4160,32013861,12562128,522307,,12039821,7078769
2022-03-09,11180,909,2741,6407,32025041,12562761,520469,,12042292,7084974
2022-03-10,12772,1046,3261,6842,32037813,12563530,518247,,12045283,7091603
2022-03-11,12895,905,3411,6867,32050708,12564146,515733,,12048413,7098254
2022-03-12,14695,1049,4191,8310,32065403,12564923,512588,,12052335,7106360
2022-03-13,14754,1091,4999,8336,32080157,12565723,508676,,12057047,7114459
2022-03-14,6337,451,2230,3500,32086494,12565902,506894,,12059008,7117745
2022-03-15,10202,793,2627,5974,32096696,12566405,505048,,12061357,7123505
2022-03-16,13073,936,3670,6954,32109769,12567051,502311,,12064740,7130228
2022-03-17,13204,1050,3966,6759,32122973,12567813,499388,,12068425,7136767
2022-03-18,11911,916,3148,6433,32134884,12568426,497146,,12071280,7142976
2022-03-19,14444,1005,4163,7903,32149328,12569151,493986,,12075165,7150660
2022-03-20,11754,992,3960,6374,32161082,12569871,491013,,12078858,7156826
2022-03-21,5059,415,1589,2814,32166141,12570027,489835,,12080192,7159437
2022-03-22,6717,552,1559,3894,32172858,12570291,488822,,12081469,7163115
2022-03-23,9977,789,2303,5196,32182835,12570764,487305,,12083459,7168070
2022-03-24,9299,723,2377,4615,32192134,12571223,485642,,12085581,7172481
2022-03-25,9234,782,2159,4754,32201368,12571742,484257,,12087485,7177023
2022-03-26,10935,938,2838,5506,32212303,12572403,482355,,12090048,7182310
2022-03-27,10230,912,3539,5301,32222533,12573055,479724,,12093331,7187400
2022-03-28,3584,322,1109,1987,32226117,12573136,478934,,12094202,7189192
2022-03-29,5353,500,1217,2693,32231470,12573351,478211,,12095140,7191663
2022-03-30,7859,748,1840,4124,32239329,12573820,477114,,12096706,7195562
2022-03-31,8657,690,1926,4415,32247986,12574221,475872,,12098349,7199755
2022-04-01,9319,802,1918,4889,32257305,12574731,474747,,12099984,7204405
2022-04-02,10448,886,2216,5573,32267753,12575330,473405,,12101925,7209761
2022-04-03,9213,880,2569,5067,32276966,12575953,471710,,12104243,7214626
2022-04-04,4205,388,1006,2407,32281171,12576079,471089,,12104990,7216829
2022-04-05,6084,601,1038,3054,32287255,12576339,470646,,12105693,7219607
2022-04-06,8384,715,1479,4384,32295639,12576763,469877,,12106886,7223764
2022-04-07,10356,733,1691,4837,32305995,12577196,468914,,12108282,7228358
2022-04-08,23999,812,1585,4837,32329994,12577730,468135,,12109595,7232979
2022-04-09,30503,971,1977,5894,32360497,12578403,467120,,12111283,7238650
2022-04-10,24872,976,2394,5336,32385369,12579120,465696,,12113424,7243784
2022-04-11,12577,386,877,2432,32397946,12579256,465201,,12114055,7246014
2022-04-12,28137,693,1024,3537,32426083,12579645,464863,,12114782,7249318
2022-04-13,37787,853,1562,4928,32463870,12580199,464150,,12116049,7254016
2022-04-14,37911,764,1619,4915,32501781,12580649,463292,,12117357,7258677
2022-04-15,43405,1234,2104,6726,32545186,12581585,462418,,12119167,7265166
2022-04-16,8097,357,651,1742,32553283,12581682,462122,,12119560,7266692
2022-04-17,21028,871,1925,4319,32574311,12582269,461061,,12121208,7270788
2022-04-18,5466,306,465,1290,32579777,12582288,460897,,12121391,7271837
2022-04-19,22662,615,775,3103,32602439,12582620,460728,,12121892,7274720
2022-04-20,40346,1063,1403,4620,32642785,12583357,460385,,12122972,7279076
2022-04-21,38761,943,1600,4685,32681546,12584004,459719,,12124285,7283527
2022-04-22,35640,1017,1437,4271,32717186,12584749,459292,,12125457,7287580
2022-04-23,34660,1005,1740,4714,32751846,12585470,458554,,12126916,7292055
2022-04-24,20818,1021,1891,3777,32772664,12586241,457681,,12128560,7295638
2022-04-25,8299,453,691,1707,32780963,12586425,457442,,12128983,7297129
2022-04-26,24625,734,948,3145,32805588,12586867,457222,,12129645,7300037
2022-04-27,33607,955,1372,3940,32839195,12587545,456797,,12130748,7303759
2022-04-28,32846,930,1420,3931,32872041,12588202,456298,,12131904,7307467
2022-04-29,32065,1098,1381,3909,32904106,12589002,456008,,12132994,7311147
2022-04-30,30295,926,1541,4025,32934401,12589630,455386,,12134244,7314936
2022-05-01,16759,770,1582,2970,32951160,12590102,454569,,12135533,7317662
2022-05-02,5937,309,526,1099,32957097,12590115,454348,,12135767,7318534
2022-05-03,20935,589,835,2347,32978032,12590399,454096,,12136303,7320642
2022-05-04,29418,800,1093,3290,33007450,12590889,453798,,12137091,7323683
2022-05-05,29102,872,1167,3125,33036552,12591448,453493,,12137955,7326563
2022-05-06,29103,1147,1287,2988,33065655,12592306,453348,,12138958,7329324
2022-05-07,28495,870,1266,3113,33094150,12592886,452947,,12139939,7332213
2022-05-08,16002,895,1310,2323,33110152,12593524,452530,,12140994,7334335
2022-05-09,5897,293,474,943,33116049,12593550,452342,,12141208,7335068
2022-05-10,21232,698,724,2120,33137281,12593930,452309,,12141621,7336928
2022-05-11,28956,837,1087,2656,33166237,12594435,452055,,12142380,7339313
2022-05-12,28249,799,1088,2517,33194486,12594937,451762,,12143175,7341589
2022-05-13,27599,879,1119,2469,33222085,12595505,451517,,12143988,7343801
2022-05-14,25695,807,1101,2610,33247780,12595999,451216,,12144783,7346157
2022-05-15,14853,751,1277,2058,33262633,12596478,450683,,12145795,7347996
2022-05-16,6387,326,533,1048,33269020,12596566,450472,,12146094,7348857
2022-05-17,19607,590,781,1743,33288627,12596840,450274,,12146566,7350351
2022-05-18,26549,876,1101,2278,33315176,12597451,450044,,12147407,7352413
2022-05-19,24447,684,1159,2164,33339623,12597868,449562,,12148306,7354360
2022-05-20,24273,801,1141,2218,33363896,12598398,449218,,12149180,7356358
2022-05-21,22408,692,1168,2351,33386304,12598780,448733,,12150047,7358466
2022-05-22,10562,549,892,1489,33396866,12599068,448385,,12150683,7359738
2022-05-23,4575,242,465,794,33401441,12599050,448160,,12150890,7360323
2022-05-24,2629,120,182,442,33404070,12598914,448096,,12150818,7360554
2022-05-25,19371,655,951,1955,33423441,12599302,447790,,12151512,7362298
2022-05-26,20658,665,953,1915,33444099,12599693,447496,,12152197,7363990
2022-05-27,21769,819,1063,2076,33465868,12600223,447249,,12152974,7365832
2022-05-28,19421,723,1168,2152,33485289,12600675,446801,,12153874,7367769
2022-05-29,12115,761,1285,1727,33497404,12601201,446270,,12154931,7369304
2022-05-30,4581,311,550,752,33501985,12601265,446027,,12155238,7369858
2022-05-31,13555,573,754,1668,33515540,12601536,445840,,12155696,7371286
2022-06-01,16619,704,976,1879,33532159,12601938,445566,,12156372,7372912
2022-06-02,14615,557,869,1679,33546774,12602183,445247,,12156936,7374350
2022-06-03,16112,699,1096,1818,33562886,12602602,444844,,12157758,7375948
2022-06-04,13327,647,1167,1845,33576213,12602991,444319,,12158672,7377591
2022-06-05,7870,587,1113,1432,33584083,12603329,443789,,12159540,7378831
2022-06-06,3295,207,446,641,33587378,12603287,443547,,12159740,7379270
2022-06-07,11229,476,729,1375,33598607,12603463,443289,,12160174,7380401
2022-06-08,14073,670,1014,1612,33612680,12603872,442940,,12160932,7381793
2022-06-09,13387,663,929,1678,33626067,12604247,442669,,12161578,7383239
2022-06-10,13859,686,1071,1699,33639926,12604645,442275,,12162370,7384708
2022-06-11,12987,616,1031,1847,33652913,12604975,441858,,12163117,7386332
2022-06-12,8100,643,1238,1504,33661013,12605359,441259,,12164100,7387629
2022-06-13,3191,284,422,713,33664204,12605375,441116,,12164259,7388132
2022-06-14,10132,513,666,1265,33674336,12605599,440957,,12164642,7389159
2022-06-15,13513,474,833,1622,33687849,12605776,440596,,12165180,7390542
2022-06-16,12553,498,858,1619,33700402,12605967,440230,,12165737,7391914
2022-06-17,11694,479,819,1653,33712096,12606157,439883,,12166274,7393329
2022-06-18,11456,438,876,1861,33723552,12606324,439442,,12166882,7394966
2022-06-19,7006,485,899,1420,33730558,12606555,439027,,12167528,7396170
2022-06-20,2287,147,301,643,33732845,12606478,438867,,12167611,7396643
2022-06-21,9548,358,616,1387,33742393,12606549,438604,,12167945,7397782
2022-06-22,13618,407,729,1706,33756011,12606684,438275,,12168409,7399263
2022-06-23,13709,405,777,1684,33769720,12606822,437900,,12168922,7400733
2022-06-24,15368,436,812,1675,33785088,12606998,437520,,12169478,7402193
2022-06-25,14475,427,853,1714,33799563,12607163,437083,,12170080,7403697
2022-06-26,8161,432,886,1280,33807724,12607333,436622,,12170711,7404760
2022-06-27,3214,171,365,594,33810938,12607254,436424,,12170830,7405146
2022-06-28,9619,369,559,1226,33820557,12607336,436230,,12171106,7406138
2022-06-29,13327,416,733,1635,33833884,12607461,435911,,12171550,7407533
2022-06-30,12234,482,848,1581,33846118,12607658,435543,,12172115,7408880
2022-07-01,13042,549,972,1949,33859160,12607949,435115,,12172834,7410623
2022-07-02,1620,111,118,366,33860780,12607784,435106,,12172678,7410757
2022-07-03,5167,260,495,963,33865947,12607785,434862,,12172923,7411503
2022-07-04,2758,132,279,615,33868705,12607670,434714,,12172956,7411921
2022-07-05,11149,372,600,1577,33879854,12607744,434478,,12173266,7413250
2022-07-06,15962,549,860,2010,33895816,12607996,434161,,12173835,7415016
2022-07-07,15671,521,832,1928,33911487,12608228,433849,,12174379,7416691
2022-07-08,17892,555,871,2248,33929379,12608478,433532,,12174946,7418690
2022-07-09,14153,452,597,1851,33943532,12608651,433386,,12175265,7420303
2022-07-10,8753,475,755,1506,33952285,12608876,433105,,12175771,7421601
2022-07-11,4095,199,331,871,33956380,12608808,432970,,12175838,7422250
2022-07-12,12113,411,527,1659,33968493,12608920,432849,,12176071,7423655
2022-07-13,16722,565,773,2144,33985215,12609187,432635,,12176552,7425554
2022-07-14,16862,483,676,2024,34002077,12609364,432431,,12176933,7427338
2022-07-15,28903,598,824,2187,34030980,12609661,432204,,12177457,7429283
2022-07-16,30306,586,775,2331,34061286,12609933,432007,,12177926,7431361
2022-07-17,22938,539,636,1895,34084224,12610233,431907,,12178326,7433060
2022-07-18,11398,189,255,857,34095622,12610153,431836,,12178317,7433694
2022-07-19,28963,593,592,2140,34124585,12610470,431834,,12178636,7435602
2022-07-20,37647,839,924,2598,34162232,12611028,431744,,12179284,7437961
2022-07-21,36369,734,812,2812,34198601,12611473,431659,,12179814,7440531
2022-07-22,35810,824,894,2689,34234411,12612007,431582,,12180425,7442982
2022-07-23,35159,821,914,2837,34269570,12612513,431481,,12181032,7445563
2022-07-24,21742,599,806,1779,34291312,12612849,431271,,12181578,7447117
2022-07-25,11938,307,311,1083,34303250,12612870,431262,,12181608,7447968
2022-07-26,26100,621,605,2215,34329350,12613206,431277,,12181929,7449939
2022-07-27,32482,810,850,2655,34361832,12613757,431235,,12182522,7452382
2022-07-28,31547,724,884,2612,34393379,12614182,431071,,12183111,7454741
2022-07-29,30003,1791,875,2649,34423382,12615679,431983,,12183696,7457138
2022-07-30,25840,2524,747,2441,34449222,12617921,433758,,12184163,7459345
2022-07-31,14320,1067,541,1572,34463542,12618718,434280,,12184438,7460688
2022-08-01,5918,337,223,685,34469460,12618795,434392,,12184403,7461150
2022-08-02,4489,306,138,607,34473949,12618830,434556,,12184274,7461534
2022-08-03,22953,2640,741,2244,34496902,12621193,436451,,12184742,7463542
2022-08-04,22242,2481,683,2136,34519144,12623345,438243,,12185102,7465413
2022-08-05,21802,2755,747,2072,34540946,12625818,440243,,12185575,7467256
2022-08-06,19655,2875,657,2001,34560601,12628380,442455,,12185925,7468997
2022-08-07,12712,2236,621,1425,34573313,12630340,444064,,12186276,7470203
2022-08-08,4766,570,188,603,34578079,12630621,444439,,12186182,7470568
2022-08-09,14023,1467,560,1600,34592102,12631799,445340,,12186459,7471926
2022-08-10,19135,2363,716,1998,34611237,12633887,446985,,12186902,7473694
2022-08-11,17085,2042,718,1860,34628322,12635653,448307,,12187346,7475321
2022-08-12,16989,2049,735,1853,34645311,12637413,449620,,12187793,7476945
2022-08-13,15957,2224,766,1809,34661268,12639350,451076,,12188274,7478511
2022-08-14,9531,1621,619,1087,34670799,12640681,452074,,12188607,7479362
2022-08-15,3876,388,271,482,34674675,12640812,452188,,12188624,7479634
2022-08-16,10811,1075,516,1356,34685486,12641585,452745,,12188840,7480738
2022-08-17,16110,1834,740,1787,34701596,12643129,453837,,12189292,7482288
2022-08-18,14938,1640,752,1698,34716534,12644444,454721,,12189723,7483714
2022-08-19,15320,1848,750,1552,34731854,12646013,455815,,12190198,7485032
2022-08-20,14288,1640,741,1547,34746142,12647360,456708,,12190652,7486339
2022-08-21,9908,1533,660,1166,34756050,12648627,457577,,12191050,7487288
2022-08-22,4167,481,272,563,34760217,12648803,457783,,12191020,7487591
2022-08-23,11141,1248,555,1500,34771358,12649742,458472,,12191270,7488838
2022-08-24,14767,1807,871,2192,34786125,12651277,459408,,12191869,7490798
2022-08-25,14031,1716,780,2125,34800156,12652703,460337,,12192366,7492676
2022-08-26,13930,1688,816,2094,34814086,12654093,461202,,12192891,7494520
2022-08-27,12420,1487,878,2001,34826506,12655252,461805,,12193447,7496254
2022-08-28,7927,1260,622,1398,34834433,12656250,462441,,12193809,7497431
2022-08-29,3401,503,286,684,34837834,12656471,462653,,12193818,7497880
2022-08-30,9908,1167,652,1857,34847742,12657279,463162,,12194117,7499433
2022-08-31,13518,1626,946,2317,34861260,12658611,463838,,12194773,7501504
2022-09-01,12909,1720,914,2143,34874169,12660035,464639,,12195396,7503401
2022-09-02,15049,1616,995,4917,34889218,12661374,465252,,12196122,7508090
2022-09-03,14723,1526,924,5518,34903941,12662613,465851,,12196762,7513371
2022-09-04,8669,1009,677,3238,34912610,12663355,466173,,12197182,7516387
2022-09-05,3557,321,229,1387,34916167,12663409,466262,,12197147,7517551
2022-09-06,2470,157,116,1132,34918637,12663309,466300,,12197009,7518473
2022-09-07,10929,1020,588,3494,34929566,12664028,466728,,12197300,7521713
2022-09-08,10874,1022,527,2792,34940440,12664720,467220,,12197500,7524227
2022-09-09,9587,1013,489,2505,34950027,12665444,467739,,12197705,7526495
2022-09-10,10637,1264,552,3168,34960664,12666428,468444,,12197984,7529427
2022-09-11,9412,980,667,3739,34970076,12667157,468751,,12198406,7532955
2022-09-12,3128,295,205,1080,34973204,12667167,468834,,12198333,7533797
2022-09-13,6021,545,284,1133,34979225,12667422,469086,,12198336,7534684
2022-09-14,14483,798,435,1844,34993708,12667900,469445,,12198455,7536261
2022-09-15,15762,782,412,1534,35009470,12668361,469810,,12198551,7537523
2022-09-16,17761,766,448,1693,35027231,12668864,470122,,12198742,7538992
2022-09-17,17623,723,458,1669,35044854,12669280,470383,,12198897,7540404
2022-09-18,11214,773,451,1688,35056068,12669789,470703,,12199086,7541866
2022-09-19,4979,404,288,670,35061047,12669919,470814,,12199105,7542321
2022-09-20,13774,443,332,948,35074821,12670047,470923,,12199124,7543006
2022-09-21,23047,648,410,1501,35097868,12670383,471156,,12199227,7544250
2022-09-22,22921,637,399,1382,35120789,12670710,471388,,12199322,7545369
2022-09-23,22952,727,603,1419,35143741,12671132,471507,,12199625,7546529
2022-09-24,21693,738,689,1499,35165434,12671575,471552,,12200023,7547792
2022-09-25,11321,595,703,1357,35176755,12671887,471438,,12200449,7548911
2022-09-26,4565,191,220,594,35181320,12671786,471403,,12200383,7549260
2022-09-27,37655,497,366,1498,35218975,12672012,471530,,12200482,7550530
2022-09-28,50973,731,670,1903,35269948,12672473,471590,,12200883,7552206
2022-09-29,48011,637,741,1838,35317959,12672785,471478,,12201307,7553764
2022-09-30,47275,677,807,2005,35365234,12673134,471346,,12201788,7555487
2022-10-01,34455,527,633,1549,35399689,12673351,471238,,12202113,7556768
2022-10-02,24247,736,1028,1712,35423936,12673789,470943,,12202846,7558226
2022-10-03,10871,238,231,613,35434807,12673734,470946,,12202788,7558600
2022-10-04,32199,477,460,1170,35467006,12673889,470959,,12202930,7559491
2022-10-05,40441,633,742,1561,35507447,12674197,470843,,12203354,7560784
2022-10-06,38697,610,653,1569,35546144,12674502,470798,,12203704,7562091
2022-10-07,42245,662,852,1742,35588389,12674816,470600,,12204216,7563531
2022-10-08,37402,782,1145,2121,35625791,12675265,470231,,12205034,7565376
2022-10-09,18814,549,727,1556,35644605,12675534,470050,,12205484,7566692
2022-10-10,6866,166,371,567,35651471,12675400,469842,,12205558,7566997
2022-10-11,4994,124,111,318,35656465,12675228,469850,,12205378,7567076
2022-10-12,35118,579,685,1429,35691583,12675471,469742,,12205729,7568213
2022-10-13,36763,643,859,1621,35728346,12675743,469522,,12206221,7569522
2022-10-14,36977,621,753,1541,35765323,12676028,469386,,12206642,7570781
2022-10-15,35455,714,1013,1628,35800778,12676448,469084,,12207364,7572158
2022-10-16,20663,654,1024,1593,35821441,12676829,468708,,12208121,7573518
2022-10-17,7356,206,477,541,35828797,12676745,468435,,12208310,7573815
2022-10-18,36430,454,503,1402,35865227,12676875,468381,,12208494,7574943
2022-10-19,49905,618,730,1983,35915132,12677189,468265,,12208924,7576674
2022-10-20,51293,621,650,2050,35966425,12677494,468233,,12209261,7578457
2022-10-21,52853,695,619,1937,36019278,12677859,468303,,12209556,7580124
2022-10-22,50869,750,905,2312,36070147,12678276,468143,,12210133,7582159
2022-10-23,30643,571,786,2121,36100790,12678529,467921,,12210608,7584015
2022-10-24,14134,232,271,978,36114924,12678455,467877,,12210578,7584732
2022-10-25,41376,472,489,1821,36156300,12678573,467857,,12210716,7586252
2022-10-26,51660,615,660,2124,36207960,12678850,467808,,12211042,7588094
2022-10-27,50119,603,768,2164,36258079,12679122,467635,,12211487,7589983
2022-10-28,49808,590,675,2095,36307887,12679348,467545,,12211803,7591767
2022-10-29,50606,734,779,2222,36358493,12679729,467496,,12212233,7593685
2022-10-30,28404,662,930,2038,36386897,12680101,467224,,12212877,7595475
2022-10-31,12440,200,234,777,36399337,12680016,467186,,12212830,7596014
2022-11-01,33096,338,198,1220,36432433,12680005,467320,,12212685,7596941
2022-11-02,44294,574,625,1903,36476727,12680243,467265,,12212978,7598541
2022-11-03,44195,540,606,1856,36520922,12680449,467194,,12213255,7600108
2022-11-04,44647,648,528,2030,36565569,12680789,467307,,12213482,7601881
2022-11-05,45211,646,753,2369,36610780,12681130,467197,,12213933,7603981
2022-11-06,26021,558,771,2098,36636801,12681343,466981,,12214362,7605778
2022-11-07,10711,242,235,877,36647512,12681290,466985,,12214305,7606411
2022-11-08,33490,486,397,1586,36681002,12681482,467071,,12214411,7607750
2022-11-09,40532,604,571,1965,36721534,12681761,467102,,12214659,7609439
2022-11-10,39181,620,548,1928,36760715,12682056,467168,,12214888,7611088
2022-11-11,43354,636,642,2209,36804069,12682370,467161,,12215209,7613018
2022-11-12,36854,638,593,2185,36840923,12682681,467198,,12215483,7614918
2022-11-13,24270,557,771,2278,36865193,12682937,466978,,12215959,7616938
2022-11-14,10968,232,205,1024,36876161,12682871,467004,,12215867,7617702
2022-11-15,33636,484,380,1696,36909797,12682983,467102,,12215881,7619083
2022-11-16,43543,799,584,2371,36953340,12683475,467311,,12216164,7621196
2022-11-17,38342,674,647,2241,36991682,12683805,467334,,12216471,7623144
2022-11-18,40629,723,530,2335,37032311,12684176,467523,,12216653,7625175
2022-11-19,39663,1005,1031,3061,37071974,12684829,467490,,12217339,7627927
2022-11-20,22425,658,719,2445,37094399,12685202,467425,,12217777,7630137
2022-11-21,8922,196,193,968,37103321,12685130,467423,,12217707,7630895
2022-11-22,26443,481,370,1513,37129764,12685241,467529,,12217712,7632085
2022-11-23,32090,686,668,2071,37161854,12685587,467544,,12218043,7633869
2022-11-24,31913,662,753,2086,37193767,12685928,467451,,12218477,7635687
2022-11-25,30754,763,827,1953,37224521,12686374,467381,,12218993,7637373
2022-11-26,30294,907,1194,2699,37254815,12686933,467085,,12219848,7639775
2022-11-27,18680,607,943,2088,37273495,12687226,466743,,12220483,7641599
2022-11-28,7541,190,282,788,37281036,12687108,466643,,12220465,7642119
2022-11-29,21028,421,454,1292,37302064,12687192,466606,,12220586,7643127
2022-11-30,27894,643,649,1841,37329958,12687507,466598,,12220909,7644683
2022-12-01,24809,593,682,1693,37354767,12687765,466505,,12221260,7646085
2022-12-02,25059,523,630,1776,37379826,12687951,466392,,12221559,7647571
2022-12-03,25559,588,781,1945,37405385,12688206,466189,,12222017,7649243
2022-12-04,15252,494,606,1702,37420637,12688357,466071,,12222286,7650645
2022-12-05,6877,167,157,746,37427514,12688224,466076,,12222148,7651137
2022-12-06,20355,419,353,1379,37447869,12688264,466136,,12222128,7652196
2022-12-07,24788,553,611,1672,37472657,12688489,466070,,12222419,7653589
2022-12-08,23164,564,520,1767,37495821,12688725,466112,,12222613,7655069
2022-12-09,23333,636,575,1633,37519154,12689019,466169,,12222850,7656418
2022-12-10,22581,508,603,1631,37541735,12689198,466071,,12223127,7657763
2022-12-11,14206,548,787,1567,37555941,12689470,465829,,12223641,7659094
2022-12-12,5507,149,156,595,37561448,12689320,465817,,12223503,7659444
2022-12-13,17799,375,371,1125,37579247,12689366,465819,,12223547,7660290
2022-12-14,21325,511,547,1454,37600572,12689572,465777,,12223795,7661491
2022-12-15,21976,530,603,1579,37622548,12689748,465702,,12224046,7662766
2022-12-16,16292,378,451,1031,37638840,12689795,465626,,12224169,7663518
2022-12-17,18702,554,510,1279,37657542,12690017,465668,,12224349,7664505
2022-12-18,12647,531,795,1307,37670189,12690258,465403,,12224855,7665552
2022-12-19,4587,131,116,450,37674776,12690045,465414,,12224631,7665709
2022-12-20,16217,499,450,1111,37690993,12690217,465455,,12224762,7666547
2022-12-21,18476,541,552,1303,37709469,12690445,465440,,12225005,7667577
2022-12-22,18608,574,591,1748,37728077,12690713,465423,,12225290,7669059
2022-12-23,15654,577,602,1716,37743731,12690925,465393,,12225532,7670472
2022-12-24,5341,224,173,675,37749072,12690826,465443,,12225383,7670857
2022-12-25,2445,153,154,480,37751517,12690665,465432,,12225233,7671067
2022-12-26,262,12,7,48,37751779,12690367,465432,,12224935,7670856
2022-12-27,2099,98,37,307,37753878,12690171,465489,,12224682,7670921
2022-12-28,8321,337,168,975,37762199,12690184,465653,,12224531,7671616
2022-12-29,13167,583,529,1601,37775366,12690421,465703,,12224718,7672919
2022-12-30,15824,667,658,1881,37791190,12690769,465709,,12225060,7674516
2022-12-31,11238,459,389,1356,37802428,12690863,465775,,12225088,7675558
2023-01-01,3910,201,219,562,37806338,12690741,465755,,12224986,7675838
2023-01-02,652,37,13,97,37806990,12690482,465778,,12224704,7675681
2023-01-03,8197,297,151,902,37815187,12690480,465918,,12224562,7676331
2023-01-04,14724,574,547,1547,37829911,12690760,465938,,12224822,7677621
2023-01-05,16120,643,535,1797,37846031,12691092,466038,,12225054,7679148
2023-01-06,18838,715,613,2047,37864869,12691500,466137,,12225363,7680930
2023-01-07,18524,701,639,2057,37883393,12691914,466194,,12225720,7682737
2023-01-08,11613,579,608,1633,37895006,12692229,466162,,12226067,7684139
2023-01-09,5299,215,196,664,37900305,12692129,466178,,12225951,7684537
2023-01-10,12163,414,317,787,37912468,12692227,466273,,12225954,7685049
2023-01-11,15546,458,370,1097,37928014,12692353,466355,,12225998,7685867
2023-01-12,14085,444,409,973,37942099,12692479,466389,,12226090,7686570
2023-01-13,14176,418,344,1041,37956275,12692631,466460,,12226171,7687378
2023-01-14,13394,471,451,1079,37969669,12692783,466474,,12226309,7688177
2023-01-15,9046,459,508,1055,37978715,12692948,466424,,12226524,7688984
2023-01-16,3746,146,130,479,37982461,12692808,466440,,12226368,7689211
2023-01-17,8855,265,179,654,37991316,12692726,466522,,12226204,7689572
2023-01-18,10268,349,273,762,38001584,12692769,466595,,12226174,7690061
2023-01-19,10593,315,318,761,38012177,12692778,466587,,12226191,7690565
2023-01-20,9839,319,273,717,38022016,12692799,466631,,12226168,7691020
2023-01-21,11311,354,401,905,38033327,12692841,466583,,12226258,7691663
2023-01-22,7570,343,405,819,38040897,12692911,466518,,12226393,7692243
2023-01-23,3382,143,131,288,38044279,12692805,466529,,12226276,7692312
2023-01-24,8291,226,166,553,38052570,12692707,466586,,12226121,7692583
2023-01-25,10312,346,299,664,38062882,12692774,466629,,12226145,7693013
2023-01-26,6727,236,205,469,38069609,12692705,466656,,12226049,7693227
2023-01-27,6912,237,197,498,38076521,12692623,466693,,12225930,7693453
2023-01-28,9354,314,339,695,38085875,12692637,466662,,12225975,7693891
2023-01-29,5973,234,341,694,38091848,12692584,466550,,12226034,7694330
2023-01-30,1900,88,80,215,38093748,12692375,466556,,12225819,7694286
2023-01-31,5884,156,151,414,38099632,12692210,466557,,12225653,7694416
2023-02-01,7304,248,250,494,38106936,12692194,466552,,12225642,7694687
2023-02-02,6485,297,241,503,38113421,12692208,466605,,12225603,7694961
2023-02-03,6551,197,194,463,38119972,12692132,466604,,12225528,7695184
2023-02-04,6731,233,307,544,38126703,12692091,466524,,12225567,7695494
2023-02-05,4178,199,291,485,38130881,12692002,466427,,12225575,7695742
2023-02-06,1834,90,98,212,38132715,12691786,466416,,12225370,7695684
2023-02-07,4967,160,182,384,38137682,12691631,466391,,12225240,7695806
2023-02-08,5771,212,206,430,38143453,12691554,466392,,12225162,7695986
2023-02-09,6124,211,244,439,38149577,12691480,466358,,12225122,7696183
2023-02-10,5092,158,208,373,38154669,12691400,466304,,12225096,7696350
2023-02-11,6056,186,261,458,38160725,12691292,466225,,12225067,7696542
2023-02-12,4085,220,342,409,38164810,12691254,466099,,12225155,7696723
2023-02-13,1483,57,87,146,38166293,12691053,466067,,12224986,7696652
2023-02-14,3949,131,179,310,38170242,12690892,466017,,12224875,7696701
2023-02-15,4541,119,191,286,38174783,12690731,465942,,12224789,7696749
2023-02-16,4917,175,284,400,38179700,12690618,465829,,12224789,7696901
2023-02-17,4984,180,211,344,38184684,12690539,465794,,12224745,7697025
2023-02-18,5119,233,295,487,38189803,12690498,465730,,12224768,7697279
2023-02-19,3354,132,244,373,38193157,12690355,465613,,12224742,7697423
2023-02-20,1424,63,54,158,38194581,12690155,465619,,12224536,7697359
2023-02-21,915,27,14,107,38195496,12689924,465628,,12224296,7697239
2023-02-22,4137,131,212,370,38199633,12689790,465541,,12224249,7697392
2023-02-23,4283,162,231,393,38203916,12689668,465465,,12224203,7697542
2023-02-24,3035,136,232,274,38206951,12689533,465365,,12224168,7697572
2023-02-25,5024,213,541,386,38211975,12689487,465035,,12224452,7697741
2023-02-26,3473,146,681,384,38215448,12689355,464496,,12224859,7697895
2023-02-27,1075,37,57,97,38216523,12689138,464471,,12224667,7697781
2023-02-28,2732,99,163,232,38219255,12688945,464405,,12224540,7697753
2023-03-01,3850,137,428,336,38223105,12688765,464108,,12224657,7697807
2023-03-02,4595,158,495,329,38227700,12688601,463760,,12224841,7697870
2023-03-03,4371,159,357,334,38232071,12688477,463559,,12224918,7697952
2023-03-04,4970,208,623,350,38237041,12688393,463141,,12225252,7698052
2023-03-05,2537,110,450,251,38239578,12688195,462800,,12225395,7698036
2023-03-06,1157,48,37,114,38240735,12687976,462808,,12225168,7697918
2023-03-07,3221,87,172,225,38243956,12687736,462718,,12225018,7697869
2023-03-08,4320,133,412,284,38248276,12687562,462437,,12225125,7697880
2023-03-09,4624,173,453,312,38252900,12687441,462151,,12225290,7697940
2023-03-10,3942,99,139,255,38256842,12687280,462108,,12225172,7697975
2023-03-11,4064,139,171,286,38260906,12687175,462072,,12225103,7698048
2023-03-12,2893,109,234,301,38263799,12687003,461938,,12225065,7698107
2023-03-13,862,29,32,106,38264661,12686780,461931,,12224849,7697993
2023-03-14,3080,100,109,257,38267741,12686595,461922,,12224673,7698008
2023-03-15,4099,138,163,313,38271840,12686471,461895,,12224576,7698091
2023-03-16,4027,176,234,277,38275867,12686318,461828,,12224490,7698097
2023-03-17,4292,168,202,311,38280159,12686179,461790,,12224389,7698135
2023-03-18,4363,144,194,298,38284522,12686038,461739,,12224299,7698183
2023-03-19,2722,128,233,256,38287244,12685931,461632,,12224299,7698227
2023-03-20,774,31,19,74,38288018,12685685,461642,,12224043,7698063
2023-03-21,2899,69,86,201,38290917,12685481,461620,,12223861,7698032
2023-03-22,3895,130,134,248,38294812,12685314,461613,,12223701,7698015
2023-03-23,3811,118,172,226,38298623,12685133,461553,,12223580,7697986
2023-03-24,3694,102,116,238,38302317,12684971,461537,,12223434,7698003
2023-03-25,4274,108,171,252,38306591,12684811,461467,,12223344,7698024
2023-03-26,2480,112,213,202,38309071,12684654,461360,,12223294,7697998
2023-03-27,915,48,32,68,38309986,12684470,461375,,12223095,7697861
2023-03-28,3109,87,79,203,38313095,12684266,461375,,12222891,7697816
2023-03-29,4172,125,136,225,38317267,12684105,461360,,12222745,7697795
2023-03-30,3838,108,164,211,38321105,12683935,461303,,12222632,7697755
2023-03-31,3987,140,109,222,38325092,12683796,461333,,12222463,7697741
2023-04-01,4195,135,147,225,38329287,12683659,461318,,12222341,7697737
2023-04-02,2183,59,123,172,38331470,12683420,461250,,12222170,7697653
2023-04-03,781,24,12,53,38332251,12683191,461260,,12221931,7697485
2023-04-04,3419,74,76,169,38335670,12683004,461256,,12221748,7697419
2023-04-05,4373,94,109,249,38340043,12682807,461238,,12221569,7697420
2023-04-06,3703,108,109,190,38343746,12682653,461235,,12221418,7697381
2023-04-07,4599,105,115,243,38348345,12682475,461222,,12221253,7697383
2023-04-08,836,23,11,54,38349181,12682246,461229,,12221017,7697221
2023-04-09,2441,81,103,161,38351622,12682099,461204,,12220895,7697190
2023-04-10,360,9,6,20,38351982,12681847,461201,,12220646,7696998
2023-04-11,2771,34,28,121,38354753,12681588,461206,,12220382,7696858
2023-04-12,6347,105,96,188,38361100,12681430,461208,,12220222,7696831
2023-04-13,6999,105,128,207,38368099,12681262,461177,,12220085,7696801
2023-04-14,6514,88,103,206,38374613,12681084,461154,,12219930,7696790
2023-04-15,6949,107,149,230,38381562,12680928,461110,,12219818,7696799
2023-04-16,3276,83,144,166,38384838,12680732,461045,,12219687,7696725
2023-04-17,864,12,13,49,38385702,12680511,461041,,12219470,7696581
2023-04-18,4786,101,77,161,38390488,12680332,461062,,12219270,7696499
2023-04-19,6568,117,99,177,38397056,12680171,461077,,12219094,7696433
2023-04-20,6391,102,153,210,38403447,12680022,461024,,12218998,7696426
2023-04-21,5774,85,76,133,38409221,12679838,461030,,12218808,7696330
2023-04-22,6392,95,91,180,38415613,12679672,461031,,12218641,7696293
2023-04-23,3301,119,147,170,38418914,12679552,461002,,12218550,7696254
2023-04-24,955,4,12,59,38419869,12679309,460992,,12218317,7696112
2023-04-25,4809,69,70,187,38424678,12679122,460991,,12218131,7696072
2023-04-26,6593,108,93,208,38431271,12678993,461005,,12217988,7696072
2023-04-27,6899,118,152,207,38438170,12678847,460966,,12217881,7696052
2023-04-28,6638,86,86,185,38444808,12678678,460964,,12217714,7696007
2023-04-29,6534,121,111,200,38451342,12678549,460970,,12217579,7695990
2023-04-30,2642,94,129,145,38453984,12678414,460934,,12217480,7695933
2023-05-01,1030,20,17,30,38455014,12678177,460932,,12217245,7695739
2023-05-02,4348,67,55,106,38459362,12677979,460939,,12217040,7695619
2023-05-03,5609,108,107,176,38464971,12677832,460934,,12216898,7695581
2023-05-04,8087,87,85,135,38473058,12677655,460933,,12216722,7695498
2023-05-05,13049,89,98,168,38486107,12677505,460921,,12216584,7695459
2023-05-06,15659,113,96,156,38501766,12677396,460936,,12216460,7695413
2023-05-07,6067,56,95,106,38507833,12677227,460893,,12216334,7695323
2023-05-08,2167,16,4,37,38510000,12677011,460902,,12216109,7695159
2023-05-09,12572,55,49,129,38522572,12676825,460905,,12215920,7695086
2023-05-10,14772,70,79,157,38537344,12676656,460894,,12215762,7695034
2023-05-11,13365,77,72,154,38550709,12676518,460898,,12215620,7694997
2023-05-12,13491,83,79,177,38564200,12676378,460900,,12215478,7694973
2023-05-13,11448,80,75,147,38575648,12676192,460901,,12215291,7694887
2023-05-14,4187,68,95,93,38579835,12676044,460871,,12215173,7694805
2023-05-15,1055,9,6,38,38580890,12675843,460868,,12214975,7694664
2023-05-16,8949,56,48,93,38589839,12675662,460870,,12214792,7694551
2023-05-17,11134,99,83,141,38600973,12675514,460882,,12214632,7694463
2023-05-18,10838,81,69,144,38611811,12675348,460893,,12214455,7694389
2023-05-19,10516,95,97,154,38622327,12675207,460887,,12214320,7694329
2023-05-20,9407,91,88,165,38631734,12675055,460889,,12214166,7694273
2023-05-21,3083,48,86,95,38634817,12674910,460849,,12214061,7694196
2023-05-22,971,14,11,30,38635788,12674708,460851,,12213857,7694036
2023-05-23,754,8,3,16,38636542,12674510,460855,,12213655,7693874
2023-05-24,8033,57,80,105,38644575,12674330,460831,,12213499,7693764
2023-05-25,9344,74,93,163,38653919,12674177,460810,,12213367,7693728
2023-05-26,7996,67,70,123,38661915,12674035,460807,,12213228,7693664
2023-05-27,8232,108,76,126,38670147,12673922,460837,,12213085,7693606
2023-05-28,2905,56,72,101,38673052,12673785,460818,,12212967,7693532
2023-05-29,972,13,11,30,38674024,12673586,460817,,12212769,7693369
2023-05-30,6072,60,50,113,38680096,12673420,460825,,12212595,7693280
2023-05-31,8174,91,95,122,38688270,12673277,460818,,12212459,7693205
2023-06-01,7403,69,92,125,38695673,12673131,460793,,12212338,7693139
2023-06-02,6342,52,49,121,38702015,12672960,460795,,12212165,7693056
2023-06-03,5491,70,63,123,38707506,12672794,460801,,12211993,7692972
2023-06-04,2052,47,78,77,38709558,12672644,460767,,12211877,7692873
2023-06-05,600,11,6,18,38710158,12672458,460770,,12211688,7692714
2023-06-06,4465,39,38,79,38714623,12672277,460768,,12211509,7692596
2023-06-07,5816,63,65,121,38720439,12672146,460762,,12211384,7692554
2023-06-08,5756,58,68,112,38726195,12672025,460749,,12211276,7692513
2023-06-09,6191,77,81,122,38732386,12671891,460744,,12211147,7692447
2023-06-10,5351,76,95,116,38737737,12671740,460720,,12211020,7692363
2023-06-11,2010,55,62,105,38739747,12671608,460708,,12210900,7692308
2023-06-12,691,11,7,38,38740438,12671446,460711,,12210735,7692193
2023-06-13,4228,54,58,104,38744666,12671296,460706,,12210590,7692125
2023-06-14,5470,72,83,118,38750136,12671147,460694,,12210453,7692055
2023-06-15,5110,72,75,121,38755246,12670983,460688,,12210295,7691969
2023-06-16,5695,70,64,121,38760941,12670838,460690,,12210148,7691904
2023-06-17,4121,63,62,114,38765062,12670685,460691,,12209994,7691826
2023-06-18,1561,41,61,98,38766623,12670525,460669,,12209856,7691751
2023-06-19,373,6,2,16,38766996,12670331,460671,,12209660,7691593
2023-06-20,3205,51,42,89,38770201,12670153,460677,,12209476,7691481
2023-06-21,3693,42,57,89,38773894,12670004,460658,,12209346,7691398
2023-06-22,3981,75,73,118,38777875,12669879,460658,,12209221,7691339
2023-06-23,4510,54,44,90,38782385,12669754,460666,,12209088,7691272
2023-06-24,3698,49,61,73,38786083,12669571,460651,,12208920,7691147
2023-06-25,1520,31,51,93,38787603,12669412,460629,,12208783,7691074
2023-06-26,510,11,9,24,38788113,12669254,460628,,12208626,7690943
2023-06-27,3119,80,45,91,38791232,12669121,460660,,12208461,7690852
2023-06-28,4074,69,60,91,38795306,12668993,460668,,12208325,7690764
2023-06-29,3984,64,72,84,38799290,12668880,460655,,12208225,7690695
2023-06-30,3834,74,61,128,38803124,12668759,460664,,12208095,7690646
2023-07-01,3221,51,88,118,38806345,12668600,460625,,12207975,7690586
2023-07-02,272,10,5,15,38806617,12668425,460629,,12207796,7690441
2023-07-03,380,7,5,26,38806997,12668270,460630,,12207640,7690328
2023-07-04,1244,18,14,49,38808241,12668095,460634,,12207461,7690204
2023-07-05,2390,56,40,70,38810631,12667968,460648,,12207320,7690120
2023-07-06,2535,38,69,85,38813166,12667800,460615,,12207185,7690025
2023-07-07,2823,53,46,71,38815989,12667689,460620,,12207069,7689953
2023-07-08,2419,64,43,94,38818408,12667557,460640,,12206917,7689873
2023-07-09,916,31,45,37,38819324,12667415,460626,,12206789,7689752
2023-07-10,289,4,2,15,38819613,12667217,460626,,12206591,7689590
2023-07-11,1793,34,20,59,38821406,12667062,460636,,12206426,7689491
2023-07-12,2320,49,52,86,38823726,12666933,460633,,12206300,7689417
2023-07-13,2288,52,68,67,38826014,12666803,460615,,12206188,7689329
2023-07-14,1974,65,48,59,38827988,12666701,460629,,12206072,7689244
2023-07-15,1945,52,56,77,38829933,12666585,460624,,12205961,7689175
2023-07-16,806,36,30,43,38830739,12666437,460630,,12205807,7689059
2023-07-17,193,5,1,11,38830932,12666285,460631,,12205654,7688934
2023-07-18,1308,42,44,56,38832240,12666140,460629,,12205511,7688830
2023-07-19,1794,55,51,57,38834034,12666030,460631,,12205399,7688749
2023-07-20,1607,77,57,61,38835641,12665941,460649,,12205292,7688655
2023-07-21,1734,54,40,50,38837375,12665827,460659,,12205168,7688554
2023-07-22,1509,39,62,75,38838884,12665715,460636,,12205079,7688486
2023-07-23,699,28,31,49,38839583,12665583,460631,,12204952,7688392
2023-07-24,235,11,2,15,38839818,12665439,460639,,12204800,7688267
2023-07-25,1083,48,25,51,38840901,12665294,460662,,12204632,7688143
2023-07-26,1346,49,49,41,38842247,12665192,460661,,12204531,7688046
2023-07-27,1285,68,47,55,38843532,12665117,460681,,12204436,7687973
2023-07-28,1449,46,47,58,38844981,12664991,460679,,12204312,7687879
2023-07-29,1307,50,49,69,38846288,12664877,460677,,12204200,7687804
2023-07-30,638,29,19,29,38846926,12664753,460686,,12204067,7687698
2023-07-31,229,6,4,15,38847155,12664619,460685,,12203934,7687587
2023-08-01,1116,47,32,35,38848271,12664526,460699,,12203827,7687498
2023-08-02,1434,73,55,56,38849705,12664431,460715,,12203716,7687416
2023-08-03,1152,61,38,47,38850857,12664346,460738,,12203608,7687333
2023-08-04,1293,48,48,60,38852150,12664255,460738,,12203517,7687267
2023-08-05,1318,48,50,49,38853468,12664163,460735,,12203428,7687191
2023-08-06,577,25,19,23,38854045,12664075,460741,,12203334,7687111
2023-08-07,245,8,4,9,38854290,12663967,460742,,12203225,7687022
2023-08-08,326,7,3,15,38854616,12663848,460743,,12203105,7686926
2023-08-09,1251,45,43,45,38855867,12663769,460744,,12203025,7686863
2023-08-10,1598,97,52,69,38857465,12663756,460788,,12202968,7686832
2023-08-11,1670,57,47,63,38859135,12663690,460798,,12202892,7686786
2023-08-12,1648,65,47,68,38860783,12663651,460816,,12202835,7686765
2023-08-13,793,28,32,32,38861576,12663577,460812,,12202765,7686704
2023-08-14,247,6,1,6,38861823,12663485,460815,,12202670,7686626
2023-08-15,1286,37,27,40,38863109,12663376,460824,,12202552,7686541
2023-08-16,1633,59,49,49,38864742,12663339,460833,,12202506,7686504
2023-08-17,1679,77,66,63,38866421,12663320,460843,,12202477,7686484
2023-08-18,1678,85,60,51,38868099,12663315,460867,,12202448,7686452
2023-08-19,1705,82,54,63,38869804,12663316,460894,,12202422,7686445
2023-08-20,839,57,44,32,38870643,12663302,460906,,12202396,7686418
2023-08-21,227,4,2,8,38870870,12663210,460907,,12202303,7686345
2023-08-22,1230,57,46,46,38872100,12663169,460918,,12202251,7686307
2023-08-23,1524,66,50,53,38873624,12663157,460934,,12202223,7686290
2023-08-24,1568,95,68,72,38875192,12663181,460961,,12202220,7686297
2023-08-25,1439,87,43,50,38876631,12663206,461004,,12202202,7686292
2023-08-26,1598,82,49,66,38878229,12663236,461037,,12202199,7686315
2023-08-27,775,30,44,48,38879004,12663228,461021,,12202207,7686330
2023-08-28,182,5,3,9,38879186,12663210,461023,,12202187,7686318
2023-08-29,897,53,30,41,38880083,12663254,461046,,12202208,7686350
2023-08-30,1345,126,63,69,38881428,12663380,461109,,12202271,7686419
2023-08-31,1394,93,88,78,38882822,12663473,461114,,12202359,7686497
