"report_date","previous_day_total_doses_administered","previous_day_at_least_one","previous_day_fully_vaccinated","previous_day_3doses","total_doses_administered","total_individuals_at_least_one","total_individuals_partially_vaccinated","total_doses_in_fully_vaccinated_individuals","total_individuals_fully_vaccinated","total_individuals_3doses"
2021-01-01,6252,6242,2,,32208,32153,32142,22,11,
2021-01-02,4615,4603,6,,36823,36704,36691,26,13,
2021-01-03,5395,5388,3,,42218,42092,42076,32,16,
2021-01-04,5995,5993,0,,48213,48084,48069,30,15,
2021-01-05,9687,9662,21,,57900,57744,57709,70,35,
2021-01-06,12793,12328,450,,70693,70069,69587,964,482,
2021-01-07,16219,15508,697,,86912,85576,84397,2358,1179,
2021-01-08,18038,17023,1002,,104950,102599,100418,4362,2181,
2021-01-09,19500,18423,1064,,124450,121021,117776,6490,3245,
2021-01-10,11372,11332,38,,135822,132345,129062,6566,3283,
2021-01-11,11712,11661,48,,147534,144006,140675,6662,3331,
2021-01-12,14467,14160,298,,162001,158158,154529,7258,3629,
2021-01-13,15437,13813,1594,,177438,171957,166736,10442,5221,
2021-01-14,19192,16740,2436,,196630,188691,181035,15312,7656,
2021-01-15,20075,18017,2038,,216705,206697,197003,19388,9694,
2021-01-16,17119,15935,1171,,233824,222616,211751,21730,10865,
2021-01-17,11259,10015,1237,,245083,232616,220516,24200,12100,
2021-01-18,6794,6712,72,,251877,239305,227136,24338,12169,
2021-01-19,11829,9721,2094,,263706,249005,234742,28526,14263,
2021-01-20,10804,7215,3572,,274510,256197,238363,35668,17834,
2021-01-21,10976,6856,4092,,285486,263037,241111,43852,21926,
2021-01-22,9038,4321,4697,,294524,267321,240700,53242,26621,
2021-01-23,7462,3044,4390,,301986,270335,239325,62020,31010,
2021-01-24,4386,1829,2536,,306372,272146,238600,67092,33546,
2021-01-25,5322,1049,4264,,311694,273163,235354,75618,37809,
2021-01-26,9394,2867,6499,,321088,275998,231691,88614,44307,
2021-01-27,9898,2866,7004,,330986,278835,227525,102620,51310,
2021-01-28,13120,5743,7335,,344106,284545,225900,117290,58645,
2021-01-29,10698,3285,7379,,354804,287799,221776,132046,66023,
2021-01-30,9191,2730,6424,,363995,290487,218043,144888,72444,
2021-01-31,3383,1570,1768,,367378,292023,217812,148422,74211,
2021-02-01,2124,487,1609,,369502,292476,216660,151632,75816,
2021-02-02,4418,1365,2996,,373920,293803,214995,157616,78808,
2021-02-03,6237,1717,4458,,380157,295479,212220,166518,83259,
2021-02-04,9091,1720,7292,,389248,297156,206611,181090,90545,
2021-02-05,8446,1468,6904,,397694,298584,201141,194886,97443,
2021-02-06,10668,1871,8737,,408362,300400,194229,212342,106171,
2021-02-07,7576,1729,5796,,415938,302089,190134,223910,111955,
2021-02-08,8221,3096,5081,,424159,305137,188114,234046,117023,
2021-02-09,15010,3860,11082,,439169,308955,180866,256178,128089,
2021-02-10,15511,4932,10518,,454680,313835,175253,277164,138582,
2021-02-11,16366,3899,12409,,471046,317682,166722,301920,150960,
2021-02-12,17677,2099,15527,,488723,319742,153275,332934,166467,
2021-02-13,16213,2446,13752,,504936,322143,141943,360400,180200,
2021-02-14,12881,924,11925,,517817,323019,130924,384190,192095,
2021-02-15,7862,486,7328,,525679,323457,124060,398794,199397,
2021-02-16,5995,1042,4903,,531674,324456,120179,408554,204277,
2021-02-17,10168,1609,8525,,541842,326021,113247,425548,212774,
2021-02-18,13871,2955,10872,,555713,328928,105312,447232,223616,
2021-02-19,18490,6213,12210,,574203,335089,99294,471590,235795,
2021-02-20,22630,11133,11444,,596833,346159,98958,494402,247201,
2021-02-21,17242,10386,6822,,614075,356485,102504,507962,253981,
2021-02-22,13587,8759,4776,,627662,365175,106467,517416,258708,
2021-02-23,17868,11126,6671,,645530,376245,110902,530686,265343,
2021-02-24,18576,13611,4884,,664106,389800,119615,540370,270185,
2021-02-25,20810,16489,4264,,684916,406223,131822,548802,274401,
2021-02-26,24904,21839,3004,,709820,428002,150634,554736,277368,
2021-02-27,27466,23583,3840,,737286,451521,170361,562320,281160,
2021-02-28,20585,19144,1406,,757871,470611,188087,565048,282524,
2021-03-01,18227,17030,1148,,776098,487579,203954,567250,283625,
2021-03-02,24691,22280,2326,,800789,509798,223893,571810,285905,
2021-03-03,30598,27966,2578,,831387,537713,249263,576900,288450,
2021-03-04,34695,32462,2147,,866082,570109,279562,581094,290547,
2021-03-05,40002,38168,1785,,906084,608229,315931,584596,292298,
2021-03-06,44156,41948,2170,,950240,650122,355695,588854,294427,
2021-03-07,32735,31556,1175,,982975,681604,386060,591088,295544,
2021-03-08,24038,22162,1861,,1007013,703698,406347,594702,297351,
2021-03-09,33295,29844,3423,,1040308,733476,432748,601456,300728,
2021-03-10,38345,34082,4218,,1078653,767484,462586,609796,304898,
2021-03-11,43982,40709,3234,,1122635,808127,500047,616160,308080,
2021-03-12,47714,46002,1689,,1170349,854065,544346,619438,309719,
2021-03-13,57934,55058,2849,,1228283,909052,596538,625028,312514,
2021-03-14,43421,42181,1222,,1271704,951150,637482,627336,313668,
2021-03-15,32814,31116,1682,,1304518,982207,666900,630614,315307,
2021-03-16,53958,51659,2282,,1358476,1033801,716255,635092,317546,
2021-03-17,61066,58525,2497,,1419542,1092260,772267,639986,319993,
2021-03-18,61554,59093,2433,,1481096,1151281,828908,644746,322373,
2021-03-19,64478,61146,3274,,1545574,1212349,886755,651188,325594,
2021-03-20,62569,59979,2559,,1608143,1272272,944167,656210,328105,
2021-03-21,44004,42478,1539,,1652147,1314685,985078,659214,329607,
2021-03-22,31002,30035,978,,1683149,1344632,1014103,661058,330529,
2021-03-23,54623,51849,2723,,1737772,1396386,1063197,666378,333189,
2021-03-24,76437,73255,3134,,1814209,1469551,1133285,672532,336266,
2021-03-25,82917,80336,2534,,1897126,1549808,1211065,677486,338743,
2021-03-26,87016,83486,3490,,1984142,1633213,1291032,684362,342181,
2021-03-27,80864,77910,2868,,2065006,1711020,1366036,689968,344984,
2021-03-28,66998,65408,1555,,2132004,1776338,1429856,692964,346482,
2021-03-29,51740,49050,2651,,2183744,1825308,1476221,698174,349087,
2021-03-30,73586,70174,3350,,2257330,1895405,1543009,704792,352396,
2021-03-31,93154,89502,3586,,2350484,1984809,1628880,711858,355929,
2021-04-01,89320,85441,3840,,2439804,2070152,1710436,719432,359716,
2021-04-02,93089,88863,4210,,2532893,2158929,1795055,727748,363874,
2021-04-03,61010,59330,1736,,2593903,2218168,1852609,731118,365559,
2021-04-04,72331,70677,1650,,2666234,2288734,1921583,734302,367151,
2021-04-05,53731,53260,470,,2719965,2341910,1974337,735146,367573,
2021-04-06,79581,77713,1887,,2799546,2419521,2050115,738812,369406,
2021-04-07,108010,104944,3055,,2907556,2524340,2151937,744806,372403,
2021-04-08,114079,110105,4028,,3021635,2634334,2257959,752750,376375,
2021-04-09,109853,105624,4300,,3131488,2739840,2359230,761220,380610,
2021-04-10,109243,105481,3852,,3240731,2845193,2460797,768792,384396,
2021-04-11,98630,95512,3259,,3339361,2940580,2552984,775192,387596,
2021-04-12,76069,75004,1158,,3415430,3015436,2626750,777372,388686,
2021-04-13,99474,96090,3401,,3514904,3111417,2719378,784078,392039,
2021-04-14,117049,113285,3649,,3631953,3224584,2828936,791296,395648,
2021-04-15,113561,109503,3897,,3745514,3333961,2934473,798976,399488,
2021-04-16,118090,113716,4194,,3863604,3447567,3043929,807276,403638,
2021-04-17,112421,107830,4451,,3976025,3555263,3147233,816060,408030,
2021-04-18,88747,86510,2102,,4064772,3641650,3231572,820156,410078,
2021-04-19,68976,67441,1453,,4133748,3708961,3297481,822960,411480,
2021-04-20,102113,98788,3119,,4235861,3807587,3393053,829068,414534,
2021-04-21,142050,137772,4042,,4377911,3945185,3526677,837016,418508,
2021-04-22,139506,135353,3911,,4517417,4080409,3658046,844726,422363,
2021-04-23,138222,131798,6176,,4655639,4212053,3783572,856962,428481,
2021-04-24,130296,126232,3889,,4785935,4338137,3905823,864628,432314,
2021-04-25,102020,98609,3179,,4887955,4436598,4001172,870852,435426,
2021-04-26,71008,69302,1558,,4958963,4505769,4068845,873848,436924,
2021-04-27,98514,95424,2897,,5057477,4601032,4161274,879516,439758,
2021-04-28,120580,115953,4434,,5178057,4716817,4272697,888240,444120,
2021-04-29,124488,119292,5047,,5302545,4835942,4386844,898196,449098,
2021-04-30,115829,110572,5015,,5418374,4946341,4492305,908072,454036,
2021-05-01,111306,107434,3651,,5529680,5053594,4595984,915220,457610,
2021-05-02,79144,76168,2863,,5608824,5129605,4669198,920814,460407,
2021-05-03,56794,55124,1597,,5665618,5184574,4722630,923888,461944,
2021-05-04,91933,88563,3282,,5757551,5272959,4807810,930298,465149,
2021-05-05,138004,133296,4620,,5895555,5406086,4936380,939412,469706,
2021-05-06,141840,136884,4817,,6037395,5542786,5068325,948922,474461,
2021-05-07,150289,145247,4837,,6187684,5687873,5208634,958478,479239,
2021-05-08,142470,137779,4440,,6330154,5825457,5341857,967200,483600,
2021-05-09,124812,121162,3481,,6454966,5946455,5459438,974034,487017,
2021-05-10,97811,95823,1884,,6552777,6042089,5553255,977668,488834,
2021-05-11,113542,108859,4495,,6666319,6150746,5657488,986516,493258,
2021-05-12,145057,138023,6886,,6811376,6288590,5788512,1000156,500078,
2021-05-13,142713,135321,7238,,6954089,6423736,5916494,1014484,507242,
2021-05-14,148869,138778,9920,,7102958,6562326,6045229,1034194,517097,
2021-05-15,159745,149697,9867,,7262703,6711836,6184947,1053778,526889,
2021-05-16,144360,136091,8062,,7407063,6847759,6312888,1069742,534871,
2021-05-17,114983,110885,3944,,7522046,6958455,6419716,1077478,538739,
2021-05-18,111343,100476,10665,,7633389,7058735,6509393,1098684,549342,
2021-05-19,149888,133474,16236,,7783277,7192057,6626553,1131008,565504,
2021-05-20,151574,131580,19777,,7934851,7323448,6738236,1170424,585212,
2021-05-21,165401,140893,24249,,8100252,7464160,6854776,1218768,609384,
2021-05-22,199447,172247,26972,,8299699,7636209,6999934,1272550,636275,
2021-05-23,139837,127467,12224,,8439536,7763498,7115061,1296874,648437,
2021-05-24,100299,93327,6827,,8539835,7856652,7201458,1310388,655194,
2021-05-25,90475,82989,7276,,8630310,7939478,7277075,1324806,662403,
2021-05-26,139790,113020,26506,,8770100,8052311,7363472,1377678,688839,
2021-05-27,152068,123048,28767,,8922168,8175202,7457665,1435074,717537,
2021-05-28,163875,132318,31249,,9086043,8307347,7558620,1497454,748727,
2021-05-29,153394,117132,36029,,9239437,8424329,7639629,1569400,784700,
2021-05-30,149728,119021,30479,,9389165,8543180,7728063,1630234,815117,
2021-05-31,99218,79823,19202,,9488383,8622833,7788578,1668510,834255,
2021-06-01,124208,90619,33250,,9612591,8713257,7845827,1734860,867430,
2021-06-02,145327,102160,42916,,9757918,8815236,7904959,1820554,910277,
2021-06-03,155377,99920,55176,,9913295,8914971,7949589,1930764,965382,
2021-06-04,181729,115544,65913,,10095024,9030316,7999109,2062414,1031207,
2021-06-05,172038,103440,68315,,10267062,9133558,8034121,2198874,1099437,
2021-06-06,163397,91872,71245,,10430459,9225252,8054640,2341224,1170612,
2021-06-07,119565,63059,56288,,10550024,9288114,8061289,2453650,1226825,
2021-06-08,161899,72455,89004,,10711923,9360380,8044631,2631498,1315749,
2021-06-09,181473,70812,110190,,10893396,9431015,8005157,2851716,1425858,
2021-06-10,185591,66430,118669,,11078987,9497242,7952806,3088872,1544436,
2021-06-11,204800,67524,136515,,11283787,9564580,7883711,3361738,1680869,
2021-06-12,199745,62683,136459,,11483532,9627081,7809845,3634472,1817236,
2021-06-13,190351,58898,130921,,11673883,9685804,7737727,3896154,1948077,
2021-06-14,137692,38699,98594,,11811575,9724307,7677741,4093132,2046566,
2021-06-15,189562,42623,146581,,12001137,9766711,7573661,4386100,2193050,
2021-06-16,206267,42438,163182,,12207404,9808953,7452824,4712258,2356129,
2021-06-17,210481,37946,171949,,12417885,9846684,7318698,5055972,2527986,
2021-06-18,217204,35366,181234,,12635089,9881860,7172732,5418256,2709128,
2021-06-19,215905,35505,179723,,12850994,9917159,7028420,5777478,2888739,
2021-06-20,186280,35574,150127,,13037274,9952535,6913777,6077516,3038758,
2021-06-21,120438,20831,99103,,13157712,9973171,6835402,6275538,3137769,
2021-06-22,204955,27529,176669,,13362667,10000506,6686177,6628658,3314329,
2021-06-23,230550,28638,201164,,13593217,10028944,6513559,7030770,3515385,
2021-06-24,227707,26679,200270,,13820924,10055427,6339882,7431090,3715545,
2021-06-25,251130,27998,222381,,14072054,10083223,6145416,7875614,3937807,
2021-06-26,261316,30017,230591,,14333370,10113014,5944757,8336514,4168257,
2021-06-27,205007,27790,176609,,14538377,10140622,5795866,8689512,4344756,
2021-06-28,199259,20957,177733,,14737636,10161381,5639017,9044728,4522364,
2021-06-29,250122,24497,224890,,14987758,10185637,5438537,9494200,4747100,
2021-06-30,275552,24181,250803,,15263310,10209615,5211841,9995548,4997774,
2021-07-01,271979,25313,246111,,15535289,10234710,4990964,10487492,5243746,
2021-07-02,144737,11594,132913,,15680026,10246130,4869573,10753114,5376557,
2021-07-03,216904,19936,196737,,15896930,10265844,4692699,11146290,5573145,
2021-07-04,196222,19459,176538,,16093152,10285117,4535553,11499128,5749564,
2021-07-05,148723,12446,136134,,16241875,10297373,4411803,11771140,5885570,
2021-07-06,220044,20000,199827,,16461919,10317157,4231906,12170502,6085251,
2021-07-07,246620,22970,223407,,16708539,10339901,4031391,12617020,6308510,
2021-07-08,231224,21367,209644,,16939763,10361062,3843043,13036038,6518019,
2021-07-09,227008,21514,205325,,17166771,10382374,3659162,13446424,6723212,
2021-07-10,209070,20542,188371,,17375841,10402712,3491266,13822892,6911446,
2021-07-11,171686,17589,153969,,17547527,10420100,3354832,14130536,7065268,
2021-07-12,123137,11445,111593,,17670664,10431356,3254632,14353448,7176724,
2021-07-13,178516,19033,159339,,17849180,10450167,3114259,14671816,7335908,
2021-07-14,180047,19307,160583,,18029227,10469259,2972931,14992656,7496328,
2021-07-15,167212,19588,147449,,18196439,10488636,2845023,15287226,7643613,
2021-07-16,169368,19915,149302,,18365807,10508349,2715587,15585524,7792762,
2021-07-17,173024,20273,152620,,18538831,10528373,2583183,15890380,7945190,
2021-07-18,133642,15939,117564,,18672473,10544128,2481522,16125212,8062606,
2021-07-19,91989,10421,81460,,18764462,10554336,2410445,16287782,8143891,
2021-07-20,133550,16958,116536,,18898012,10571054,2310803,16520502,8260251,
2021-07-21,140090,16988,123032,,19038102,10587827,2204706,16766242,8383121,
2021-07-22,125630,17653,107839,,19163732,10605256,2114473,16981566,8490783,
2021-07-23,120282,16997,103078,,19284014,10622012,2028350,17187324,8593662,
2021-07-24,126704,18336,108130,,19410718,10640145,1938516,17403258,8701629,
2021-07-25,103653,14869,88653,,19514371,10654790,1864689,17580202,8790101,
2021-07-26,66697,9892,56710,,19581068,10664464,1817834,17693260,8846630,
2021-07-27,92392,15321,76909,,19673460,10679524,1756202,17846644,8923322,
2021-07-28,93953,16472,77410,,19767413,10695761,1695220,18001082,9000541,
2021-07-29,89404,16706,72536,,19856817,10712235,1639346,18145778,9072889,
2021-07-30,84072,16105,67851,,19940889,10728112,1587560,18281104,9140552,
2021-07-31,83870,15733,67990,,20024759,10743627,1535275,18416704,9208352,
2021-08-01,61881,11324,50372,,20086640,10754725,1496192,18517066,9258533,
2021-08-02,42496,7420,34956,,20129136,10761947,1468624,18586646,9293323,
2021-08-03,33300,5959,27168,,20162436,10767673,1447392,18640562,9320281,
2021-08-04,61330,12377,48762,,20223766,10779815,1410970,18737690,9368845,
2021-08-05,59463,12552,46759,,20283229,10792159,1376719,18830880,9415440,
2021-08-06,56030,11859,43954,,20339259,10803758,1344593,18918330,9459165,
2021-08-07,62382,12137,50050,,20401641,10815634,1306637,19017994,9508997,
2021-08-08,48698,9277,39229,,20450339,10824683,1276662,19096042,9548021,
2021-08-09,30861,5938,24745,,20481200,10830407,1257828,19145158,9572579,
2021-08-10,49267,10516,38448,,20530467,10840643,1229862,19221562,9610781,
2021-08-11,48730,10768,37711,,20579197,10851164,1202888,19296552,9648276,
2021-08-12,49261,11205,37824,,20628458,10862118,1176227,19371782,9685891,
2021-08-13,49639,11736,37628,,20678097,10873613,1150305,19446616,9723308,
2021-08-14,51227,12137,38880,,20729324,10885500,1123536,19523928,9761964,
2021-08-15,41776,9856,31695,,20771100,10895154,1101667,19586974,9793487,
2021-08-16,26744,6189,20405,,20797844,10901120,1087425,19627390,9813695,
2021-08-17,40511,11061,29182,,20838355,10911931,1069280,19685302,9842651,
2021-08-18,41902,11974,29684,,20880257,10923663,1051538,19744250,9872125,
2021-08-19,45902,16539,29100,,20926159,10939951,1038949,19802004,9901002,
2021-08-20,46456,16297,29746,,20972615,10955992,1025473,19861038,9930519,
2021-08-21,47961,15151,32442,,21020576,10970883,1008149,19925468,9962734,
2021-08-22,34399,10808,23320,,21054975,10981445,995613,19971664,9985832,
2021-08-23,23223,7005,16000,,21078198,10988215,986597,20003236,10001618,
2021-08-24,37653,13374,23822,,21115851,11001335,976126,20050418,10025209,
2021-08-25,41364,14426,26327,,21157215,11015505,964206,20102598,10051299,
2021-08-26,39275,13556,24977,,21196490,11028785,952750,20152070,10076035,
2021-08-27,37679,12944,23689,,21234169,11041488,941978,20199020,10099510,
2021-08-28,40130,13426,25525,,21274299,11054635,929855,20249560,10124780,
2021-08-29,30563,10257,19945,,21304862,11064660,920148,20289024,10144512,
2021-08-30,18237,6140,11846,,21323099,11070552,914413,20312278,10156139,
2021-08-31,32718,11940,19624,,21355817,11082224,906701,20351046,10175523,
2021-09-01,36254,12949,21960,,21392071,11094940,897674,20394532,10197266,
2021-09-02,37786,15646,19673,,21429857,11110334,893622,20433424,10216712,
2021-09-03,46892,21097,22444,,21476749,11131182,892256,20477852,10238926,
2021-09-04,46885,20590,24779,,21523634,11151526,888044,20526964,10263482,
2021-09-05,33081,14207,18580,,21556715,11165489,883651,20563676,10281838,
2021-09-06,21719,9491,12036,,21578434,11174731,881089,20587284,10293642,
2021-09-07,15013,6728,8099,,21593447,11181202,879701,20603002,10301501,
2021-09-08,41152,17116,20938,,21634599,11198054,875861,20644386,10322193,
2021-09-09,41456,16980,19680,,21676055,11214757,873136,20683242,10341621,
2021-09-10,39659,15512,19013,,21715714,11230006,869617,20720778,10360389,
2021-09-11,42386,15936,23339,,21758100,11245663,862193,20766940,10383470,
2021-09-12,29972,11533,17871,,21788072,11256902,855825,20802154,10401077,
2021-09-13,16092,6406,9188,,21804164,11263074,853028,20820092,10410046,
2021-09-14,29912,11561,15295,,21834076,11274333,849267,20850132,10425066,
2021-09-15,39285,14025,19425,,21873361,11288098,843851,20888494,10444247,
2021-09-16,39353,13988,19250,,21912714,11301851,838566,20926570,10463285,
2021-09-17,38936,13612,19343,,21951650,11315220,832823,20964794,10482397,
2021-09-18,41261,14088,23549,,21992911,11329035,823341,21011388,10505694,
2021-09-19,30664,10829,18985,,22023575,11339605,815172,21048866,10524433,
2021-09-20,16733,6098,10177,,22040308,11345449,811070,21068758,10534379,
2021-09-21,31367,11216,16996,,22071675,11356400,805274,21102252,10551126,
2021-09-22,41818,14818,22929,,22113493,11370922,797142,21147560,10573780,
2021-09-23,47234,16138,26034,,22160727,11386795,787227,21199136,10599568,
2021-09-24,46318,15637,26657,,22207045,11402172,776188,21251968,10625984,
2021-09-25,48203,15258,29950,,22255248,11417177,761477,21311400,10655700,
2021-09-26,37516,12425,24496,,22292764,11429327,749385,21359884,10679942,
2021-09-27,19159,6530,12322,,22311923,11435603,743577,21384052,10692026,
2021-09-28,30961,11295,17883,,22342884,11446639,736977,21419324,10709662,
2021-09-29,37892,12477,21729,,22380776,11458845,727705,21462280,10731140,
2021-09-30,37347,11655,21375,,22418123,11470241,717966,21504550,10752275,
2021-10-01,30884,9811,18416,,22449007,11479826,709348,21540956,10770478,
2021-10-02,37143,11160,23590,,22486150,11490716,696900,21587632,10793816,
2021-10-03,27208,8165,18324,,22513358,11498640,686728,21623824,10811912,
2021-10-04,14869,4747,9803,,22528227,11503140,681654,21642972,10821486,
2021-10-05,26835,8598,15877,,22555062,11511477,674360,21674234,10837117,
2021-10-06,31668,9638,18514,,22586730,11520856,665476,21710760,10855380,
2021-10-07,30353,9398,17122,,22617083,11530003,657739,21744528,10872264,
2021-10-08,32846,10745,18855,,22649929,11540477,649615,21781724,10890862,
2021-10-09,34147,10668,21017,,22684076,11550882,639252,21823260,10911630,
2021-10-10,23417,7661,15089,,22707493,11558292,631812,21852960,10926480,
2021-10-11,12004,3839,7866,,22719497,11561881,627769,21868224,10934112,
2021-10-12,5115,1627,3271,,22724612,11563230,626110,21874240,10937120,
2021-10-13,29120,9192,18096,,22753732,11572132,617190,21909884,10954942,
2021-10-14,29022,8905,17752,,22782754,11580761,608333,21944856,10972428,
2021-10-15,29105,8832,18173,,22811859,11589330,598979,21980702,10990351,
2021-10-16,31142,8986,19872,,22843001,11598025,588081,22019888,11009944,
2021-10-17,23719,7264,15383,,22866720,11605035,579949,22050172,11025086,
2021-10-18,12308,3747,8148,,22879028,11608501,575536,22065930,11032965,
2021-10-19,21282,6631,12638,,22900310,11614849,569516,22090666,11045333,
2021-10-20,25674,7541,14925,,22925984,11622143,562119,22120048,11060024,
2021-10-21,23182,6684,13032,,22949166,11628558,555760,22145596,11072798,
2021-10-22,26130,7315,15120,,22975296,11635550,547939,22175222,11087611,
2021-10-23,28188,7606,17162,,23003484,11642894,538376,22209036,11104518,
2021-10-24,19354,5728,12604,,23022838,11648366,531488,22233756,11116878,
2021-10-25,9932,2710,6477,,23032770,11650807,527713,22246188,11123094,
2021-10-26,18925,5393,11106,,23051695,11655922,521991,22267862,11133931,
2021-10-27,22862,6081,13217,,23074557,11661748,514841,22293814,11146907,
2021-10-28,22307,5791,12646,,23096864,11667251,507975,22318552,11159276,
2021-10-29,22816,5732,13051,,23119680,11672681,500641,22344080,11172040,
2021-10-30,24121,6047,14619,,23143801,11678456,492057,22372798,11186399,
2021-10-31,16487,4596,10604,,23160288,11682758,486044,22393428,11196714,
2021-11-01,7872,2081,5056,,23168160,11684559,483056,22403006,11201503,
2021-11-02,15628,4364,7748,,23183788,11688634,479661,22417946,11208973,
2021-11-03,18633,5070,9606,,23202421,11693401,475115,22436572,11218286,
2021-11-04,19509,4875,10034,,23221930,11698000,469941,22456118,11228059,
2021-11-05,21473,4405,9524,,23243403,11702116,464808,22474616,11237308,
2021-11-06,25338,5209,12156,,23268741,11707056,457844,22498424,11249212,
2021-11-07,21454,4025,8925,,23290195,11710800,452932,22515736,11257868,
2021-11-08,11991,2110,4732,,23302186,11712615,450294,22524642,11262321,
2021-11-09,24130,3851,7653,,23326316,11716145,446482,22539326,11269663,
2021-11-10,28479,4508,8997,,23354795,11720377,441979,22556796,11278398,
2021-11-11,28766,4309,9100,,23383561,11724389,437179,22574420,11287210,
2021-11-12,26750,4166,8244,,23410311,11728264,433087,22590354,11295177,
2021-11-13,34319,5081,11416,,23444630,11733039,426743,22612592,11306296,
2021-11-14,23224,3899,8609,,23467854,11736675,422026,22629298,11314649,
2021-11-15,12702,2185,4495,,23480556,11738600,419708,22637784,11318892,
2021-11-16,26184,3933,7486,,23506740,11742277,416151,22652252,11326126,
2021-11-17,31176,4047,7826,,23537916,11746042,412362,22667360,11333680,
2021-11-18,32509,3868,7529,,23570425,11749604,408687,22681834,11340917,
2021-11-19,35481,3864,7758,,23605906,11753167,404781,22696772,11348386,
2021-11-20,40117,4382,8820,,23646023,11757268,400334,22713868,11356934,
2021-11-21,28127,3439,6952,,23674150,11760445,396807,22727276,11363638,
2021-11-22,14900,1951,3894,,23689050,11762119,394858,22734522,11367261,
2021-11-23,33056,3278,6010,,23722106,11765117,392118,22745998,11372999,
2021-11-24,42666,3760,6809,,23764772,11768573,389058,22759030,11379515,
2021-11-25,46048,3934,6577,,23810820,11772232,386412,22771640,11385820,
2021-11-26,52868,11348,6616,,23863688,11783309,391137,22784344,11392172,
2021-11-27,63523,22356,7039,,23927211,11805384,406444,22797880,11398940,
2021-11-28,51461,27742,5317,,23978672,11832833,428857,22807952,11403976,
2021-11-29,33528,18933,2883,,24012200,11851505,444896,22813218,11406609,
2021-11-30,56044,20687,5137,,24068244,11871911,460436,22822950,11411475,
2021-12-01,69543,26243,5639,,24137787,11897848,481026,22833644,11416822,
2021-12-02,71637,26488,5039,,24209424,11924038,502462,22843152,11421576,
2021-12-03,73427,25096,5171,,24282851,11948838,522381,22852914,11426457,
2021-12-04,81161,27784,6075,47282,24364012,11976329,544081,,11432248,807729
2021-12-05,62638,31932,4415,26269,24426650,12007966,571590,,11436376,833894
2021-12-06,38629,19144,2713,16757,24465279,12026821,588014,,11438807,850573
2021-12-07,60296,14852,4482,40948,24525575,12041401,598374,,11443027,891447
2021-12-08,73454,19056,4682,49713,24599029,12060180,612738,,11447442,941082
2021-12-09,74507,18274,4347,51866,24673536,12078145,626657,,11451488,992863
2021-12-10,77509,17589,4659,55250,24751045,12095453,639582,,11455871,1048032
2021-12-11,83195,20406,5838,56939,24834240,12115570,654136,,11461434,1104885
2021-12-12,60758,22699,4158,33858,24894998,12137989,672671,,11465318,1138654
2021-12-13,34938,11603,2412,20900,24929936,12149295,681852,,11467443,1159459
2021-12-14,101988,9002,3875,89067,25031924,12157986,686964,,11471022,1248406
2021-12-15,127704,12429,4515,110722,25159628,12170111,694868,,11475243,1359028
2021-12-16,139369,12468,4255,122630,25298997,12182293,703071,,11479222,1481559
2021-12-17,159181,12403,4525,142231,25458178,12194421,710940,,11483481,1623693
2021-12-18,175592,13523,4925,157098,25633770,12207650,719526,,11488124,1780696
2021-12-19,140444,18160,3934,118313,25774214,12225509,733744,,11491765,1898898
2021-12-20,106824,10305,2746,93726,25881038,12235546,741293,,11494253,1992526
2021-12-21,215401,12966,4322,198091,26096439,12248196,749930,,11498266,2190496
2021-12-22,237265,14427,5204,217751,26333704,12262323,759139,,11503184,2408129
2021-12-23,257786,11731,5091,240866,26591490,12273749,765773,,11507976,2648889
2021-12-24,223640,9465,4576,209532,26815130,12282917,770658,,11512259,2858305
2021-12-25,89734,3889,2513,83344,26904864,12286531,772029,,11514502,2941542
2021-12-26,11900,388,360,11142,26916764,12286627,772049,,11514578,2952554
2021-12-27,46945,1491,1116,44307,26963709,12287873,772417,,11515456,2996741
2021-12-28,144789,6100,4012,134614,27108498,12293679,774494,,11519185,3131224
2021-12-29,175474,9377,4584,161443,27283972,12302760,779283,,11523477,3292539
2021-12-30,200074,10135,5352,184545,27484046,12312592,784051,,11528541,3476950
2021-12-31,195215,10008,5806,179148,27679261,12322311,788244,,11534067,3655972
2022-01-01,96958,5384,3883,87364,27776219,12327386,789737,,11537649,3743187
2022-01-02,19451,943,930,17448,27795670,12328038,789741,,11538297,3760489
2022-01-03,88257,4773,4593,78810,27883927,12332501,789913,,11542588,3839146
2022-01-04,146375,6001,5319,135015,28030302,12338174,790582,,11547592,3974005
2022-01-05,177520,7634,7298,162414,28207822,12345454,790907,,11554547,4136259
2022-01-06,191549,7214,6790,177018,28399371,12352349,791320,,11561029,4313122
2022-01-07,191305,7968,7006,175517,28590676,12359973,792270,,11567703,4488466
2022-01-08,181689,8630,6642,165228,28772365,12368271,794245,,11574026,4653538
2022-01-09,131106,9867,7187,113959,28903471,12377816,796920,,11580896,4767337
2022-01-10,90563,5108,4489,80835,28994034,12382601,797529,,11585072,4848019
2022-01-11,138903,6163,6583,125452,29132937,12388417,797096,,11591321,4973281
2022-01-12,157042,8165,8060,138694,29289979,12396253,797196,,11599057,5111807
2022-01-13,162691,9215,9217,141549,29452670,12405106,797180,,11607926,5253173
2022-01-14,159900,10754,10386,136068,29612570,12415498,797543,,11617955,5389043
2022-01-15,161213,11013,11677,135889,29773783,12426139,796868,,11629271,5524739
2022-01-16,109791,9294,9678,89457,29883574,12435071,796477,,11638594,5613978
2022-01-17,65789,5939,6567,52642,29949363,12440674,795839,,11644835,5666435
2022-01-18,36121,2005,2135,31157,29985484,12442324,795698,,11646626,5697396
2022-01-19,101331,5586,6723,85962,30086815,12447510,794543,,11652967,5783131
2022-01-20,103611,6327,7007,85739,30190426,12453453,793855,,11659598,5868647
2022-01-21,102119,6234,8059,82513,30292545,12459283,792016,,11667267,5950932
2022-01-22,102593,8719,12076,78119,30395138,12467613,788652,,11678961,6028823
2022-01-23,76707,7308,14000,54800,30471845,12474578,781953,,11692625,6083401
2022-01-24,42268,3198,7935,30746,30514113,12477412,777198,,11700214,6113940
2022-01-25,62571,3759,8373,48119,30576684,12480791,772569,,11708222,6161840
2022-01-26,77894,4918,13172,55693,30654578,12485332,764310,,11721022,6217291
2022-01-27,78082,4896,13246,56054,30732660,12489856,755950,,11733906,6273108
2022-01-28,77292,4676,13677,53900,30809952,12494174,746936,,11747238,6326789
2022-01-29,84830,5531,17717,58119,30894782,12499341,734743,,11764598,6384663
2022-01-30,66514,5025,20632,40160,30961296,12504024,719122,,11784902,6424598
2022-01-31,34755,2177,9888,22351,30996051,12505882,711402,,11794480,6446760
2022-02-01,51355,3266,9665,36529,31047406,12508795,704993,,11803802,6483064
2022-02-02,57717,3849,12401,38681,31105123,12512313,696426,,11815887,6521545
2022-02-03,52584,3611,11512,34301,31157707,12515547,688513,,11827034,6555595
2022-02-04,43100,2946,10567,27286,31200807,12518182,680882,,11837300,6582687
2022-02-05,58729,3747,14473,37566,31259536,12521597,670144,,11851453,6620040
2022-02-06,49866,3642,16120,29574,31309402,12524916,657661,,11867255,6649390
2022-02-07,23241,1691,7811,13446,31332643,12526281,651528,,11874753,6662612
2022-02-08,33405,2360,7255,21972,31366048,12528311,646626,,11881685,6684351
2022-02-09,38891,2785,8923,24411,31404939,12530737,640482,,11890255,6708510
2022-02-10,37542,2765,8838,22553,31442481,12533165,634405,,11898760,6730832
2022-02-11,39453,2726,10295,23006,31481934,12535544,626826,,11908718,6753600
2022-02-12,42054,2959,11457,25321,31523988,12538169,618317,,11919852,6778697
2022-02-13,36328,2802,13147,19943,31560316,12540684,607969,,11932715,6798442
2022-02-14,16985,1176,6124,9475,31577301,12541585,603013,,11938572,6807717
2022-02-15,19368,1387,4758,11880,31596669,12542648,599632,,11943016,6819370
2022-02-16,26027,1767,7736,14949,31622696,12544118,593659,,11950459,6834118
2022-02-17,26770,1684,7527,14986,31649466,12545447,587807,,11957640,6848849
2022-02-18,23951,1353,6614,13680,31673417,12546483,582534,,11963949,6862320
2022-02-19,37839,1904,8339,26055,31711256,12548055,576094,,11971961,6888133
2022-02-20,32581,1499,7964,22807,31743837,12549253,569621,,11979632,6910735
2022-02-21,17503,913,3678,12758,31761340,12549870,566847,,11983023,6923281
2022-02-22,9113,430,1555,6958,31770453,12550010,565717,,11984293,6930028
2022-02-23,25341,1327,4796,17298,31795794,12551027,562241,,11988786,6947090
2022-02-24,24577,1401,5233,15485,31820371,12552106,558404,,11993702,6962332
2022-02-25,23111,1396,5138,14509,31843482,12553208,554655,,11998553,6976615
2022-02-26,25237,1386,5910,16560,31868719,12554284,550124,,12004160,6992949
2022-02-27,26962,1371,7372,17705,31895681,12555386,544112,,12011274,7010459
2022-02-28,10130,594,2531,6745,31905811,12555727,542167,,12013560,7017021
2022-03-01,13204,949,3152,8167,31919015,12556371,539954,,12016417,7024971
2022-03-02,15419,1164,3578,9620,31934434,12557273,537533,,12019740,7034413
2022-03-03,14302,1079,3228,8689,31948736,12558040,535376,,12022664,7042871
2022-03-04,14479,993,3445,8318,31963215,12558712,532920,,12025792,7050936
2022-03-05,18538,1278,4998,11186,31981753,12559680,529189,,12030491,7061898
2022-03-06,16519,1088,5526,9607,31998272,12560487,524745,,12035742,7071298
2022-03-07,5950,469,1861,3509,32004222,12560671,523346,,12037325,7074590
2022-03-08,7369,701,1944,4159,32011591,12561094,522096,,12038998,7078550
2022-03-09,11177,908,2739,6407,32022768,12561726,520259,,12041467,7084755
2022-03-10,12769,1046,3258,6842,32035537,12562495,518040,,12044455,7091384
2022-03-11,12893,905,3410,6866,32048430,12563111,515527,,12047584,7098034
2022-03-12,14692,1049,4189,8310,32063122,12563888,512384,,12051504,7106140
2022-03-13,14752,1091,4999,8336,32077874,12564688,508472,,12056216,7114239
2022-03-14,6334,450,2229,3499,32084208,12564867,506690,,12058177,7117524
2022-03-15,10200,793,2625,5974,32094408,12565370,504846,,12060524,7123284
2022-03-16,13068,935,3668,6954,32107476,12566015,502110,,12063905,7130007
2022-03-17,13200,1049,3963,6759,32120676,12566776,499189,,12067587,7136546
2022-03-18,11909,915,3147,6433,32132585,12567388,496947,,12070441,7142755
2022-03-19,14444,1005,4163,7903,32147029,12568113,493787,,12074326,7150439
2022-03-20,11753,992,3960,6373,32158782,12568834,490814,,12078020,7156604
2022-03-21,5059,415,1589,2814,32163841,12568990,489636,,12079354,7159215
2022-03-22,6716,552,1559,3894,32170557,12569254,488623,,12080631,7162893
2022-03-23,9971,785,2300,5195,32180528,12569723,487105,,12082618,7167847
2022-03-24,9297,723,2377,4613,32189825,12570182,485442,,12084740,7172256
2022-03-25,9229,781,2156,4754,32199054,12570700,484059,,12086641,7176798
2022-03-26,10931,937,2837,5506,32209985,12571360,482157,,12089203,7182085
2022-03-27,10228,911,3539,5301,32220213,12572011,479525,,12092486,7187175
2022-03-28,3584,322,1109,1987,32223797,12572092,478735,,12093357,7188967
2022-03-29,5352,500,1217,2692,32229149,12572307,478012,,12094295,7191437
2022-03-30,7858,748,1839,4124,32237007,12572776,476916,,12095860,7195336
2022-03-31,8655,689,1926,4414,32245662,12573176,475673,,12097503,7199528
2022-04-01,9315,802,1917,4889,32254977,12573686,474549,,12099137,7204178
2022-04-02,10447,886,2215,5573,32265424,12574285,473208,,12101077,7209534
2022-04-03,9212,880,2569,5067,32274636,12574908,471513,,12103395,7214399
2022-04-04,4204,388,1006,2407,32278840,12575034,470892,,12104142,7216602
2022-04-05,6082,601,1037,3054,32284922,12575295,470450,,12104845,7219381
2022-04-06,8382,715,1479,4384,32293304,12575719,469681,,12106038,7223538
2022-04-07,10349,733,1688,4837,32303653,12576152,468721,,12107431,7228132
2022-04-08,23997,812,1584,4836,32327650,12576686,467943,,12108743,7232752
2022-04-09,30498,969,1975,5894,32358148,12577357,466928,,12110429,7238423
2022-04-10,24869,976,2393,5335,32383017,12578074,465505,,12112569,7243556
2022-04-11,12575,386,877,2432,32395592,12578210,465010,,12113200,7245786
2022-04-12,28134,693,1021,3537,32423726,12578599,464675,,12113924,7249090
2022-04-13,37785,853,1562,4927,32461511,12579153,463962,,12115191,7253787
2022-04-14,37905,760,1616,4915,32499416,12579600,463103,,12116497,7258449
2022-04-15,43405,1234,2104,6726,32542821,12580536,462229,,12118307,7264938
2022-04-16,8095,357,650,1741,32550916,12580633,461934,,12118699,7266463
2022-04-17,21027,871,1925,4319,32571943,12581220,460873,,12120347,7270559
2022-04-18,5461,306,463,1290,32577404,12581239,460711,,12120528,7271608
2022-04-19,22657,615,773,3103,32600061,12581571,460544,,12121027,7274491
2022-04-20,40344,1063,1402,4620,32640405,12582308,460202,,12122106,7278847
2022-04-21,38757,943,1600,4683,32679162,12582955,459536,,12123419,7283296
2022-04-22,35638,1017,1436,4270,32714800,12583700,459110,,12124590,7287348
2022-04-23,34659,1005,1740,4714,32749459,12584421,458372,,12126049,7291823
2022-04-24,20816,1021,1889,3777,32770275,12585192,457501,,12127691,7295406
2022-04-25,8299,453,691,1707,32778574,12585376,457262,,12128114,7296897
2022-04-26,24624,733,948,3145,32803198,12585817,457041,,12128776,7299805
2022-04-27,33604,955,1370,3939,32836802,12586495,456618,,12129877,7303526
2022-04-28,32844,929,1419,3931,32869646,12587151,456119,,12131032,7307234
2022-04-29,32062,1098,1379,3909,32901708,12587951,455831,,12132120,7310914
2022-04-30,30290,925,1538,4025,32931998,12588578,455211,,12133367,7314703
2022-05-01,16755,769,1579,2970,32948753,12589049,454396,,12134653,7317429
2022-05-02,5936,309,526,1098,32954689,12589062,454175,,12134887,7318300
2022-05-03,20932,588,834,2347,32975621,12589345,453923,,12135422,7320408
2022-05-04,29418,800,1093,3290,33005039,12589835,453625,,12136210,7323449
2022-05-05,29100,872,1165,3125,33034139,12590394,453322,,12137072,7326329
2022-05-06,29100,1147,1286,2987,33063239,12591253,453178,,12138075,7329089
2022-05-07,28493,870,1266,3113,33091732,12591833,452777,,12139056,7331978
2022-05-08,16001,895,1309,2323,33107733,12592471,452361,,12140110,7334100
2022-05-09,5897,293,474,943,33113630,12592497,452173,,12140324,7334833
2022-05-10,21232,698,724,2120,33134862,12592877,452140,,12140737,7336693
2022-05-11,28955,837,1087,2656,33163817,12593382,451886,,12141496,7339078
2022-05-12,28244,799,1086,2515,33192061,12593884,451595,,12142289,7341352
2022-05-13,27598,878,1119,2469,33219659,12594451,451349,,12143102,7343564
2022-05-14,25694,807,1100,2610,33245353,12594944,451049,,12143895,7345920
2022-05-15,14851,751,1276,2058,33260204,12595423,450517,,12144906,7347759
2022-05-16,6387,326,533,1048,33266591,12595511,450306,,12145205,7348620
2022-05-17,19607,590,781,1743,33286198,12595785,450108,,12145677,7350114
2022-05-18,26548,877,1101,2277,33312746,12596397,449879,,12146518,7352175
2022-05-19,24443,684,1157,2164,33337189,12596814,449399,,12147415,7354122
2022-05-20,24271,801,1140,2218,33361460,12597344,449056,,12148288,7356120
2022-05-21,22406,691,1167,2351,33383866,12597725,448571,,12149154,7358228
2022-05-22,10561,549,891,1489,33394427,12598013,448224,,12149789,7359500
2022-05-23,4574,242,465,793,33399001,12597995,447999,,12149996,7360084
2022-05-24,2629,120,182,442,33401630,12597859,447935,,12149924,7360315
2022-05-25,19369,656,949,1954,33420999,12598248,447632,,12150616,7362058
2022-05-26,20649,664,951,1912,33441648,12598638,447339,,12151299,7363747
2022-05-27,21765,818,1062,2078,33463413,12599168,447092,,12152076,7365592
2022-05-28,19418,722,1167,2152,33482831,12599619,446644,,12152975,7367529
2022-05-29,12113,760,1283,1726,33494944,12600144,446114,,12154030,7369063
2022-05-30,4580,311,550,751,33499524,12600209,445872,,12154337,7369616
2022-05-31,13552,573,753,1667,33513076,12600480,445686,,12154794,7371043
2022-06-01,16614,704,972,1879,33529690,12600882,445416,,12155466,7372669
2022-06-02,14610,557,867,1678,33544300,12601127,445099,,12156028,7374106
2022-06-03,16112,699,1097,1817,33560412,12601546,444695,,12156851,7375703
2022-06-04,13325,647,1166,1845,33573737,12601935,444171,,12157764,7377346
2022-06-05,7869,587,1112,1432,33581606,12602273,443642,,12158631,7378586
2022-06-06,3295,207,446,641,33584901,12602231,443400,,12158831,7379025
2022-06-07,11225,476,728,1372,33596126,12602407,443143,,12159264,7380153
2022-06-08,14070,668,1013,1612,33610196,12602814,442793,,12160021,7381545
2022-06-09,13382,663,927,1676,33623578,12603189,442524,,12160665,7382989
2022-06-10,13856,686,1069,1698,33637434,12603588,442132,,12161456,7384457
2022-06-11,12986,616,1031,1846,33650420,12603918,441715,,12162203,7386080
2022-06-12,8098,643,1236,1504,33658518,12604303,441118,,12163185,7387377
2022-06-13,3190,284,422,713,33661708,12604319,440975,,12163344,7387880
2022-06-14,10131,512,666,1265,33671839,12604542,440815,,12163727,7388907
2022-06-15,13511,473,832,1621,33685350,12604719,440454,,12164265,7390290
2022-06-16,12550,497,857,1618,33697900,12604909,440088,,12164821,7391661
2022-06-17,11693,479,818,1653,33709593,12605101,439742,,12165359,7393078
2022-06-18,11454,437,876,1860,33721047,12605267,439300,,12165967,7394714
2022-06-19,7005,484,899,1420,33728052,12605498,438884,,12166614,7395919
2022-06-20,2287,147,301,643,33730339,12605421,438724,,12166697,7396392
2022-06-21,9547,358,616,1386,33739886,12605492,438461,,12167031,7397530
2022-06-22,13616,408,728,1704,33753502,12605628,438134,,12167494,7399009
2022-06-23,13705,402,775,1683,33767207,12605763,437758,,12168005,7400478
2022-06-24,15367,436,812,1675,33782574,12605939,437378,,12168561,7401938
2022-06-25,14472,427,852,1714,33797046,12606104,436942,,12169162,7403442
2022-06-26,8159,432,886,1280,33805205,12606274,436481,,12169793,7404505
2022-06-27,3213,171,365,594,33808418,12606196,436283,,12169913,7404892
2022-06-28,9621,370,559,1226,33818039,12606280,436090,,12170190,7405885
2022-06-29,13318,415,731,1632,33831357,12606405,435772,,12170633,7407277
2022-06-30,12234,482,848,1581,33843591,12606602,435404,,12171198,7408624
2022-07-01,13041,550,972,1950,33856632,12606894,434977,,12171917,7410368
2022-07-02,1617,110,116,365,33858249,12606728,434969,,12171759,7410501
2022-07-03,5164,260,494,962,33863413,12606730,434726,,12172004,7411247
2022-07-04,2757,132,279,614,33866170,12606615,434578,,12172037,7411664
2022-07-05,11146,372,600,1576,33877316,12606689,434342,,12172347,7412992
2022-07-06,15961,549,859,2010,33893277,12606942,434026,,12172916,7414759
2022-07-07,15668,521,832,1927,33908945,12607174,433714,,12173460,7416433
2022-07-08,17888,555,869,2246,33926833,12607424,433399,,12174025,7418430
2022-07-09,14152,451,597,1851,33940985,12607596,433252,,12174344,7420043
2022-07-10,8751,475,755,1505,33949736,12607821,432971,,12174850,7421340
2022-07-11,4094,199,331,871,33953830,12607754,432836,,12174918,7421990
2022-07-12,12111,410,525,1659,33965941,12607865,432716,,12175149,7423395
2022-07-13,16722,564,773,2144,33982663,12608131,432501,,12175630,7425294
2022-07-14,16861,483,675,2024,33999524,12608308,432298,,12176010,7427078
2022-07-15,28902,598,823,2187,34028426,12608606,432072,,12176534,7429024
2022-07-16,30302,586,774,2328,34058728,12608877,431875,,12177002,7431099
2022-07-17,22936,538,636,1894,34081664,12609176,431774,,12177402,7432797
2022-07-18,11398,189,255,857,34093062,12609097,431703,,12177394,7433432
2022-07-19,28961,593,592,2138,34122023,12609414,431701,,12177713,7435338
2022-07-20,37646,839,924,2598,34159669,12609972,431611,,12178361,7437697
2022-07-21,36360,734,812,2809,34196029,12610417,431526,,12178891,7440264
2022-07-22,35807,824,893,2688,34231836,12610951,431450,,12179501,7442714
2022-07-23,35155,821,913,2836,34266991,12611457,431350,,12180107,7445294
2022-07-24,21740,599,804,1779,34288731,12611793,431142,,12180651,7446848
2022-07-25,11939,308,311,1082,34300670,12611815,431134,,12180681,7447698
2022-07-26,26096,619,605,2214,34326766,12612149,431147,,12181002,7449668
2022-07-27,32476,808,848,2653,34359242,12612698,431105,,12181593,7452109
2022-07-28,31545,724,884,2611,34390787,12613124,430941,,12182183,7454468
2022-07-29,29998,1790,876,2647,34420785,12614621,431851,,12182770,7456864
2022-07-30,25839,2525,747,2440,34446624,12616864,433627,,12183237,7459070
2022-07-31,14319,1069,541,1571,34460943,12617663,434151,,12183512,7460412
2022-08-01,5917,337,223,684,34466860,12617740,434263,,12183477,7460873
2022-08-02,4487,306,138,606,34471347,12617775,434427,,12183348,7461256
2022-08-03,22947,2640,739,2242,34494294,12620138,436324,,12183814,7463262
2022-08-04,22238,2481,681,2135,34516532,12622291,438118,,12184173,7465133
2022-08-05,21800,2755,747,2071,34538332,12624764,440118,,12184646,7466975
2022-08-06,19651,2875,657,1999,34557983,12627327,442330,,12184997,7468715
2022-08-07,12709,2236,621,1423,34570692,12629288,443939,,12185349,7469920
2022-08-08,4766,570,188,603,34575458,12629569,444314,,12185255,7470285
2022-08-09,14019,1468,559,1596,34589477,12630748,445217,,12185531,7471639
2022-08-10,19133,2364,717,1995,34608610,12632837,446862,,12185975,7473404
2022-08-11,17081,2041,718,1858,34625691,12634602,448183,,12186419,7475029
2022-08-12,16985,2048,734,1852,34642676,12636361,449496,,12186865,7476652
2022-08-13,15956,2223,766,1809,34658632,12638297,450951,,12187346,7478218
2022-08-14,9531,1621,619,1087,34668163,12639628,451949,,12187679,7479069
2022-08-15,3873,388,271,479,34672036,12639760,452063,,12187697,7479338
2022-08-16,10810,1075,516,1356,34682846,12640533,452620,,12187913,7480442
2022-08-17,16104,1834,739,1784,34698950,12642078,453714,,12188364,7481989
2022-08-18,14935,1642,749,1697,34713885,12643395,454603,,12188792,7483414
2022-08-19,15319,1847,749,1552,34729204,12644963,455697,,12189266,7484732
2022-08-20,14286,1640,740,1547,34743490,12646311,456591,,12189720,7486040
2022-08-21,9906,1533,660,1165,34753396,12647579,457460,,12190119,7486988
2022-08-22,4166,481,271,563,34757562,12647755,457667,,12190088,7487291
2022-08-23,11141,1248,556,1500,34768703,12648694,458355,,12190339,7488538
2022-08-24,14762,1808,871,2188,34783465,12650230,459292,,12190938,7490494
2022-08-25,14028,1716,780,2123,34797493,12651656,460221,,12191435,7492370
2022-08-26,13929,1687,816,2094,34811422,12653045,461085,,12191960,7494214
2022-08-27,12420,1487,878,2001,34823842,12654204,461688,,12192516,7495948
2022-08-28,7926,1259,622,1398,34831768,12655201,462323,,12192878,7497125
2022-08-29,3400,502,286,684,34835168,12655421,462534,,12192887,7497574
2022-08-30,9908,1169,652,1855,34845076,12656232,463045,,12193187,7499126
2022-08-31,13515,1626,946,2315,34858591,12657564,463721,,12193843,7501195
2022-09-01,12907,1720,913,2142,34871498,12658988,464523,,12194465,7503091
2022-09-02,15044,1616,991,4917,34886542,12660328,465140,,12195188,7507781
2022-09-03,14720,1525,923,5517,34901262,12661566,465739,,12195827,7513061
2022-09-04,8667,1009,676,3237,34909929,12662308,466062,,12196246,7516076
2022-09-05,3556,321,229,1387,34913485,12662362,466151,,12196211,7517240
2022-09-06,2469,157,116,1132,34915954,12662262,466189,,12196073,7518162
2022-09-07,10927,1019,587,3493,34926881,12662981,466617,,12196364,7521402
2022-09-08,10871,1022,527,2791,34937752,12663674,467109,,12196565,7523916
2022-09-09,9583,1011,488,2504,34947335,12664396,467627,,12196769,7526183
2022-09-10,10636,1264,552,3168,34957971,12665380,468332,,12197048,7529115
2022-09-11,9412,982,667,3738,34967383,12666111,468641,,12197470,7532642
2022-09-12,3127,295,205,1079,34970510,12666122,468724,,12197398,7533483
2022-09-13,6018,544,283,1132,34976528,12666376,468976,,12197400,7534369
2022-09-14,14482,797,434,1844,34991010,12666854,469335,,12197519,7535947
2022-09-15,15758,781,411,1533,35006768,12667314,469700,,12197614,7537208
2022-09-16,17759,766,447,1693,35024527,12667818,470013,,12197805,7538678
2022-09-17,17622,722,458,1669,35042149,12668234,470273,,12197961,7540091
2022-09-18,11214,773,451,1688,35053363,12668745,470593,,12198152,7541555
2022-09-19,4979,404,288,670,35058342,12668875,470704,,12198171,7542010
2022-09-20,13772,442,332,948,35072114,12669002,470812,,12198190,7542695
2022-09-21,23043,647,410,1499,35095157,12669337,471044,,12198293,7543937
2022-09-22,22918,636,398,1381,35118075,12669663,471276,,12198387,7545055
2022-09-23,22952,727,604,1418,35141027,12670086,471394,,12198692,7546215
2022-09-24,21691,737,689,1499,35162718,12670528,471438,,12199090,7547478
2022-09-25,11320,595,702,1357,35174038,12670840,471325,,12199515,7548597
2022-09-26,4564,192,219,594,35178602,12670740,471292,,12199448,7548946
2022-09-27,37653,497,365,1497,35216255,12670966,471420,,12199546,7550215
2022-09-28,50969,731,670,1901,35267224,12671428,471480,,12199948,7551890
2022-09-29,48010,637,741,1837,35315234,12671742,471368,,12200374,7553449
2022-09-30,47271,677,806,2003,35362505,12672091,471237,,12200854,7555170
2022-10-01,34452,527,633,1548,35396957,12672308,471129,,12201179,7556450
2022-10-02,24245,736,1028,1711,35421202,12672746,470834,,12201912,7557907
2022-10-03,10871,238,231,613,35432073,12672691,470837,,12201854,7558281
2022-10-04,32199,477,460,1170,35464272,12672846,470850,,12201996,7559172
2022-10-05,40440,632,741,1561,35504712,12673155,470734,,12202421,7560467
2022-10-06,38695,610,653,1567,35543407,12673460,470689,,12202771,7561772
2022-10-07,42243,661,852,1741,35585650,12673774,470490,,12203284,7563212
2022-10-08,37397,782,1145,2120,35623047,12674223,470121,,12204102,7565056
2022-10-09,18814,549,727,1556,35641861,12674493,469940,,12204553,7566373
2022-10-10,6865,168,370,565,35648726,12674361,469735,,12204626,7566676
2022-10-11,4994,124,111,318,35653720,12674189,469743,,12204446,7566755
2022-10-12,35117,579,685,1428,35688837,12674432,469635,,12204797,7567891
2022-10-13,36762,643,859,1620,35725599,12674706,469415,,12205291,7569200
2022-10-14,36977,621,753,1541,35762576,12674991,469279,,12205712,7570459
2022-10-15,35454,714,1013,1628,35798030,12675412,468977,,12206435,7571837
2022-10-16,20663,654,1024,1593,35818693,12675794,468601,,12207193,7573198
2022-10-17,7356,206,477,541,35826049,12675713,468328,,12207385,7573498
2022-10-18,36430,454,502,1402,35862479,12675845,468275,,12207570,7574626
2022-10-19,49903,618,730,1983,35912382,12676160,468159,,12208001,7576358
2022-10-20,51292,622,649,2050,35963674,12676466,468129,,12208337,7578141
2022-10-21,52851,696,619,1935,36016525,12676833,468200,,12208633,7579807
2022-10-22,50864,749,904,2311,36067389,12677249,468040,,12209209,7581841
2022-10-23,30641,571,786,2122,36098030,12677502,467818,,12209684,7583698
2022-10-24,14134,232,271,978,36112164,12677429,467774,,12209655,7584416
2022-10-25,41374,473,489,1820,36153538,12677548,467755,,12209793,7585935
2022-10-26,51658,615,660,2124,36205196,12677826,467706,,12210120,7587777
2022-10-27,50119,603,768,2164,36255315,12678099,467533,,12210566,7589667
2022-10-28,49804,591,675,2095,36305119,12678328,467444,,12210884,7591452
2022-10-29,50603,733,779,2222,36355722,12678708,467394,,12211314,7593370
2022-10-30,28403,661,930,2038,36384125,12679080,467121,,12211959,7595161
2022-10-31,12440,200,234,777,36396565,12678997,467084,,12211913,7595701
2022-11-01,33094,338,197,1220,36429659,12678988,467219,,12211769,7596628
2022-11-02,44291,574,625,1903,36473950,12679226,467164,,12212062,7598228
2022-11-03,44194,540,606,1856,36518144,12679434,467094,,12212340,7599796
2022-11-04,44647,648,528,2030,36562791,12679776,467207,,12212569,7601571
2022-11-05,45208,646,754,2368,36607999,12680119,467096,,12213023,7603670
2022-11-06,26020,558,771,2097,36634019,12680333,466880,,12213453,7605467
2022-11-07,10711,242,235,877,36644730,12680280,466884,,12213396,7606100
2022-11-08,33489,486,397,1587,36678219,12680473,466970,,12213503,7607440
2022-11-09,40529,605,571,1964,36718748,12680753,467002,,12213751,7609128
2022-11-10,39178,620,547,1929,36757926,12681050,467069,,12213981,7610779
2022-11-11,43347,635,641,2209,36801273,12681365,467062,,12214303,7612711
2022-11-12,36851,638,592,2185,36838124,12681676,467100,,12214576,7614611
2022-11-13,24269,558,770,2277,36862393,12681934,466882,,12215052,7616631
2022-11-14,10966,232,204,1024,36873359,12681868,466909,,12214959,7617395
2022-11-15,33629,483,380,1693,36906988,12681983,467006,,12214977,7618777
2022-11-16,43541,798,583,2370,36950529,12682475,467215,,12215260,7620890
2022-11-17,38341,674,647,2241,36988870,12682805,467238,,12215567,7622838
2022-11-18,40628,726,531,2331,37029498,12683181,467429,,12215752,7624866
2022-11-19,39659,1005,1031,3061,37069157,12683836,467396,,12216440,7627620
2022-11-20,22423,658,718,2444,37091580,12684211,467332,,12216879,7629831
2022-11-21,8921,196,193,967,37100501,12684139,467330,,12216809,7630588
2022-11-22,26440,481,369,1513,37126941,12684251,467437,,12216814,7631779
2022-11-23,32088,685,668,2069,37159029,12684599,467451,,12217148,7633564
2022-11-24,31912,663,752,2086,37190941,12684941,467360,,12217581,7635382
2022-11-25,30753,763,827,1953,37221694,12685387,467290,,12218097,7637068
2022-11-26,30292,908,1193,2698,37251986,12685949,466996,,12218953,7639470
2022-11-27,18676,608,943,2087,37270662,12686244,466655,,12219589,7641294
2022-11-28,7540,190,282,787,37278202,12686129,466555,,12219574,7641815
2022-11-29,21026,421,454,1292,37299228,12686214,466518,,12219696,7642824
2022-11-30,27892,643,649,1842,37327120,12686530,466510,,12220020,7644382
2022-12-01,24807,593,682,1692,37351927,12686788,466417,,12220371,7645783
2022-12-02,25058,523,630,1776,37376985,12686975,466304,,12220671,7647270
2022-12-03,25558,588,781,1945,37402543,12687232,466101,,12221131,7648944
2022-12-04,15252,494,606,1702,37417795,12687384,465983,,12221401,7650347
2022-12-05,6877,167,157,746,37424672,12687253,465988,,12221265,7650840
2022-12-06,20351,419,352,1379,37445023,12687297,466049,,12221248,7651903
2022-12-07,24783,553,610,1673,37469806,12687524,465984,,12221540,7653298
2022-12-08,23162,563,520,1766,37492968,12687763,466025,,12221738,7654781
2022-12-09,23329,635,575,1632,37516297,12688061,466081,,12221980,7656133
2022-12-10,22578,508,602,1631,37538875,12688243,465984,,12222259,7657481
2022-12-11,14204,548,786,1566,37553079,12688515,465743,,12222772,7658811
2022-12-12,5507,149,156,595,37558586,12688366,465731,,12222635,7659162
2022-12-13,17798,375,371,1125,37576384,12688412,465733,,12222679,7660008
2022-12-14,21324,511,547,1454,37597708,12688620,465691,,12222929,7661210
2022-12-15,21974,530,603,1579,37619682,12688799,465616,,12223183,7662487
2022-12-16,16292,378,451,1031,37635974,12688848,465540,,12223308,7663241
2022-12-17,18701,555,509,1277,37654675,12689074,465584,,12223490,7664229
2022-12-18,12643,530,794,1306,37667318,12689315,465319,,12223996,7665276
2022-12-19,4586,131,116,450,37671904,12689107,465330,,12223777,7665437
2022-12-20,16215,498,449,1110,37688119,12689281,465371,,12223910,7666276
2022-12-21,18476,541,552,1303,37706595,12689513,465356,,12224157,7667310
2022-12-22,18604,574,591,1747,37725199,12689784,465339,,12224445,7668793
2022-12-23,15654,577,602,1716,37740853,12689998,465309,,12224689,7670208
2022-12-24,5339,224,172,674,37746192,12689904,465360,,12224544,7670596
2022-12-25,2445,153,154,480,37748637,12689743,465349,,12224394,7670806
2022-12-26,262,12,7,48,37748899,12689451,465349,,12224102,7670597
2022-12-27,2099,98,37,307,37750998,12689256,465406,,12223850,7670662
2022-12-28,8321,337,168,975,37759319,12689274,465570,,12223704,7671361
2022-12-29,13165,582,529,1601,37772484,12689520,465619,,12223901,7672672
2022-12-30,15825,667,658,1881,37788309,12689872,465625,,12224247,7674272
2022-12-31,11237,459,389,1356,37799546,12689969,465691,,12224278,7675316
2023-01-01,3907,201,219,562,37803453,12689850,465672,,12224178,7675598
2023-01-02,652,36,14,97,37804105,12689595,465693,,12223902,7675444
2023-01-03,8197,297,151,902,37812302,12689602,465833,,12223769,7676101
2023-01-04,14723,574,547,1547,37827025,12689886,465854,,12224032,7677394
2023-01-05,16119,643,535,1796,37843144,12690222,465954,,12224268,7678923
2023-01-06,18835,715,612,2046,37861979,12690633,466054,,12224579,7680706
2023-01-07,18524,701,639,2057,37880503,12691048,466111,,12224937,7682514
2023-01-08,11612,580,608,1632,37892115,12691368,466080,,12225288,7683919
2023-01-09,5299,215,196,664,37897414,12691271,466096,,12225175,7684320
2023-01-10,12163,415,317,786,37909577,12691375,466192,,12225183,7684836
2023-01-11,15544,458,370,1095,37925121,12691506,466276,,12225230,7685655
2023-01-12,14084,444,409,973,37939205,12691637,466310,,12225327,7686361
2023-01-13,14175,419,344,1040,37953380,12691795,466382,,12225413,7687172
2023-01-14,13391,472,451,1079,37966771,12691954,466397,,12225557,7687977
2023-01-15,9046,459,508,1055,37975817,12692128,466347,,12225781,7688791
2023-01-16,3746,146,130,479,37979563,12691997,466363,,12225634,7689024
2023-01-17,8855,267,179,654,37988418,12691920,466447,,12225473,7689388
2023-01-18,10266,349,273,761,37998684,12691967,466520,,12225447,7689880
2023-01-19,10593,315,318,761,38009277,12691981,466512,,12225469,7690386
2023-01-20,9837,318,272,717,38019114,12692005,466556,,12225449,7690843
2023-01-21,11307,354,399,904,38030421,12692053,466510,,12225543,7691489
2023-01-22,7569,343,405,818,38037990,12692130,466445,,12225685,7692072
2023-01-23,3380,143,131,288,38041370,12692031,466456,,12225575,7692146
2023-01-24,8291,226,166,553,38049661,12691941,466514,,12225427,7692423
2023-01-25,10307,346,297,663,38059968,12692012,466559,,12225453,7692856
2023-01-26,6725,236,203,469,38066693,12691951,466589,,12225362,7693074
2023-01-27,6912,237,197,498,38073605,12691877,466626,,12225251,7693307
2023-01-28,9352,313,339,695,38082957,12691897,466595,,12225302,7693749
2023-01-29,5970,234,341,694,38088927,12691849,466483,,12225366,7694192
2023-01-30,1900,88,80,215,38090827,12691648,466489,,12225159,7694154
2023-01-31,5883,156,150,414,38096710,12691493,466492,,12225001,7694291
2023-02-01,7302,248,249,493,38104012,12691484,466488,,12224996,7694563
2023-02-02,6484,296,240,503,38110496,12691503,466541,,12224962,7694841
2023-02-03,6551,197,194,463,38117047,12691435,466540,,12224895,7695072
2023-02-04,6731,233,307,544,38123778,12691397,466460,,12224937,7695385
2023-02-05,4177,199,291,484,38127955,12691313,466363,,12224950,7695635
2023-02-06,1834,90,98,212,38129789,12691105,466352,,12224753,7695585
2023-02-07,4965,161,182,385,38134754,12690955,466328,,12224627,7695710
2023-02-08,5770,212,206,430,38140524,12690888,466331,,12224557,7695896
2023-02-09,6124,211,244,439,38146648,12690826,466297,,12224529,7696104
2023-02-10,5092,159,208,372,38151740,12690753,466244,,12224509,7696274
2023-02-11,6054,186,260,458,38157794,12690647,466166,,12224481,7696468
2023-02-12,4084,220,342,409,38161878,12690613,466040,,12224573,7696652
2023-02-13,1483,57,87,146,38163361,12690414,466008,,12224406,7696583
2023-02-14,3947,131,179,310,38167308,12690258,465958,,12224300,7696636
2023-02-15,4540,119,191,286,38171848,12690101,465883,,12224218,7696687
2023-02-16,4916,175,284,400,38176764,12689997,465770,,12224227,7696846
2023-02-17,4983,179,210,344,38181747,12689921,465735,,12224186,7696973
2023-02-18,5118,232,294,487,38186865,12689879,465671,,12224208,7697227
2023-02-19,3354,132,244,373,38190219,12689742,465554,,12224188,7697375
2023-02-20,1424,63,54,158,38191643,12689547,465560,,12223987,7697315
2023-02-21,914,27,14,107,38192557,12689323,465569,,12223754,7697199
2023-02-22,4136,131,212,370,38196693,12689193,465482,,12223711,7697356
2023-02-23,4282,162,231,392,38200975,12689081,465406,,12223675,7697511
2023-02-24,3034,136,231,274,38204009,12688957,465307,,12223650,7697550
2023-02-25,5024,213,541,386,38209033,12688915,464978,,12223937,7697722
2023-02-26,3472,146,681,384,38212505,12688788,464439,,12224349,7697879
2023-02-27,1074,37,57,97,38213579,12688578,464414,,12224164,7697771
2023-02-28,2729,99,163,232,38216308,12688389,464348,,12224041,7697747
2023-03-01,3850,137,428,336,38220158,12688217,464051,,12224166,7697807
2023-03-02,4595,158,494,330,38224753,12688059,463704,,12224355,7697877
2023-03-03,4368,159,356,334,38229121,12687939,463504,,12224435,7697962
2023-03-04,4970,208,623,350,38234091,12687862,463086,,12224776,7698067
2023-03-05,2537,110,450,251,38236628,12687669,462745,,12224924,7698054
2023-03-06,1156,48,37,114,38237784,12687459,462754,,12224705,7697942
2023-03-07,3221,87,172,225,38241005,12687227,462665,,12224562,7697900
2023-03-08,4318,133,412,284,38245323,12687060,462384,,12224676,7697916
2023-03-09,4623,173,453,312,38249946,12686942,462098,,12224844,7697979
2023-03-10,3942,100,139,254,38253888,12686791,462057,,12224734,7698019
2023-03-11,4064,139,171,286,38257952,12686690,462022,,12224668,7698095
2023-03-12,2883,109,233,301,38260835,12686523,461889,,12224634,7698158
2023-03-13,862,29,32,106,38261697,12686304,461882,,12224422,7698048
2023-03-14,3079,100,109,257,38264776,12686128,461873,,12224255,7698069
2023-03-15,4099,138,163,313,38268875,12686009,461846,,12224163,7698157
2023-03-16,4020,176,234,277,38272895,12685862,461779,,12224083,7698169
2023-03-17,4290,168,202,310,38277185,12685725,461741,,12223984,7698207
2023-03-18,4361,144,194,298,38281546,12685591,461690,,12223901,7698262
2023-03-19,2722,128,233,256,38284268,12685489,461583,,12223906,7698309
2023-03-20,774,31,19,74,38285042,12685251,461593,,12223658,7698151
2023-03-21,2899,69,86,201,38287941,12685059,461571,,12223488,7698129
2023-03-22,3894,130,133,248,38291835,12684900,461565,,12223335,7698119
2023-03-23,3808,118,171,226,38295643,12684730,461506,,12223224,7698099
2023-03-24,3693,102,116,238,38299336,12684578,461490,,12223088,7698122
2023-03-25,4274,108,171,252,38303610,12684422,461420,,12223002,7698146
2023-03-26,2472,112,212,202,38306082,12684276,461314,,12222962,7698129
2023-03-27,915,48,32,68,38306997,12684096,461329,,12222767,7697995
2023-03-28,3106,87,78,203,38310103,12683901,461330,,12222571,7697958
2023-03-29,4170,127,136,224,38314273,12683748,461317,,12222431,7697941
2023-03-30,3838,108,164,211,38318111,12683583,461260,,12222323,7697904
2023-03-31,3987,140,109,222,38322098,12683447,461290,,12222157,7697893
2023-04-01,4192,135,147,225,38326290,12683321,461275,,12222046,7697900
2023-04-02,2181,59,122,172,38328471,12683092,461208,,12221884,7697825
2023-04-03,781,24,12,53,38329252,12682870,461218,,12221652,7697662
2023-04-04,3418,74,74,169,38332670,12682692,461217,,12221475,7697603
2023-04-05,4369,94,109,249,38337039,12682507,461199,,12221308,7697616
2023-04-06,3703,108,109,190,38340742,12682363,461196,,12221167,7697585
2023-04-07,4599,105,115,243,38345341,12682203,461183,,12221020,7697601
2023-04-08,835,22,11,54,38346176,12681983,461190,,12220793,7697446
2023-04-09,2441,81,103,161,38348617,12681847,461165,,12220682,7697421
2023-04-10,360,9,6,20,38348977,12681609,461162,,12220447,7697240
2023-04-11,2771,34,28,121,38351748,12681373,461167,,12220206,7697118
2023-04-12,6347,104,96,188,38358095,12681231,461170,,12220061,7697103
2023-04-13,6997,105,128,207,38365092,12681077,461140,,12219937,7697084
2023-04-14,6514,88,103,206,38371606,12680909,461118,,12219791,7697077
2023-04-15,6949,107,149,230,38378555,12680767,461074,,12219693,7697096
2023-04-16,3274,83,144,165,38381829,12680586,461010,,12219576,7697033
2023-04-17,864,12,13,49,38382693,12680378,461006,,12219372,7696897
2023-04-18,4785,101,77,160,38387478,12680221,461028,,12219193,7696831
2023-04-19,6567,117,98,177,38394045,12680078,461045,,12219033,7696781
2023-04-20,6390,101,153,210,38400435,12679942,460991,,12218951,7696785
2023-04-21,5773,85,75,133,38406208,12679781,460999,,12218782,7696705
2023-04-22,6391,95,91,180,38412599,12679640,461000,,12218640,7696686
2023-04-23,3301,119,147,170,38415900,12679537,460971,,12218566,7696661
2023-04-24,955,4,12,59,38416855,12679326,460961,,12218365,7696543
2023-04-25,4809,69,70,187,38421664,12679164,460960,,12218204,7696523
2023-04-26,6592,108,93,208,38428256,12679050,460975,,12218075,7696534
2023-04-27,6899,118,152,207,38435155,12678935,460937,,12217998,7696538
2023-04-28,6638,86,86,185,38441793,12678794,460935,,12217859,7696516
2023-04-29,6531,123,111,197,38448324,12678703,460946,,12217757,7696524
2023-04-30,2642,94,129,145,38450966,12678593,460910,,12217683,7696488
2023-05-01,1030,20,17,30,38451996,12678404,460911,,12217493,7696330
2023-05-02,4348,68,55,105,38456344,12678248,460919,,12217329,7696240
2023-05-03,5608,108,107,176,38461952,12678139,460917,,12217222,7696230
2023-05-04,8086,87,85,134,38470038,12678002,460918,,12217084,7696176
2023-05-05,13049,90,98,168,38483087,12677883,460907,,12216976,7696157
2023-05-06,15641,114,96,154,38498728,12677802,460923,,12216879,7696134
2023-05-07,6066,56,95,106,38504794,12677659,460880,,12216779,7696066
2023-05-08,2165,16,4,37,38506959,12677486,460890,,12216596,7695936
2023-05-09,12561,55,49,129,38519520,12677333,460893,,12216440,7695889
2023-05-10,14768,70,79,157,38534288,12677195,460882,,12216313,7695863
2023-05-11,13363,77,71,154,38547651,12677081,460887,,12216194,7695849
2023-05-12,13488,86,79,176,38561139,12676971,460892,,12216079,7695844
2023-05-13,11446,80,74,147,38572585,12676823,460895,,12215928,7695789
2023-05-14,4185,67,95,93,38576770,12676691,460866,,12215825,7695717
2023-05-15,1055,9,6,38,38577825,12676515,460863,,12215652,7695600
2023-05-16,8948,56,47,93,38586773,12676356,460867,,12215489,7695507
2023-05-17,11123,99,83,141,38597896,12676229,460880,,12215349,7695437
2023-05-18,10838,81,69,144,38608734,12676088,460891,,12215197,7695385
2023-05-19,10514,96,97,152,38619248,12675964,460886,,12215078,7695339
2023-05-20,9405,91,88,165,38628653,12675831,460888,,12214943,7695297
2023-05-21,3084,48,86,95,38631737,12675700,460848,,12214852,7695232
2023-05-22,970,14,11,30,38632707,12675516,460851,,12214665,7695087
2023-05-23,754,8,3,16,38633461,12675332,460856,,12214476,7694936
2023-05-24,8018,57,80,105,38641479,12675166,460832,,12214334,7694837
2023-05-25,9344,74,93,163,38650823,12675029,460811,,12214218,7694815
2023-05-26,7995,67,70,123,38658818,12674898,460808,,12214090,7694761
2023-05-27,8231,108,76,126,38667049,12674799,460838,,12213961,7694713
2023-05-28,2905,56,72,101,38669954,12674674,460819,,12213855,7694651
2023-05-29,972,13,11,30,38670926,12674486,460819,,12213667,7694497
2023-05-30,6072,61,50,112,38676998,12674333,460829,,12213504,7694416
2023-05-31,8170,91,94,122,38685168,12674208,460823,,12213385,7694353
2023-06-01,7372,70,90,122,38692540,12674070,460801,,12213269,7694289
2023-06-02,6326,50,48,121,38698866,12673914,460802,,12213112,7694221
2023-06-03,5492,70,63,123,38704358,12673771,460808,,12212963,7694157
2023-06-04,2049,47,78,77,38706407,12673634,460774,,12212860,7694068
2023-06-05,600,11,6,18,38707007,12673468,460777,,12212691,7693927
2023-06-06,4465,39,38,79,38711472,12673310,460775,,12212535,7693831
2023-06-07,5811,63,65,121,38717283,12673203,460770,,12212433,7693806
2023-06-08,5756,58,68,112,38723039,12673108,460758,,12212350,7693788
2023-06-09,6187,78,81,122,38729226,12672991,460755,,12212236,7693737
2023-06-10,5347,77,95,115,38734573,12672866,460734,,12212132,7693672
2023-06-11,2010,55,62,105,38736583,12672754,460722,,12212032,7693633
2023-06-12,691,11,7,38,38737274,12672616,460725,,12211891,7693539
2023-06-13,4228,55,58,103,38741502,12672493,460721,,12211772,7693493
2023-06-14,5477,72,83,117,38746979,12672367,460709,,12211658,7693440
2023-06-15,5102,70,76,121,38752081,12672234,460701,,12211533,7693381
2023-06-16,5693,70,64,120,38757774,12672117,460704,,12211413,7693337
2023-06-17,4120,63,62,113,38761894,12672004,460705,,12211299,7693293
2023-06-18,1560,41,61,98,38763454,12671879,460684,,12211195,7693247
2023-06-19,373,7,2,15,38763827,12671734,460687,,12211047,7693131
2023-06-20,3201,52,42,88,38767028,12671599,460694,,12210905,7693054
2023-06-21,3689,42,57,88,38770717,12671484,460676,,12210808,7692999
2023-06-22,3976,75,73,118,38774693,12671390,460676,,12210714,7692971
2023-06-23,4508,56,44,88,38779201,12671300,460687,,12210613,7692930
2023-06-24,3698,49,61,73,38782899,12671154,460673,,12210481,7692836
2023-06-25,1518,31,50,93,38784417,12671045,460652,,12210393,7692806
2023-06-26,510,12,9,23,38784927,12670928,460652,,12210276,7692710
2023-06-27,3102,80,46,91,38788029,12670839,460685,,12210154,7692653
2023-06-28,4074,72,59,89,38792103,12670766,460698,,12210068,7692608
2023-06-29,3962,64,72,82,38796065,12670696,460685,,12210011,7692572
2023-06-30,3827,74,61,128,38799892,12670633,460695,,12209938,7692572
2023-07-01,3214,52,88,116,38803106,12670530,460658,,12209872,7692555
2023-07-02,269,10,4,15,38803375,12670407,460663,,12209744,7692456
2023-07-03,377,6,5,26,38803752,12670300,460664,,12209636,7692385
2023-07-04,1234,19,14,48,38804986,12670186,460669,,12209517,7692314
2023-07-05,2382,56,40,70,38807368,12670126,460683,,12209443,7692287
2023-07-06,2529,38,69,85,38809897,12670021,460650,,12209371,7692250
2023-07-07,2816,53,46,71,38812713,12669971,460655,,12209316,7692234
2023-07-08,2398,63,43,92,38815111,12669908,460675,,12209233,7692214
2023-07-09,915,31,44,37,38816026,12669821,460662,,12209159,7692144
2023-07-10,289,4,2,15,38816315,12669687,460663,,12209024,7692034
2023-07-11,1787,34,20,59,38818102,12669597,460676,,12208921,7691988
2023-07-12,2311,51,52,84,38820413,12669526,460675,,12208851,7691963
2023-07-13,2242,53,68,66,38822655,12669475,460660,,12208815,7691941
2023-07-14,1926,65,48,59,38824581,12669447,460675,,12208772,7691923
2023-07-15,1918,53,56,77,38826499,12669408,460671,,12208737,7691922
2023-07-16,795,36,28,42,38827294,12669342,460679,,12208663,7691874
2023-07-17,191,5,1,11,38827485,12669277,460682,,12208595,7691823
2023-07-18,1303,42,44,56,38828788,12669236,460680,,12208556,7691804
2023-07-19,1761,56,49,56,38830549,12669228,460686,,12208542,7691804
2023-07-20,1477,79,55,54,38832026,12669247,460709,,12208538,7691803
2023-07-21,1708,56,40,48,38833734,12669232,460721,,12208511,7691788
2023-07-22,1494,41,61,75,38835228,12669231,460701,,12208530,7691824
2023-07-23,684,31,29,46,38835912,12669233,460703,,12208530,7691844
2023-07-24,231,12,2,14,38836143,12669219,460712,,12208507,7691834
2023-07-25,1048,46,26,50,38837191,12669255,460732,,12208523,7691874
2023-07-26,1298,51,46,41,38838489,12669305,460737,,12208568,7691914
2023-07-27,1187,78,41,45,38839676,12669383,460774,,12208609,7691959
