"report_date","previous_day_total_doses_administered","previous_day_at_least_one","previous_day_fully_vaccinated","previous_day_3doses","total_doses_administered","total_individuals_at_least_one","total_individuals_partially_vaccinated","total_doses_in_fully_vaccinated_individuals","total_individuals_fully_vaccinated","total_individuals_3doses"
2021-01-01,6251,6241,2,,32200,32145,32134,22,11,
2021-01-02,4614,4602,6,,36814,36695,36682,26,13,
2021-01-03,5395,5388,3,,42209,42083,42067,32,16,
2021-01-04,5995,5993,0,,48204,48075,48060,30,15,
2021-01-05,9685,9660,20,,57889,57733,57699,68,34,
2021-01-06,12793,12328,450,,70682,70057,69577,960,480,
2021-01-07,16218,15507,697,,86900,85563,84386,2354,1177,
2021-01-08,18037,17022,1002,,104937,102585,100406,4358,2179,
2021-01-09,19500,18423,1064,,124437,121007,117764,6486,3243,
2021-01-10,11372,11332,38,,135809,132330,129050,6560,3280,
2021-01-11,11710,11660,48,,147519,143990,140662,6656,3328,
2021-01-12,14467,14160,298,,161986,158142,154516,7252,3626,
2021-01-13,15436,13813,1593,,177422,171941,166724,10434,5217,
2021-01-14,19188,16737,2436,,196610,188672,181020,15304,7652,
2021-01-15,20067,18009,2038,,216677,206670,196980,19380,9690,
2021-01-16,17118,15934,1171,,233795,222588,211727,21722,10861,
2021-01-17,11259,10015,1237,,245054,232588,220492,24192,12096,
2021-01-18,6794,6712,72,,251848,239277,227112,24330,12165,
2021-01-19,11828,9720,2094,,263676,248976,234717,28518,14259,
2021-01-20,10801,7212,3572,,274477,256165,238335,35660,17830,
2021-01-21,10973,6854,4091,,285450,263003,241082,43842,21921,
2021-01-22,9038,4320,4698,,294488,267286,240669,53234,26617,
2021-01-23,7456,3040,4388,,301944,270296,239292,62008,31004,
2021-01-24,4385,1828,2536,,306329,272106,238566,67080,33540,
2021-01-25,5321,1048,4264,,311650,273122,235319,75606,37803,
2021-01-26,9392,2867,6497,,321042,275957,231658,88598,44299,
2021-01-27,9896,2864,7004,,330938,278792,227490,102604,51302,
2021-01-28,13115,5738,7335,,344053,284497,225860,117274,58637,
2021-01-29,10694,3281,7379,,354747,287747,221732,132030,66015,
2021-01-30,9188,2728,6423,,363935,290433,217998,144870,72435,
2021-01-31,3380,1567,1768,,367315,291966,217764,148404,74202,
2021-02-01,2122,485,1609,,369437,292417,216610,151614,75807,
2021-02-02,4412,1359,2995,,373849,293738,214940,157596,78798,
2021-02-03,6236,1716,4458,,380085,295413,212164,166498,83249,
2021-02-04,9079,1709,7291,,389164,297079,206545,181068,90534,
2021-02-05,8442,1466,6903,,397606,298505,201074,194862,97431,
2021-02-06,10667,1871,8736,,408273,300321,194163,212316,106158,
2021-02-07,7574,1729,5796,,415847,302010,190068,223884,111942,
2021-02-08,8218,3095,5080,,424065,305057,188048,234018,117009,
2021-02-09,15007,3857,11082,,439072,308872,180797,256150,128075,
2021-02-10,15508,4929,10518,,454580,313749,175181,277136,138568,
2021-02-11,16367,3899,12410,,470947,317596,166649,301894,150947,
2021-02-12,17670,2098,15522,,488617,319655,153206,332898,166449,
2021-02-13,16209,2443,13751,,504826,322053,141872,360362,180181,
2021-02-14,12878,921,11925,,517704,322926,130850,384152,192076,
2021-02-15,7861,485,7328,,525565,323363,123985,398756,199378,
2021-02-16,5992,1040,4902,,531557,324360,120103,408514,204257,
2021-02-17,10166,1609,8523,,541723,325925,113173,425504,212752,
2021-02-18,13869,2955,10870,,555592,328832,105240,447184,223592,
2021-02-19,18488,6213,12208,,574080,334993,99224,471538,235769,
2021-02-20,22627,11131,11444,,596707,346061,98886,494350,247175,
2021-02-21,17236,10380,6822,,613943,356381,102426,507910,253955,
2021-02-22,13585,8759,4774,,627528,365071,106391,517360,258680,
2021-02-23,17864,11126,6667,,645392,376141,110830,530622,265311,
2021-02-24,18576,13611,4884,,663968,389696,119543,540306,270153,
2021-02-25,20808,16488,4263,,684776,406118,131750,548736,274368,
2021-02-26,24895,21833,3001,,709671,427891,150559,554664,277332,
2021-02-27,27461,23581,3838,,737132,451408,170286,562244,281122,
2021-02-28,20581,19140,1406,,757713,470494,188008,564972,282486,
2021-03-01,18222,17026,1148,,775935,487458,203871,567174,283587,
2021-03-02,24681,22272,2324,,800616,509669,223804,571730,285865,
2021-03-03,30596,27965,2577,,831212,537583,249174,576818,288409,
2021-03-04,34689,32459,2145,,865901,569976,279472,581008,290504,
2021-03-05,39997,38164,1784,,905898,608092,315838,584508,292254,
2021-03-06,44150,41944,2168,,950048,649981,355600,588762,294381,
2021-03-07,32733,31554,1175,,982781,681461,385963,590996,295498,
2021-03-08,24037,22162,1861,,1006818,703555,406250,594610,297305,
2021-03-09,33290,29840,3422,,1040108,733329,432648,601362,300681,
2021-03-10,38338,34076,4217,,1078446,767331,462481,609700,304850,
2021-03-11,43977,40704,3234,,1122423,807969,499937,616064,308032,
2021-03-12,47711,45999,1689,,1170134,853904,544233,619342,309671,
2021-03-13,57922,55047,2848,,1228056,908880,596415,624930,312465,
2021-03-14,43418,42179,1221,,1271474,950976,637358,627236,313618,
2021-03-15,32810,31112,1682,,1304284,982029,666772,630514,315257,
2021-03-16,53956,51657,2282,,1358240,1033621,716125,634992,317496,
2021-03-17,61059,58520,2496,,1419299,1092075,772133,639884,319942,
2021-03-18,61544,59087,2429,,1480843,1151090,828772,644636,322318,
2021-03-19,64468,61139,3273,,1545311,1212151,886613,651076,325538,
2021-03-20,62565,59975,2559,,1607876,1272070,944021,656098,328049,
2021-03-21,43994,42472,1536,,1651870,1314477,984929,659096,329548,
2021-03-22,30999,30034,976,,1682869,1344423,1013955,660936,330468,
2021-03-23,54618,51845,2722,,1737487,1396173,1063046,666254,333127,
2021-03-24,76428,73247,3133,,1813915,1469330,1133127,672406,336203,
2021-03-25,82906,80326,2533,,1896821,1549577,1210898,677358,338679,
2021-03-26,87009,83479,3490,,1983830,1632975,1290858,684234,342117,
2021-03-27,80849,77897,2867,,2064679,1710769,1365850,689838,344919,
2021-03-28,66986,65397,1554,,2131665,1776076,1429660,692832,346416,
2021-03-29,51733,49045,2651,,2183398,1825041,1476020,698042,349021,
2021-03-30,73579,70170,3349,,2256977,1895134,1542805,704658,352329,
2021-03-31,93148,89497,3585,,2350125,1984533,1628672,711722,355861,
2021-04-01,89312,85434,3839,,2439437,2069869,1710222,719294,359647,
2021-04-02,93082,88859,4207,,2532519,2158642,1794840,727604,363802,
2021-04-03,61006,59328,1735,,2593525,2217879,1852393,730972,365486,
2021-04-04,72327,70674,1650,,2665852,2288442,1921364,734156,367078,
2021-04-05,53730,53260,470,,2719582,2341618,1974118,735000,367500,
2021-04-06,79580,77713,1886,,2799162,2419229,2049897,738664,369332,
2021-04-07,108003,104938,3055,,2907165,2524042,2151713,744658,372329,
2021-04-08,114072,110104,4023,,3021237,2634035,2257739,752592,376296,
2021-04-09,109844,105620,4296,,3131081,2739537,2359010,761054,380527,
2021-04-10,109236,105476,3851,,3240317,2844885,2460573,768624,384312,
2021-04-11,98621,95506,3258,,3338938,2940266,2552755,775022,387511,
2021-04-12,76064,75001,1156,,3415002,3015119,2626520,777198,388599,
2021-04-13,99469,96088,3399,,3514471,3111098,2719148,783900,391950,
2021-04-14,117045,113281,3650,,3631516,3224261,2828701,791120,395560,
2021-04-15,113558,109502,3898,,3745074,3333637,2934236,798802,399401,
2021-04-16,118085,113711,4194,,3863159,3447238,3043687,807102,403551,
2021-04-17,112414,107824,4450,,3975573,3554928,3146986,815884,407942,
2021-04-18,88741,86504,2103,,4064314,3641309,3231318,819982,409991,
2021-04-19,68972,67440,1452,,4133286,3708619,3297227,822784,411392,
2021-04-20,102089,98767,3117,,4235375,3807224,3392780,828888,414444,
2021-04-21,142035,137761,4038,,4377410,3944811,3526397,836828,418414,
2021-04-22,139497,135347,3909,,4516907,4080029,3657762,844534,422267,
2021-04-23,138213,131796,6171,,4655120,4211671,3783291,856760,428380,
2021-04-24,130286,126226,3886,,4785406,4337749,3905539,864420,432210,
2021-04-25,102013,98603,3179,,4887419,4436204,4000882,870644,435322,
2021-04-26,70999,69295,1556,,4958418,4505368,4068550,873636,436818,
2021-04-27,98500,95419,2890,,5056918,4600626,4160981,879290,439645,
2021-04-28,120575,115952,4431,,5177493,4716410,4272406,888008,444004,
2021-04-29,124482,119288,5046,,5301975,4835531,4386550,897962,448981,
2021-04-30,115814,110562,5011,,5417789,4945920,4492005,907830,453915,
2021-05-01,111290,107428,3646,,5529079,5053167,4595683,914968,457484,
2021-05-02,79137,76163,2861,,5608216,5129173,4668894,920558,460279,
2021-05-03,56791,55122,1596,,5665007,5184140,4722325,923630,461815,
2021-05-04,91924,88555,3281,,5756931,5272517,4807498,930038,465019,
2021-05-05,137992,133287,4620,,5894923,5405635,4936059,939152,469576,
2021-05-06,141831,136878,4815,,6036754,5542329,5068000,948658,474329,
2021-05-07,150281,145241,4835,,6187035,5687410,5208305,958210,479105,
2021-05-08,142454,137770,4435,,6329489,5824985,5341524,966922,483461,
2021-05-09,124802,121155,3478,,6454291,5945976,5459101,973750,486875,
2021-05-10,97802,95818,1879,,6552093,6041605,5552918,977374,488687,
2021-05-11,113529,108856,4490,,6665622,6150259,5657153,986212,493106,
2021-05-12,145038,138013,6878,,6810660,6288093,5788175,999836,499918,
2021-05-13,142703,135314,7236,,6953363,6423232,5916152,1014160,507080,
2021-05-14,148860,138772,9918,,7102223,6561816,6044883,1033866,516933,
2021-05-15,159731,149689,9863,,7261954,6711318,6184597,1053442,526721,
2021-05-16,144356,136089,8060,,7406310,6847239,6312538,1069402,534701,
2021-05-17,114973,110878,3942,,7521283,6957928,6419361,1077134,538567,
2021-05-18,111328,100461,10665,,7632611,7058193,6509023,1098340,549170,
2021-05-19,149874,133464,16233,,7782485,7191505,6626176,1130658,565329,
2021-05-20,151564,131574,19774,,7934049,7322890,6737856,1170068,585034,
2021-05-21,165381,140878,24245,,8099430,7463587,6854385,1218404,609202,
2021-05-22,199430,172237,26965,,8298860,7635627,6999541,1272172,636086,
2021-05-23,139818,127450,12223,,8438678,7762899,7114652,1296494,648247,
2021-05-24,100295,93324,6826,,8538973,7856050,7201047,1310006,655003,
2021-05-25,90460,82976,7275,,8629433,7938863,7276652,1324422,662211,
2021-05-26,139776,113009,26503,,8769209,8051685,7363041,1377288,688644,
2021-05-27,152055,123038,28764,,8921264,8174566,7457227,1434678,717339,
2021-05-28,163861,132307,31248,,9085125,8306700,7558172,1497056,748528,
2021-05-29,153380,117119,36028,,9238505,8423669,7639169,1569000,784500,
2021-05-30,149717,119011,30479,,9388222,8542510,7727593,1629834,814917,
2021-05-31,99212,79818,19201,,9487434,8622158,7788104,1668108,834054,
2021-06-01,124190,90606,33248,,9611624,8712569,7845342,1734454,867227,
2021-06-02,145312,102149,42912,,9756936,8814537,7904467,1820140,910070,
2021-06-03,155363,99910,55174,,9912299,8914262,7949089,1930346,965173,
2021-06-04,181711,115528,65911,,10094010,9029591,7998595,2061992,1030996,
2021-06-05,172023,103434,68308,,10266033,9132827,8033608,2198438,1099219,
2021-06-06,163388,91863,71245,,10429421,9224512,8054118,2340788,1170394,
2021-06-07,119555,63050,56288,,10548976,9287365,8060758,2453214,1226607,
2021-06-08,161888,72446,89003,,10710864,9359622,8044092,2631060,1315530,
2021-06-09,181463,70807,110187,,10892327,9430252,8004616,2851272,1425636,
2021-06-10,185573,66419,118663,,11077900,9496468,7952260,3088416,1544208,
2021-06-11,204780,67514,136512,,11282680,9563796,7883158,3361276,1680638,
2021-06-12,199728,62673,136455,,11482408,9626287,7809286,3634002,1817001,
2021-06-13,190332,58882,130919,,11672740,9684994,7737154,3895680,1947840,
2021-06-14,137684,38692,98593,,11810424,9723490,7677162,4092656,2046328,
2021-06-15,189535,42615,146566,,11999959,9765887,7573090,4385594,2192797,
2021-06-16,206246,42432,163173,,12206205,9808123,7452256,4711734,2355867,
2021-06-17,210458,37937,171938,,12416663,9845845,7318132,5055426,2527713,
2021-06-18,217181,35352,181226,,12633844,9881007,7172160,5417694,2708847,
2021-06-19,215886,35493,179719,,12849730,9916294,7027840,5776908,2888454,
2021-06-20,186266,35565,150124,,13035996,9951661,6913191,6076940,3038470,
2021-06-21,120428,20826,99101,,13156424,9972292,6834813,6274958,3137479,
2021-06-22,204934,27515,176662,,13361358,9999613,6685581,6628064,3314032,
2021-06-23,230526,28629,201157,,13591884,10028042,6512961,7030162,3515081,
2021-06-24,227687,26670,200262,,13819571,10054516,6339283,7430466,3715233,
2021-06-25,251107,27981,222377,,14070678,10082296,6144804,7874984,3937492,
2021-06-26,261291,30003,230586,,14331969,10112074,5944136,8335876,4167938,
2021-06-27,204996,27785,176605,,14536965,10139677,5795244,8688866,4344433,
2021-06-28,199248,20953,177729,,14736213,10160432,5638395,9044074,4522037,
2021-06-29,250108,24493,224883,,14986321,10184684,5437918,9493532,4746766,
2021-06-30,275536,24174,250794,,15261857,10208655,5211224,9994862,4997431,
2021-07-01,271968,25307,246107,,15533825,10233744,4990345,10486798,5243399,
2021-07-02,144724,11589,132907,,15678549,10245159,4868955,10752408,5376204,
2021-07-03,216893,19929,196733,,15895442,10264866,4692078,11145576,5572788,
2021-07-04,196191,19428,176539,,16091633,10284107,4534900,11498414,5749207,
2021-07-05,148719,12442,136134,,16240352,10296359,4411146,11770426,5885213,
2021-07-06,220032,19992,199825,,16460384,10316135,4231243,12169784,6084892,
2021-07-07,246610,22967,223402,,16706994,10338876,4030730,12616292,6308146,
2021-07-08,231204,21351,209641,,16938198,10360021,3842369,13035304,6517652,
2021-07-09,226996,21509,205318,,17165194,10381328,3658490,13445676,6722838,
2021-07-10,209058,20536,188365,,17374252,10401660,3490594,13822132,6911066,
2021-07-11,171675,17582,153966,,17545927,10419041,3354156,14129770,7064885,
2021-07-12,123133,11445,111591,,17669060,10430297,3253958,14352678,7176339,
2021-07-13,178502,19026,159334,,17847562,10449101,3113583,14671036,7335518,
2021-07-14,180038,19302,160579,,18027600,10468188,2972254,14991868,7495934,
2021-07-15,167197,19584,147439,,18194797,10487561,2844352,15286418,7643209,
2021-07-16,169344,19897,149293,,18364141,10507256,2714907,15584698,7792349,
2021-07-17,173005,20262,152613,,18537146,10527269,2582499,15889540,7944770,
2021-07-18,133626,15929,117560,,18670772,10543014,2480832,16124364,8062182,
2021-07-19,91979,10416,81455,,18762751,10553217,2409755,16286924,8143462,
2021-07-20,133536,16947,116530,,18896287,10569924,2310108,16519632,8259816,
2021-07-21,140083,16983,123028,,19036370,10586692,2204010,16765364,8382682,
2021-07-22,125603,17637,107828,,19161973,10604105,2113772,16980666,8490333,
2021-07-23,120269,16990,103071,,19282242,10620854,2027649,17186410,8593205,
2021-07-24,126695,18331,108125,,19408937,10638982,1937815,17402334,8701167,
2021-07-25,103633,14860,88643,,19512570,10653618,1863989,17579258,8789629,
2021-07-26,66685,9887,56706,,19579255,10663287,1817133,17692308,8846154,
2021-07-27,92375,15314,76898,,19671630,10678340,1755505,17845670,8922835,
2021-07-28,93941,16463,77405,,19765571,10694568,1694519,18000098,9000049,
2021-07-29,89391,16700,72528,,19854962,10711036,1638647,18144778,9072389,
2021-07-30,84061,16104,67842,,19939023,10726912,1586869,18280086,9140043,
2021-07-31,83845,15715,67978,,20022868,10742409,1534578,18415662,9207831,
2021-08-01,61866,11317,50367,,20084734,10753500,1495493,18516014,9258007,
2021-08-02,42488,7415,34954,,20127222,10760717,1467922,18585590,9292795,
2021-08-03,33291,5954,27166,,20160513,10766438,1446687,18639502,9319751,
2021-08-04,61316,12371,48755,,20221829,10778574,1410266,18736616,9368308,
2021-08-05,59454,12545,46756,,20281283,10790911,1376011,18829800,9414900,
2021-08-06,56016,11856,43945,,20337299,10802507,1343891,18917232,9458616,
2021-08-07,62371,12133,50044,,20399670,10814379,1305937,19016884,9508442,
2021-08-08,48679,9269,39222,,20448349,10823420,1275961,19094918,9547459,
2021-08-09,30854,5936,24740,,20479203,10829142,1257130,19144024,9572012,
2021-08-10,49253,10507,38444,,20528456,10839369,1229159,19220420,9610210,
2021-08-11,48719,10764,37708,,20577175,10849886,1202184,19295404,9647702,
2021-08-12,49244,11193,37820,,20626419,10860828,1175515,19370626,9685313,
2021-08-13,49621,11726,37619,,20676040,10872313,1149592,19445442,9722721,
2021-08-14,51216,12131,38875,,20727256,10884194,1122822,19522744,9761372,
2021-08-15,41761,9849,31689,,20769017,10893841,1100952,19585778,9792889,
2021-08-16,26734,6180,20402,,20795751,10899798,1086704,19626188,9813094,
2021-08-17,40498,11055,29178,,20836249,10910603,1068557,19684092,9842046,
2021-08-18,41889,11967,29679,,20878138,10922328,1050813,19743030,9871515,
2021-08-19,45888,16530,29096,,20924026,10938607,1038219,19800776,9900388,
2021-08-20,46440,16285,29740,,20970466,10954636,1024737,19859798,9929899,
2021-08-21,47948,15141,32439,,21018414,10969517,1007406,19924222,9962111,
2021-08-22,34385,10802,23313,,21052799,10980073,994871,19970404,9985202,
2021-08-23,23219,7004,15999,,21076018,10986842,985855,20001974,10000987,
2021-08-24,37649,13374,23820,,21113667,10999962,975386,20049152,10024576,
2021-08-25,41340,14418,26312,,21155007,11014124,963473,20101302,10050651,
2021-08-26,39263,13551,24970,,21194270,11027399,952019,20150760,10075380,
2021-08-27,37667,12936,23687,,21231937,11040094,941241,20197706,10098853,
2021-08-28,40115,13422,25516,,21272052,11053237,929123,20248228,10124114,
2021-08-29,30551,10249,19942,,21302603,11063254,919411,20287686,10143843,
2021-08-30,18232,6139,11843,,21320835,11069145,913678,20310934,10155467,
2021-08-31,32707,11936,19620,,21353542,11080813,905966,20349694,10174847,
2021-09-01,36238,12941,21952,,21389780,11093521,896939,20393164,10196582,
2021-09-02,37769,15641,19663,,21427549,11108910,892892,20432036,10216018,
2021-09-03,46882,21092,22440,,21474431,11129753,891525,20476456,10238228,
2021-09-04,46873,20586,24772,,21521304,11150093,887316,20525554,10262777,
2021-09-05,33066,14201,18573,,21554370,11164050,882924,20562252,10281126,
2021-09-06,21711,9488,12031,,21576081,11173289,880364,20585850,10292925,
2021-09-07,15006,6727,8095,,21591087,11179759,878979,20601560,10300780,
2021-09-08,41143,17114,20931,,21632230,11196609,875144,20642930,10321465,
2021-09-09,41442,16972,19674,,21673672,11213304,872417,20681774,10340887,
2021-09-10,39641,15506,19003,,21713313,11228548,868902,20719292,10359646,
2021-09-11,42374,15932,23337,,21755687,11244201,861476,20765450,10382725,
2021-09-12,29963,11530,17866,,21785650,11255437,855110,20800654,10400327,
2021-09-13,16087,6406,9184,,21801737,11261609,852317,20818584,10409292,
2021-09-14,29899,11555,15288,,21831636,11272862,848557,20848610,10424305,
2021-09-15,39273,14020,19419,,21870909,11286623,843143,20886960,10443480,
2021-09-16,39343,13983,19245,,21910252,11300371,837858,20925026,10462513,
2021-09-17,38922,13610,19332,,21949174,11313738,832124,20963228,10481614,
2021-09-18,41239,14080,23535,,21990413,11327545,822648,21009794,10504897,
2021-09-19,30654,10827,18978,,22021067,11338113,814484,21047258,10523629,
2021-09-20,16729,6098,10176,,22037796,11343957,810383,21067148,10533574,
2021-09-21,31355,11213,16987,,22069151,11354905,804593,21100624,10550312,
2021-09-22,41811,14813,22927,,22110962,11369422,796458,21145928,10572964,
2021-09-23,47225,16136,26029,,22158187,11385295,786546,21197498,10598749,
2021-09-24,46297,15628,26646,,22204484,11400663,775509,21250308,10625154,
2021-09-25,48193,15253,29946,,22252677,11415663,760797,21309732,10654866,
2021-09-26,37497,12418,24486,,22290174,11427806,748708,21358196,10679098,
2021-09-27,19157,6530,12321,,22309331,11434082,742901,21382362,10691181,
2021-09-28,30953,11292,17878,,22340284,11445115,736303,21417624,10708812,
2021-09-29,37886,12475,21726,,22378170,11457319,727032,21460574,10730287,
2021-09-30,37333,11651,21370,,22415503,11468711,717294,21502834,10751417,
2021-10-01,30875,9809,18412,,22446378,11478294,708678,21539232,10769616,
2021-10-02,37134,11156,23583,,22483512,11489180,696233,21585894,10792947,
2021-10-03,27201,8161,18323,,22510713,11497100,686058,21622084,10811042,
2021-10-04,14866,4746,9801,,22525579,11501600,680985,21641230,10820615,
2021-10-05,26822,8593,15869,,22552401,11509932,673694,21672476,10836238,
2021-10-06,31658,9635,18507,,22584059,11519308,664814,21708988,10854494,
2021-10-07,30342,9393,17116,,22614401,11528450,657078,21742744,10871372,
2021-10-08,32837,10740,18851,,22647238,11538920,648954,21779932,10889966,
2021-10-09,34135,10661,21013,,22681373,11549318,638588,21821460,10910730,
2021-10-10,23405,7658,15080,,22704778,11556725,631154,21851142,10925571,
2021-10-11,12001,3839,7863,,22716779,11560314,627114,21866400,10933200,
2021-10-12,5106,1625,3264,,22721885,11561661,625460,21872402,10936201,
2021-10-13,29101,9189,18082,,22750986,11570560,616551,21908018,10954009,
2021-10-14,29008,8903,17744,,22779994,11579188,607700,21942976,10971488,
2021-10-15,29098,8831,18167,,22809092,11587756,598351,21978810,10989405,
2021-10-16,31135,8984,19869,,22840227,11596449,587454,22017990,11008995,
2021-10-17,23703,7260,15371,,22863930,11603455,579330,22048250,11024125,
2021-10-18,12305,3746,8146,,22876235,11606920,574918,22064004,11032002,
2021-10-19,21265,6624,12628,,22897500,11613262,568901,22088722,11044361,
2021-10-20,25666,7540,14919,,22923166,11620555,561509,22118092,11059046,
2021-10-21,23175,6681,13028,,22946341,11626967,555151,22143632,11071816,
2021-10-22,26115,7311,15110,,22972456,11633955,547336,22173238,11086619,
2021-10-23,28173,7605,17151,,23000629,11641298,537783,22207030,11103515,
2021-10-24,19346,5727,12597,,23019975,11646769,530901,22231736,11115868,
2021-10-25,9928,2709,6475,,23029903,11649209,527127,22244164,11122082,
2021-10-26,18904,5388,11096,,23048807,11654319,521410,22265818,11132909,
2021-10-27,22847,6077,13207,,23071654,11660141,514266,22291750,11145875,
2021-10-28,22302,5791,12643,,23093956,11665644,507403,22316482,11158241,
2021-10-29,22809,5731,13046,,23116765,11671073,500073,22342000,11171000,
2021-10-30,24109,6041,14613,,23140874,11676842,491489,22370706,11185353,
2021-10-31,16475,4594,10597,,23157349,11681142,485481,22391322,11195661,
2021-11-01,7869,2080,5054,,23165218,11682942,482494,22400896,11200448,
2021-11-02,15622,4364,7744,,23180840,11687017,479103,22415828,11207914,
2021-11-03,18621,5067,9602,,23199461,11691781,474558,22434446,11217223,
2021-11-04,19505,4874,10031,,23218966,11696379,469386,22453986,11226993,
2021-11-05,21464,4404,9519,,23240430,11700494,464257,22472474,11236237,
2021-11-06,25330,5205,12154,,23265760,11705430,457291,22496278,11248139,
2021-11-07,21448,4024,8921,,23287208,11709173,452382,22513582,11256791,
2021-11-08,11990,2110,4731,,23299198,11710988,449745,22522486,11261243,
2021-11-09,24120,3850,7645,,23323318,11714517,445940,22537154,11268577,
2021-11-10,28474,4508,8994,,23351792,11718748,441440,22554616,11277308,
2021-11-11,28754,4305,9094,,23380546,11722757,436642,22572230,11286115,
2021-11-12,26738,4162,8236,,23407284,11726628,432554,22588148,11294074,
2021-11-13,34308,5080,11409,,23441592,11731402,426216,22610372,11305186,
2021-11-14,23217,3897,8604,,23464809,11735036,421502,22627068,11313534,
2021-11-15,12700,2184,4494,,23477509,11736960,419184,22635552,11317776,
2021-11-16,26170,3928,7479,,23503679,11740632,415629,22650006,11325003,
2021-11-17,31164,4046,7816,,23534843,11744396,411849,22665094,11332547,
2021-11-18,32502,3865,7526,,23567345,11747955,408174,22679562,11339781,
2021-11-19,35469,3860,7752,,23602814,11751514,404270,22694488,11347244,
2021-11-20,40109,4381,8815,,23642923,11755615,399827,22711576,11355788,
2021-11-21,28116,3435,6945,,23671039,11758788,396303,22724970,11362485,
2021-11-22,14898,1950,3894,,23685937,11760462,394353,22732218,11366109,
2021-11-23,33046,3273,6007,,23718983,11763455,391611,22743688,11371844,
2021-11-24,42650,3755,6801,,23761633,11766906,388554,22756704,11378352,
2021-11-25,46035,3931,6568,,23807668,11770562,385914,22769296,11384648,
2021-11-26,52863,11347,6613,,23860531,11781639,390641,22781996,11390998,
2021-11-27,63511,22353,7031,,23924042,11803711,405953,22795516,11397758,
2021-11-28,51452,27739,5311,,23975494,11831158,428369,22805578,11402789,
2021-11-29,33525,18933,2880,,24009019,11849830,444411,22810838,11405419,
2021-11-30,56029,20680,5133,,24065048,11870229,459948,22820562,11410281,
2021-12-01,69537,26243,5633,,24134585,11896166,480544,22831244,11415622,
2021-12-02,71629,26486,5036,,24206214,11922354,501981,22840746,11420373,
2021-12-03,73417,25095,5169,,24279631,11947153,521901,22850504,11425252,
2021-12-04,81148,27784,6068,47276,24360779,11974644,543608,,11431036,807656
2021-12-05,62625,31927,4408,26268,24423404,12006276,571119,,11435157,833820
2021-12-06,38624,19142,2712,16755,24462028,12025129,587542,,11437587,850497
2021-12-07,60282,14850,4471,40947,24522310,12039707,597911,,11441796,891370
2021-12-08,73446,19055,4677,49711,24595756,12058485,612279,,11446206,941003
2021-12-09,74494,18273,4341,51860,24670250,12076449,626203,,11450246,992778
2021-12-10,77493,17589,4654,55241,24747743,12093757,639133,,11454624,1047938
2021-12-11,83178,20404,5825,56937,24830921,12113872,653698,,11460174,1104789
2021-12-12,60753,22696,4156,33858,24891674,12136288,672232,,11464056,1138558
2021-12-13,34931,11603,2408,20897,24926605,12147594,681417,,11466177,1159360
2021-12-14,101972,9001,3860,89067,25028577,12156284,686543,,11469741,1248307
2021-12-15,127690,12427,4509,110716,25156267,12168407,694451,,11473956,1358923
2021-12-16,139355,12460,4251,122628,25295622,12180581,702650,,11477931,1481452
2021-12-17,159165,12401,4517,142225,25454787,12192707,710525,,11482182,1623580
2021-12-18,175584,13523,4922,157093,25630371,12205936,719114,,11486822,1780578
2021-12-19,140437,18159,3929,118312,25770808,12223794,733336,,11490458,1898779
2021-12-20,106821,10305,2745,93724,25877629,12233831,740886,,11492945,1992405
2021-12-21,215385,12962,4313,198088,26093014,12246477,749528,,11496949,2190372
2021-12-22,237247,14420,5199,217743,26330261,12260598,758735,,11501863,2407997
2021-12-23,257759,11719,5086,240857,26588020,12272012,765362,,11506650,2648748
2021-12-24,223602,9453,4568,209514,26811622,12281168,770243,,11510925,2858146
2021-12-25,89722,3885,2508,83341,26901344,12284778,771615,,11513163,2941380
2021-12-26,11895,388,358,11139,26913239,12284874,771637,,11513237,2952389
2021-12-27,46940,1491,1114,44304,26960179,12286120,772007,,11514113,2996573
2021-12-28,144776,6098,4010,134607,27104955,12291924,774084,,11517840,3131049
2021-12-29,175462,9376,4579,161437,27280417,12301004,778877,,11522127,3292358
2021-12-30,200059,10131,5347,184539,27480476,12310832,783646,,11527186,3476763
2021-12-31,195197,10006,5798,179140,27675673,12320549,787845,,11532704,3655777
2022-01-01,96951,5383,3879,87362,27772624,12325623,789341,,11536282,3742990
2022-01-02,19442,941,928,17444,27792066,12326273,789345,,11536928,3760288
2022-01-03,88253,4773,4591,78808,27880319,12330736,789519,,11541217,3838943
2022-01-04,146362,6000,5314,135008,28026681,12336408,790192,,11546216,3973795
2022-01-05,177499,7627,7292,162407,28204180,12343681,790516,,11553165,4136042
2022-01-06,191530,7205,6786,177012,28395710,12350567,790924,,11559643,4312899
2022-01-07,191282,7963,6996,175510,28586992,12358186,791879,,11566307,4488236
2022-01-08,181667,8624,6634,165221,28768659,12366478,793856,,11572622,4653301
2022-01-09,131099,9866,7182,113958,28899758,12376022,796535,,11579487,4767099
2022-01-10,90558,5107,4489,80831,28990316,12380807,797143,,11583664,4847777
2022-01-11,138878,6154,6570,125448,29129194,12386614,796714,,11589900,4973035
2022-01-12,157026,8160,8054,138689,29286220,12394445,796815,,11597630,5111556
2022-01-13,162679,9210,9215,141544,29448899,12403293,796796,,11606497,5252917
2022-01-14,159881,10753,10380,136058,29608780,12413685,797164,,11616521,5388777
2022-01-15,161203,11011,11672,135886,29769983,12424325,796492,,11627833,5524470
2022-01-16,109781,9292,9674,89455,29879764,12433255,796103,,11637152,5613707
2022-01-17,65785,5937,6566,52641,29945549,12438856,795464,,11643392,5666163
2022-01-18,36108,2003,2130,31151,29981657,12440504,795326,,11645178,5697118
2022-01-19,101319,5582,6720,85956,30082976,12445686,794170,,11651516,5782847
2022-01-20,103597,6321,7004,85734,30186573,12451623,793479,,11658144,5868358
2022-01-21,102107,6231,8058,82505,30288680,12457450,791638,,11665812,5950635
2022-01-22,102577,8712,12073,78114,30391257,12465773,788270,,11677503,6028521
2022-01-23,76697,7307,13993,54798,30467954,12472737,781577,,11691160,6083097
2022-01-24,42263,3195,7935,30744,30510217,12475568,776819,,11698749,6113634
2022-01-25,62560,3756,8369,48116,30572777,12478945,772191,,11706754,6161531
2022-01-26,77885,4914,13170,55693,30650662,12483482,763930,,11719552,6216982
2022-01-27,78074,4894,13243,56050,30728736,12488004,755571,,11732433,6272795
2022-01-28,77283,4672,13676,53896,30806019,12492318,746554,,11745764,6326472
2022-01-29,84818,5527,17712,58116,30890837,12497481,734362,,11763119,6384343
2022-01-30,66506,5024,20630,40157,30957343,12502163,718742,,11783421,6424275
2022-01-31,34743,2175,9881,22348,30992086,12504019,711027,,11792992,6446434
2022-02-01,51351,3265,9664,36527,31043437,12506931,704618,,11802313,6482736
2022-02-02,57710,3847,12397,38680,31101147,12510447,696053,,11814394,6521216
2022-02-03,52579,3610,11510,34299,31153726,12513680,688141,,11825539,6555264
2022-02-04,43092,2947,10560,27285,31196818,12516317,680518,,11835799,6582355
2022-02-05,58720,3743,14473,37564,31255538,12519728,669776,,11849952,6619706
2022-02-06,49857,3639,16115,29572,31305395,12523044,657295,,11865749,6649054
2022-02-07,23233,1690,7810,13440,31328628,12524408,651162,,11873246,6662270
2022-02-08,33393,2355,7249,21971,31362021,12526433,646261,,11880172,6684008
2022-02-09,38880,2784,8916,24409,31400901,12528858,640123,,11888735,6708165
2022-02-10,37535,2764,8835,22551,31438436,12531286,634048,,11897238,6730486
2022-02-11,39448,2724,10292,23005,31477884,12533664,626471,,11907193,6753253
2022-02-12,42045,2956,11456,25317,31519929,12536286,617960,,11918326,6778346
2022-02-13,36317,2800,13142,19941,31556246,12538799,607615,,11931184,6798089
2022-02-14,16975,1175,6119,9472,31573221,12539699,602663,,11937036,6807361
2022-02-15,19352,1384,4750,11878,31592573,12540759,599287,,11941472,6819012
2022-02-16,26019,1767,7730,14947,31618592,12542229,593320,,11948909,6833758
2022-02-17,26763,1683,7524,14984,31645355,12543557,587470,,11956087,6848487
2022-02-18,23941,1354,6608,13677,31669296,12544594,582204,,11962390,6861955
2022-02-19,37833,1903,8338,26050,31707129,12546166,575764,,11970402,6887764
2022-02-20,32575,1498,7963,22805,31739704,12547364,569291,,11978073,6910365
2022-02-21,17502,913,3678,12757,31757206,12547982,566517,,11981465,6922911
2022-02-22,9112,430,1555,6957,31766318,12548122,565387,,11982735,6929657
2022-02-23,25333,1325,4794,17295,31791651,12549137,561911,,11987226,6946716
2022-02-24,24572,1401,5233,15483,31816223,12550216,558074,,11992142,6961956
2022-02-25,23101,1389,5137,14508,31839324,12551311,554319,,11996992,6976238
2022-02-26,25231,1385,5909,16556,31864555,12552386,549788,,12002598,6992568
2022-02-27,26956,1370,7369,17703,31891511,12553487,543778,,12009709,7010076
2022-02-28,10129,594,2531,6745,31901640,12553828,541833,,12011995,7016638
2022-03-01,13198,947,3150,8166,31914838,12554470,539620,,12014850,7024587
2022-03-02,15416,1164,3577,9618,31930254,12555373,537200,,12018173,7034028
2022-03-03,14298,1077,3227,8689,31944552,12556138,535042,,12021096,7042486
2022-03-04,14473,991,3445,8314,31959025,12556808,532584,,12024224,7050547
2022-03-05,18528,1276,4996,11183,31977553,12557775,528853,,12028922,7061506
2022-03-06,16514,1088,5524,9604,31994067,12558583,524411,,12034172,7070903
2022-03-07,5949,468,1861,3509,32000016,12558766,523011,,12035755,7074195
2022-03-08,7362,699,1943,4158,32007378,12559187,521760,,12037427,7078154
2022-03-09,11157,907,2736,6406,32018535,12559818,519925,,12039893,7084358
2022-03-10,12760,1044,3256,6837,32031295,12560585,517706,,12042879,7090982
2022-03-11,12889,904,3408,6864,32044184,12561200,515194,,12046006,7097630
2022-03-12,14683,1046,4183,8310,32058867,12561974,512054,,12049920,7105736
2022-03-13,14747,1091,4999,8332,32073614,12562774,508142,,12054632,7113831
2022-03-14,6333,450,2228,3499,32079947,12562953,506361,,12056592,7117116
2022-03-15,10197,792,2625,5972,32090144,12563455,504516,,12058939,7122874
2022-03-16,13062,934,3666,6953,32103206,12564101,501781,,12062320,7129597
2022-03-17,13196,1047,3960,6757,32116402,12564860,498861,,12065999,7136134
2022-03-18,11904,913,3145,6432,32128306,12565470,496619,,12068851,7142342
2022-03-19,14442,1004,4163,7902,32142748,12566194,493458,,12072736,7150025
2022-03-20,11746,990,3958,6371,32154494,12566913,490485,,12076428,7156188
2022-03-21,5057,414,1589,2814,32159551,12567068,489306,,12077762,7158799
2022-03-22,6710,552,1558,3892,32166261,12567332,488294,,12079038,7162475
2022-03-23,9970,785,2299,5195,32176231,12567801,486777,,12081024,7167429
2022-03-24,9295,723,2377,4611,32185526,12568260,485114,,12083146,7171836
2022-03-25,9223,781,2153,4751,32194749,12568778,483734,,12085044,7176375
2022-03-26,10926,936,2833,5506,32205675,12569437,481835,,12087602,7181662
2022-03-27,10225,910,3537,5301,32215900,12570087,479204,,12090883,7186752
2022-03-28,3583,322,1109,1987,32219483,12570169,478414,,12091755,7188545
2022-03-29,5346,499,1212,2692,32224829,12570383,477695,,12092688,7191015
2022-03-30,7854,748,1837,4122,32232683,12570852,476601,,12094251,7194912
2022-03-31,8652,689,1925,4413,32241335,12571252,475359,,12095893,7199103
2022-04-01,9310,801,1915,4888,32250645,12571761,474236,,12097525,7203752
2022-04-02,10446,888,2215,5571,32261091,12572362,472897,,12099465,7209106
2022-04-03,9204,880,2567,5065,32270295,12572985,471204,,12101781,7213969
2022-04-04,4202,387,1006,2406,32274497,12573111,470582,,12102529,7216172
2022-04-05,6076,600,1036,3051,32280573,12573371,470140,,12103231,7218948
2022-04-06,8379,714,1477,4382,32288952,12573794,469372,,12104422,7223103
2022-04-07,10344,733,1687,4836,32299296,12574227,468413,,12105814,7227696
2022-04-08,23994,811,1582,4836,32323290,12574760,467636,,12107124,7232316
2022-04-09,30495,969,1974,5895,32353785,12575431,466622,,12108809,7237988
2022-04-10,24863,976,2390,5332,32378648,12576148,465202,,12110946,7243118
2022-04-11,12570,385,876,2431,32391218,12576283,464707,,12111576,7245347
2022-04-12,28126,693,1018,3536,32419344,12576672,464375,,12112297,7248650
2022-04-13,37780,853,1560,4927,32457124,12577226,463664,,12113562,7253347
2022-04-14,37904,761,1615,4913,32495028,12577675,462807,,12114868,7258007
2022-04-15,43399,1231,2104,6725,32538427,12578608,461930,,12116678,7264495
2022-04-16,8094,357,650,1741,32546521,12578705,461635,,12117070,7266020
2022-04-17,21015,870,1924,4318,32567536,12579291,460574,,12118717,7270115
2022-04-18,5459,306,463,1289,32572995,12579310,460412,,12118898,7271163
2022-04-19,22652,615,773,3103,32595647,12579642,460245,,12119397,7274046
2022-04-20,40334,1061,1396,4619,32635981,12580377,459907,,12120470,7278401
2022-04-21,38754,943,1600,4682,32674735,12581024,459241,,12121783,7282849
2022-04-22,35628,1015,1432,4267,32710363,12581767,458817,,12122950,7286898
2022-04-23,34654,1006,1736,4712,32745017,12582489,458084,,12124405,7291371
2022-04-24,20815,1021,1888,3776,32765832,12583260,457214,,12126046,7294953
2022-04-25,8299,453,691,1707,32774131,12583444,456975,,12126469,7296444
2022-04-26,24618,732,945,3146,32798749,12583884,456756,,12127128,7299353
2022-04-27,33600,955,1368,3938,32832349,12584563,456335,,12128228,7303074
2022-04-28,32834,928,1414,3930,32865183,12585218,455840,,12129378,7306781
2022-04-29,32060,1098,1379,3912,32897243,12586018,455552,,12130466,7310464
2022-04-30,30283,924,1534,4025,32927526,12586646,454935,,12131711,7314254
2022-05-01,16752,769,1579,2970,32944278,12587118,454120,,12132998,7316981
2022-05-02,5934,309,524,1098,32950212,12587131,453901,,12133230,7317852
2022-05-03,20928,588,831,2347,32971140,12587414,453652,,12133762,7319960
2022-05-04,29416,799,1091,3291,33000556,12587903,453355,,12134548,7323002
2022-05-05,29097,872,1162,3125,33029653,12588463,453055,,12135408,7325883
2022-05-06,29097,1147,1285,2987,33058750,12589322,452912,,12136410,7328643
2022-05-07,28490,869,1265,3113,33087240,12589901,452511,,12137390,7331532
2022-05-08,15998,895,1308,2323,33103238,12590539,452096,,12138443,7333654
2022-05-09,5897,293,474,943,33109135,12590566,451909,,12138657,7334387
2022-05-10,21227,696,719,2120,33130362,12590944,451879,,12139065,7336247
2022-05-11,28949,836,1083,2655,33159311,12591448,451628,,12139820,7338631
2022-05-12,28240,799,1084,2513,33187551,12591950,451339,,12140611,7340903
2022-05-13,27593,878,1118,2468,33215144,12592517,451094,,12141423,7343114
2022-05-14,25691,807,1098,2609,33240835,12593008,450796,,12142212,7345468
2022-05-15,14848,751,1275,2057,33255683,12593487,450265,,12143222,7347306
2022-05-16,6384,326,532,1047,33262067,12593575,450055,,12143520,7348166
2022-05-17,19602,589,778,1741,33281669,12593848,449859,,12143989,7349658
2022-05-18,26544,878,1101,2272,33308213,12594462,449631,,12144831,7351715
2022-05-19,24440,681,1155,2164,33332653,12594876,449150,,12145726,7353662
2022-05-20,24269,801,1139,2217,33356922,12595409,448808,,12146601,7355661
2022-05-21,22405,692,1167,2350,33379327,12595792,448324,,12147468,7357769
2022-05-22,10560,550,890,1489,33389887,12596081,447979,,12148102,7359041
2022-05-23,4572,242,464,792,33394459,12596063,447755,,12148308,7359624
2022-05-24,2622,119,179,439,33397081,12595929,447693,,12148236,7359854
2022-05-25,19363,656,947,1953,33416444,12596319,447392,,12148927,7361597
2022-05-26,20643,663,949,1909,33437087,12596708,447100,,12149608,7363283
2022-05-27,21759,818,1057,2078,33458846,12597238,446858,,12150380,7365128
2022-05-28,19406,722,1165,2147,33478252,12597690,446412,,12151278,7367061
2022-05-29,12111,760,1282,1726,33490363,12598215,445883,,12152332,7368595
2022-05-30,4580,311,550,751,33494943,12598280,445641,,12152639,7369148
2022-05-31,13547,573,750,1665,33508490,12598551,445458,,12153093,7370573
2022-06-01,16613,704,971,1879,33525103,12598952,445189,,12153763,7372198
2022-06-02,14607,557,867,1676,33539710,12599197,444872,,12154325,7373633
2022-06-03,16103,697,1096,1814,33555813,12599616,444467,,12155149,7375229
2022-06-04,13323,647,1165,1845,33569136,12600005,443944,,12156061,7376872
2022-06-05,7867,587,1110,1432,33577003,12600343,443417,,12156926,7378112
2022-06-06,3294,206,445,641,33580297,12600301,443175,,12157126,7378552
2022-06-07,11221,475,727,1370,33591518,12600476,442918,,12157558,7379678
2022-06-08,14067,667,1013,1610,33605585,12600883,442567,,12158316,7381069
2022-06-09,13375,663,924,1675,33618960,12601258,442301,,12158957,7382512
2022-06-10,13851,685,1068,1697,33632811,12601657,441910,,12159747,7383979
2022-06-11,12983,616,1031,1844,33645794,12601987,441493,,12160494,7385600
2022-06-12,8098,643,1236,1504,33653892,12602372,440896,,12161476,7386897
2022-06-13,3188,284,422,711,33657080,12602389,440753,,12161636,7387399
2022-06-14,10128,511,666,1264,33667208,12602611,440592,,12162019,7388425
2022-06-15,13509,472,832,1620,33680717,12602788,440230,,12162558,7389808
2022-06-16,12542,495,856,1616,33693259,12602978,439864,,12163114,7391177
2022-06-17,11693,479,818,1653,33704952,12603171,439518,,12163653,7392595
2022-06-18,11451,436,875,1860,33716403,12603336,439076,,12164260,7394231
2022-06-19,7003,483,899,1419,33723406,12603568,438659,,12164909,7395437
2022-06-20,2286,147,301,643,33725692,12603491,438499,,12164992,7395910
2022-06-21,9542,357,615,1384,33735234,12603561,438236,,12165325,7397046
2022-06-22,13610,406,725,1703,33748844,12603695,437910,,12165785,7398524
2022-06-23,13704,401,775,1683,33762548,12603829,437533,,12166296,7399993
2022-06-24,15365,435,811,1674,33777913,12604004,437153,,12166851,7401452
2022-06-25,14469,425,851,1713,33792382,12604168,436716,,12167452,7402956
2022-06-26,8157,432,885,1279,33800539,12604338,436256,,12168082,7404018
2022-06-27,3213,171,365,594,33803752,12604260,436058,,12168202,7404405
2022-06-28,9620,369,558,1226,33813372,12604344,435865,,12168479,7405399
2022-06-29,13315,415,730,1631,33826687,12604469,435548,,12168921,7406790
2022-06-30,12233,482,847,1581,33838920,12604667,435181,,12169486,7408138
2022-07-01,13037,548,971,1949,33851957,12604957,434753,,12170204,7409881
2022-07-02,1614,110,115,364,33853571,12604791,434746,,12170045,7410013
2022-07-03,5159,260,493,960,33858730,12604794,434504,,12170290,7410757
2022-07-04,2757,132,279,614,33861487,12604679,434356,,12170323,7411174
2022-07-05,11142,372,599,1573,33872629,12604754,434121,,12170633,7412499
2022-07-06,15960,549,859,2009,33888589,12605008,433805,,12171203,7414266
2022-07-07,15665,520,832,1926,33904254,12605240,433492,,12171748,7415939
2022-07-08,17886,555,869,2245,33922140,12605490,433177,,12172313,7417935
2022-07-09,14142,450,597,1845,33936282,12605664,433029,,12172635,7419544
2022-07-10,8747,475,754,1503,33945029,12605891,432749,,12173142,7420841
2022-07-11,4094,199,331,871,33949123,12605825,432614,,12173211,7421492
2022-07-12,12107,412,524,1655,33961230,12605938,432497,,12173441,7422893
2022-07-13,16720,564,772,2143,33977950,12606206,432283,,12173923,7424793
2022-07-14,16860,483,675,2023,33994810,12606383,432080,,12174303,7426576
2022-07-15,28894,599,822,2186,34023704,12606682,431856,,12174826,7428521
2022-07-16,30298,586,772,2327,34054002,12606954,431661,,12175293,7430596
2022-07-17,22930,537,636,1890,34076932,12607254,431559,,12175695,7432292
2022-07-18,11397,189,255,856,34088329,12607175,431488,,12175687,7432926
2022-07-19,28955,592,591,2136,34117284,12607492,431486,,12176006,7434830
2022-07-20,37638,840,923,2592,34154922,12608053,431398,,12176655,7437185
2022-07-21,36356,733,811,2808,34191278,12608499,431313,,12177186,7439753
2022-07-22,35800,824,891,2685,34227078,12609036,431240,,12177796,7442201
2022-07-23,35151,821,912,2834,34262229,12609542,431141,,12178401,7444779
2022-07-24,21737,599,804,1777,34283966,12609878,430933,,12178945,7446331
2022-07-25,11935,308,311,1080,34295901,12609902,430925,,12178977,7447181
2022-07-26,26090,619,603,2212,34321991,12610238,430940,,12179298,7449151
2022-07-27,32470,809,847,2649,34354461,12610789,430900,,12179889,7451589
2022-07-28,31541,724,884,2609,34386002,12611216,430736,,12180480,7453947
2022-07-29,29993,1790,875,2645,34415995,12612714,431647,,12181067,7456342
2022-07-30,25830,2525,747,2435,34441825,12614958,433423,,12181535,7458543
2022-07-31,14307,1067,540,1562,34456132,12615756,433946,,12181810,7459877
2022-08-01,5914,336,223,682,34462046,12615833,434057,,12181776,7460336
2022-08-02,4480,306,138,602,34466526,12615869,434221,,12181648,7460716
2022-08-03,22940,2637,738,2238,34489466,12618230,436116,,12182114,7462718
2022-08-04,22232,2482,679,2131,34511698,12620385,437913,,12182472,7464586
2022-08-05,21794,2755,745,2068,34533492,12622859,439915,,12182944,7466426
2022-08-06,19644,2875,657,1993,34553136,12625423,442127,,12183296,7468161
2022-08-07,12706,2236,620,1422,34565842,12627384,443737,,12183647,7469365
2022-08-08,4766,570,188,603,34570608,12627666,444112,,12183554,7469731
2022-08-09,14011,1467,558,1592,34584619,12628846,445015,,12183831,7471082
2022-08-10,19130,2364,718,1992,34603749,12630937,446659,,12184278,7472846
2022-08-11,17076,2040,717,1857,34620825,12632701,447980,,12184721,7474470
2022-08-12,16982,2048,734,1852,34637807,12634460,449293,,12185167,7476093
2022-08-13,15952,2223,764,1808,34653759,12636401,450750,,12185651,7477662
2022-08-14,9527,1621,618,1084,34663286,12637733,451749,,12185984,7478510
2022-08-15,3871,388,271,477,34667157,12637868,451863,,12186005,7478778
2022-08-16,10807,1073,516,1356,34677964,12638642,452418,,12186224,7479884
2022-08-17,16096,1833,739,1782,34694060,12640188,453511,,12186677,7481430
2022-08-18,14930,1641,748,1693,34708990,12641504,454400,,12187104,7482851
2022-08-19,15316,1846,749,1550,34724306,12643073,455493,,12187580,7484167
2022-08-20,14284,1641,740,1545,34738590,12644423,456388,,12188035,7485474
2022-08-21,9904,1533,660,1164,34748494,12645691,457257,,12188434,7486421
2022-08-22,4163,481,271,561,34752657,12645869,457464,,12188405,7486723
2022-08-23,11133,1248,554,1494,34763790,12646810,458154,,12188656,7487965
2022-08-24,14759,1808,871,2186,34778549,12648347,459091,,12189256,7489920
2022-08-25,14028,1718,780,2121,34792577,12649777,460022,,12189755,7491796
2022-08-26,13929,1689,816,2092,34806506,12651171,460888,,12190283,7493639
2022-08-27,12414,1486,876,1998,34818920,12652332,461492,,12190840,7495371
2022-08-28,7923,1258,621,1397,34826843,12653330,462127,,12191203,7496549
2022-08-29,3399,502,286,684,34830242,12653551,462338,,12191213,7496999
2022-08-30,9905,1169,649,1855,34840147,12654364,462852,,12191512,7498553
2022-08-31,13511,1628,946,2312,34853658,12655702,463530,,12192172,7500622
2022-09-01,12906,1721,912,2141,34866564,12657127,464334,,12192793,7502517
2022-09-02,15043,1616,991,4917,34881607,12658468,464951,,12193517,7507208
2022-09-03,14717,1525,923,5515,34896324,12659711,465550,,12194161,7512489
2022-09-04,8665,1010,675,3236,34904989,12660457,465876,,12194581,7515505
2022-09-05,3555,321,229,1386,34908544,12660513,465965,,12194548,7516669
2022-09-06,2467,157,114,1132,34911011,12660416,466005,,12194411,7517592
2022-09-07,10924,1018,587,3491,34921935,12661136,466432,,12194704,7520832
2022-09-08,10868,1021,526,2790,34932803,12661828,466924,,12194904,7523345
2022-09-09,9581,1011,488,2502,34942384,12662552,467442,,12195110,7525612
2022-09-10,10633,1264,551,3165,34953017,12663540,468148,,12195392,7528544
2022-09-11,9410,983,667,3735,34962427,12664275,468458,,12195817,7532070
2022-09-12,3125,294,204,1079,34965552,12664287,468542,,12195745,7532912
2022-09-13,6017,544,283,1132,34971569,12664545,468794,,12195751,7533802
2022-09-14,14483,798,434,1844,34986052,12665024,469154,,12195870,7535380
2022-09-15,15752,779,408,1532,35001804,12665483,469520,,12195963,7536641
2022-09-16,17756,766,448,1690,35019560,12665990,469832,,12196158,7538111
2022-09-17,17616,722,456,1667,35037176,12666408,470094,,12196314,7539524
2022-09-18,11213,773,451,1688,35048389,12666923,470414,,12196509,7540991
2022-09-19,4978,404,288,669,35053367,12667057,470525,,12196532,7541448
2022-09-20,13768,442,332,944,35067135,12667185,470633,,12196552,7542130
2022-09-21,23037,646,409,1497,35090172,12667523,470865,,12196658,7543373
2022-09-22,22914,636,398,1378,35113086,12667852,471097,,12196755,7544490
2022-09-23,22946,725,601,1418,35136032,12668278,471216,,12197062,7545654
2022-09-24,21690,737,689,1498,35157722,12668721,471260,,12197461,7546916
2022-09-25,11318,595,702,1355,35169040,12669038,471147,,12197891,7548038
2022-09-26,4563,192,218,594,35173603,12668940,471115,,12197825,7548389
2022-09-27,37650,497,365,1497,35211253,12669170,471243,,12197927,7549661
2022-09-28,50966,731,671,1900,35262219,12669632,471302,,12198330,7551335
2022-09-29,48005,637,740,1836,35310224,12669952,471191,,12198761,7552897
2022-09-30,47270,677,806,2003,35357494,12670302,471060,,12199242,7554619
2022-10-01,34447,527,633,1545,35391941,12670523,470952,,12199571,7555899
2022-10-02,24245,736,1028,1711,35416186,12670966,470657,,12200309,7557359
2022-10-03,10867,238,230,611,35427053,12670912,470661,,12200251,7557732
2022-10-04,32195,478,458,1169,35459248,12671071,470677,,12200394,7558625
2022-10-05,40431,625,740,1561,35499679,12671381,470556,,12200825,7559925
2022-10-06,38690,610,653,1567,35538369,12671688,470511,,12201177,7561232
2022-10-07,42240,661,851,1742,35580609,12672005,470313,,12201692,7562676
2022-10-08,37395,783,1144,2120,35618004,12672457,469946,,12202511,7564521
2022-10-09,18813,549,727,1556,35636817,12672731,469765,,12202966,7565842
2022-10-10,6864,168,370,566,35643681,12672601,469560,,12203041,7566148
2022-10-11,4993,124,111,318,35648674,12672431,469568,,12202863,7566228
2022-10-12,35113,579,685,1428,35683787,12672678,469460,,12203218,7567368
2022-10-13,36757,644,858,1620,35720544,12672961,469243,,12203718,7568683
2022-10-14,36975,621,753,1541,35757519,12673253,469108,,12204145,7569945
2022-10-15,35451,714,1013,1627,35792970,12673677,468806,,12204871,7571324
2022-10-16,20663,654,1024,1593,35813633,12674063,468430,,12205633,7572688
2022-10-17,7356,206,477,541,35820989,12673987,468157,,12205830,7572990
2022-10-18,36426,457,500,1398,35857415,12674128,468109,,12206019,7574119
2022-10-19,49901,619,730,1981,35907316,12674449,467995,,12206454,7575852
2022-10-20,51285,623,649,2049,35958601,12674762,467966,,12206796,7577640
2022-10-21,52847,697,619,1935,36011448,12675134,468040,,12207094,7579307
2022-10-22,50864,751,904,2309,36062312,12675559,467882,,12207677,7581345
2022-10-23,30638,572,785,2121,36092950,12675819,467663,,12208156,7583205
2022-10-24,14133,232,271,978,36107083,12675754,467619,,12208135,7583930
2022-10-25,41365,473,489,1818,36148448,12675882,467600,,12208282,7585456
2022-10-26,51654,615,660,2124,36200102,12676167,467551,,12208616,7587304
2022-10-27,50113,606,768,2162,36250215,12676452,467381,,12209071,7589200
2022-10-28,49797,590,675,2095,36300012,12676689,467291,,12209398,7590991
2022-10-29,50595,733,779,2221,36350607,12677076,467241,,12209835,7592914
2022-10-30,28397,661,930,2037,36379004,12677459,466968,,12210491,7594711
2022-10-31,12439,200,234,777,36391443,12677385,466931,,12210454,7595257
2022-11-01,33093,339,198,1220,36424536,12677383,467066,,12210317,7596187
2022-11-02,44284,574,624,1903,36468820,12677632,467012,,12210620,7597797
2022-11-03,44186,540,604,1856,36513006,12677850,466944,,12210906,7599374
2022-11-04,44642,647,528,2028,36557648,12678196,467056,,12211140,7601150
2022-11-05,45203,645,753,2369,36602851,12678543,466945,,12211598,7603255
2022-11-06,26016,558,771,2097,36628867,12678765,466729,,12212036,7605060
2022-11-07,10710,243,235,876,36639577,12678733,466734,,12211999,7605708
2022-11-08,33479,485,396,1585,36673056,12678935,466820,,12212115,7607054
2022-11-09,40527,604,570,1964,36713583,12679229,466852,,12212377,7608755
2022-11-10,39168,620,547,1928,36752751,12679536,466920,,12212616,7610413
2022-11-11,43338,633,640,2209,36796089,12679856,466912,,12212944,7612351
2022-11-12,36846,637,591,2183,36832935,12680174,466950,,12213224,7614256
2022-11-13,24267,559,770,2276,36857202,12680447,466733,,12213714,7616288
2022-11-14,10966,232,204,1024,36868168,12680391,466760,,12213631,7617060
2022-11-15,33613,484,380,1692,36901781,12680514,466859,,12213655,7618447
2022-11-16,43540,799,583,2369,36945321,12681020,467069,,12213951,7620570
2022-11-17,38342,674,647,2241,36983663,12681365,467092,,12214273,7622531
2022-11-18,40621,726,531,2329,37024284,12681752,467283,,12214469,7624564
2022-11-19,39654,1005,1031,3060,37063938,12682417,467253,,12215164,7627323
2022-11-20,22421,659,718,2442,37086359,12682805,467190,,12215615,7629539
2022-11-21,8922,197,193,969,37095281,12682741,467189,,12215552,7630304
2022-11-22,26438,479,368,1512,37121719,12682871,467296,,12215575,7631511
2022-11-23,32078,685,669,2069,37153797,12683233,467310,,12215923,7633306
2022-11-24,31900,664,751,2085,37185697,12683590,467221,,12216369,7635135
2022-11-25,30751,763,828,1951,37216448,12684048,467150,,12216898,7636830
2022-11-26,30285,906,1191,2698,37246733,12684623,466856,,12217767,7639246
2022-11-27,18675,608,944,2087,37265408,12684933,466515,,12218418,7641081
2022-11-28,7537,190,280,787,37272945,12684834,466418,,12218416,7641615
2022-11-29,21021,421,453,1292,37293966,12684935,466382,,12218553,7642635
2022-11-30,27891,643,650,1842,37321857,12685270,466373,,12218897,7644210
2022-12-01,24805,593,682,1692,37346662,12685542,466281,,12219261,7645622
2022-12-02,25053,524,630,1773,37371715,12685748,466169,,12219579,7647120
2022-12-03,25556,588,781,1944,37397271,12686022,465966,,12220056,7648809
2022-12-04,15250,494,606,1702,37412521,12686192,465849,,12220343,7650224
2022-12-05,6877,167,157,746,37419398,12686071,465854,,12220217,7650726
2022-12-06,20345,421,352,1376,37439743,12686135,465918,,12220217,7651799
2022-12-07,24779,555,608,1670,37464522,12686383,465859,,12220524,7653206
2022-12-08,23161,563,521,1763,37487683,12686640,465899,,12220741,7654700
2022-12-09,23324,635,574,1632,37511007,12686958,465957,,12221001,7656064
2022-12-10,22571,507,601,1631,37533578,12687161,465860,,12221301,7657430
2022-12-11,14204,548,786,1566,37547782,12687449,465619,,12221830,7658773
2022-12-12,5506,149,156,595,37553288,12687314,465607,,12221707,7659132
2022-12-13,17795,375,370,1124,37571083,12687378,465610,,12221768,7659992
2022-12-14,21320,511,547,1454,37592403,12687607,465568,,12222039,7661210
2022-12-15,21967,531,603,1580,37614370,12687813,465494,,12222319,7662509
2022-12-16,16286,378,451,1031,37630656,12687874,465418,,12222456,7663272
2022-12-17,18696,557,507,1275,37649352,12688121,465466,,12222655,7664270
2022-12-18,12638,529,794,1306,37661990,12688381,465200,,12223181,7665335
2022-12-19,4585,131,116,449,37666575,12688195,465211,,12222984,7665510
2022-12-20,16207,499,449,1109,37682782,12688388,465254,,12223134,7666360
2022-12-21,18472,541,552,1303,37701254,12688640,465239,,12223401,7667411
2022-12-22,18598,574,591,1746,37719852,12688926,465222,,12223704,7668906
2022-12-23,15644,574,599,1716,37735496,12689158,465192,,12223966,7670337
2022-12-24,5338,224,172,673,37740834,12689089,465243,,12223846,7670748
2022-12-25,2444,153,153,480,37743278,12688947,465234,,12223713,7670973
2022-12-26,262,12,7,48,37743540,12688671,465234,,12223437,7670775
2022-12-27,2094,98,36,306,37745634,12688493,465293,,12223200,7670850
2022-12-28,8318,337,168,974,37753952,12688529,465457,,12223072,7671560
2022-12-29,13163,582,528,1601,37767115,12688803,465507,,12223296,7672895
2022-12-30,15820,666,658,1881,37782935,12689175,465512,,12223663,7674513
2022-12-31,11230,460,387,1355,37794165,12689300,465581,,12223719,7675578
2023-01-01,3907,201,219,563,37798072,12689202,465563,,12223639,7675876
2023-01-02,652,36,14,97,37798724,12688965,465584,,12223381,7675735
2023-01-03,8196,297,151,902,37806920,12688989,465724,,12223265,7676406
2023-01-04,14720,574,547,1546,37821640,12689286,465745,,12223541,7677708
2023-01-05,16117,643,535,1796,37837757,12689639,465845,,12223794,7679254
2023-01-06,18827,716,609,2045,37856584,12690079,465949,,12224130,7681058
2023-01-07,18523,702,639,2055,37875107,12690509,466007,,12224502,7682878
2023-01-08,11612,580,608,1633,37886719,12690841,465976,,12224865,7684293
2023-01-09,5299,215,196,664,37892018,12690761,465993,,12224768,7684705
2023-01-10,12158,415,317,786,37904176,12690885,466089,,12224796,7685237
2023-01-11,15541,457,371,1094,37919717,12691033,466172,,12224861,7686067
2023-01-12,14066,444,409,973,37933783,12691180,466206,,12224974,7686783
2023-01-13,14171,422,345,1040,37947954,12691357,466281,,12225076,7687606
2023-01-14,13386,473,451,1078,37961340,12691546,466298,,12225248,7688433
2023-01-15,9046,461,507,1055,37970386,12691752,466251,,12225501,7689274
2023-01-16,3746,146,130,479,37974132,12691637,466267,,12225370,7689519
2023-01-17,8851,267,179,653,37982983,12691582,466352,,12225230,7689898
2023-01-18,10263,349,272,761,37993246,12691651,466426,,12225225,7690406
2023-01-19,10593,316,318,761,38003839,12691686,466420,,12225266,7690926
2023-01-20,9828,317,272,717,38013667,12691728,466463,,12225265,7691398
2023-01-21,11304,355,398,904,38024971,12691806,466420,,12225386,7692068
2023-01-22,7567,343,405,817,38032538,12691902,466356,,12225546,7692663
2023-01-23,3380,143,131,288,38035918,12691826,466368,,12225458,7692757
2023-01-24,8288,227,166,549,38044206,12691766,466427,,12225339,7693055
2023-01-25,10306,347,297,662,38054512,12691860,466473,,12225387,7693501
2023-01-26,6721,236,203,469,38061233,12691821,466504,,12225317,7693735
2023-01-27,6910,236,197,498,38068143,12691773,466540,,12225233,7693989
2023-01-28,9350,312,339,695,38077493,12691814,466509,,12225305,7694447
2023-01-29,5967,235,341,691,38083460,12691787,466398,,12225389,7694902
2023-01-30,1899,88,79,215,38085359,12691612,466405,,12225207,7694885
2023-01-31,5879,156,150,414,38091238,12691485,466409,,12225076,7695045
2023-02-01,7302,248,248,494,38098540,12691501,466407,,12225094,7695337
2023-02-02,6482,295,239,502,38105022,12691563,466461,,12225102,7695647
2023-02-03,6549,196,193,464,38111571,12691525,466462,,12225063,7695902
2023-02-04,6729,231,306,543,38118300,12691535,466382,,12225153,7696257
2023-02-05,4176,198,291,484,38122476,12691485,466287,,12225198,7696535
2023-02-06,1834,90,98,212,38124310,12691323,466277,,12225046,7696518
2023-02-07,4964,160,181,385,38129274,12691218,466254,,12224964,7696674
2023-02-08,5769,212,206,430,38135043,12691190,466259,,12224931,7696890
2023-02-09,6124,211,244,439,38141167,12691180,466226,,12224954,7697139
2023-02-10,5087,159,207,372,38146254,12691161,466176,,12224985,7697351
2023-02-11,6052,185,259,458,38152306,12691116,466098,,12225018,7697600
2023-02-12,4082,219,342,409,38156388,12691116,465972,,12225144,7697809
2023-02-13,1483,57,87,146,38157871,12690966,465941,,12225025,7697781
2023-02-14,3944,131,179,309,38161815,12690853,465892,,12224961,7697872
2023-02-15,4539,119,191,286,38166354,12690753,465820,,12224933,7697966
2023-02-16,4914,175,284,400,38171268,12690697,465709,,12224988,7698161
2023-02-17,4982,181,210,342,38176250,12690669,465678,,12224991,7698323
2023-02-18,5115,232,294,487,38181365,12690676,465614,,12225062,7698610
2023-02-19,3353,132,244,373,38184718,12690589,465499,,12225090,7698799
2023-02-20,1419,63,54,158,38186137,12690446,465506,,12224940,7698780
2023-02-21,912,25,14,107,38187049,12690273,465515,,12224758,7698707
2023-02-22,4134,131,212,369,38191183,12690197,465429,,12224768,7698904
2023-02-23,4282,162,231,392,38195465,12690120,465353,,12224767,7699087
2023-02-24,3033,138,229,273,38198498,12690050,465258,,12224792,7699172
2023-02-25,5024,214,540,386,38203522,12690047,464931,,12225116,7699376
2023-02-26,3472,146,681,384,38206994,12689975,464393,,12225582,7699573
2023-02-27,1074,37,57,97,38208068,12689807,464370,,12225437,7699498
2023-02-28,2729,99,163,232,38210797,12689656,464304,,12225352,7699503
2023-03-01,3849,137,427,334,38214646,12689535,464012,,12225523,7699600
2023-03-02,4588,158,494,328,38219234,12689440,463670,,12225770,7699714
2023-03-03,4367,159,357,334,38223601,12689369,463470,,12225899,7699837
2023-03-04,4966,207,623,350,38228567,12689354,463052,,12226302,7699991
2023-03-05,2535,110,449,251,38231102,12689227,462712,,12226515,7700031
2023-03-06,1156,48,37,114,38232258,12689063,462721,,12226342,7699960
2023-03-07,3219,87,172,224,38235477,12688881,462633,,12226248,7699957
2023-03-08,4314,133,412,283,38239791,12688769,462353,,12226416,7700019
2023-03-09,4614,173,453,312,38244405,12688698,462068,,12226630,7700122
2023-03-10,3941,100,139,254,38248346,12688587,462027,,12226560,7700192
2023-03-11,4064,140,171,285,38252410,12688525,461993,,12226532,7700295
2023-03-12,2883,109,234,301,38255293,12688406,461862,,12226544,7700392
2023-03-13,862,29,32,106,38256155,12688233,461857,,12226376,7700321
2023-03-14,3078,100,109,257,38259233,12688103,461848,,12226255,7700379
2023-03-15,4099,141,163,310,38263332,12688035,461826,,12226209,7700501
2023-03-16,4020,176,234,277,38267352,12687939,461764,,12226175,7700549
2023-03-17,4290,168,202,310,38271642,12687843,461726,,12226117,7700621
2023-03-18,4361,144,194,298,38276003,12687750,461676,,12226074,7700706
2023-03-19,2722,129,233,255,38278725,12687693,461572,,12226121,7700788
2023-03-20,774,31,19,74,38279499,12687497,461584,,12225913,7700665
2023-03-21,2896,70,84,200,38282395,12687343,461566,,12225777,7700671
2023-03-22,3893,130,132,248,38286288,12687241,461561,,12225680,7700712
2023-03-23,3807,118,171,225,38290095,12687131,461503,,12225628,7700738
2023-03-24,3690,102,115,237,38293785,12687019,461489,,12225530,7700791
2023-03-25,4272,107,170,251,38298057,12686906,461421,,12225485,7700851
2023-03-26,2472,112,212,202,38300529,12686818,461318,,12225500,7700878
2023-03-27,915,48,32,68,38301444,12686690,461334,,12225356,7700792
2023-03-28,3104,86,78,202,38304548,12686555,461336,,12225219,7700799
2023-03-29,4168,128,136,222,38308716,12686448,461325,,12225123,7700814
2023-03-30,3838,108,164,211,38312554,12686339,461268,,12225071,7700826
2023-03-31,3985,140,109,222,38316539,12686261,461298,,12224963,7700861
2023-04-01,4188,135,147,225,38320727,12686188,461285,,12224903,7700902
2023-04-02,2180,58,122,173,38322907,12686006,461217,,12224789,7700864
2023-04-03,781,24,12,53,38323688,12685824,461228,,12224596,7700736
2023-04-04,3417,75,73,168,38327105,12685690,461229,,12224461,7700712
2023-04-05,4364,94,108,249,38331469,12685565,461213,,12224352,7700775
2023-04-06,3697,107,108,189,38335166,12685467,461211,,12224256,7700778
2023-04-07,4597,105,115,242,38339763,12685352,461198,,12224154,7700832
2023-04-08,835,22,11,54,38340598,12685187,461205,,12223982,7700727
2023-04-09,2437,83,103,159,38343035,12685102,461183,,12223919,7700742
2023-04-10,360,9,6,20,38343395,12684927,461180,,12223747,7700611
2023-04-11,2771,34,28,121,38346166,12684729,461185,,12223544,7700522
2023-04-12,6341,104,96,187,38352507,12684643,461191,,12223452,7700546
2023-04-13,6994,105,128,207,38359501,12684539,461165,,12223374,7700566
2023-04-14,6511,89,102,205,38366012,12684429,461149,,12223280,7700597
2023-04-15,6943,107,149,229,38372955,12684337,461105,,12223232,7700654
2023-04-16,3267,85,144,165,38376222,12684217,461044,,12223173,7700639
2023-04-17,863,12,13,49,38377085,12684050,461040,,12223010,7700534
2023-04-18,4778,101,77,160,38381863,12683951,461062,,12222889,7700517
2023-04-19,6562,118,98,176,38388425,12683863,461081,,12222782,7700509
2023-04-20,6343,100,151,209,38394768,12683777,461029,,12222748,7700553
2023-04-21,5768,85,73,134,38400536,12683667,461039,,12222628,7700516
2023-04-22,6384,92,91,180,38406920,12683567,461038,,12222529,7700535
2023-04-23,3298,119,147,170,38410218,12683513,461010,,12222503,7700552
2023-04-24,954,4,12,58,38411172,12683348,461001,,12222347,7700471
2023-04-25,4804,69,70,186,38415976,12683234,461000,,12222234,7700491
2023-04-26,6564,107,93,208,38422540,12683178,461014,,12222164,7700554
2023-04-27,6873,119,152,207,38429413,12683114,460977,,12222137,7700600
2023-04-28,6610,86,86,184,38436023,12683012,460976,,12222036,7700610
2023-04-29,6524,124,108,197,38442547,12682967,460991,,12221976,7700660
2023-04-30,2637,95,127,145,38445184,12682894,460959,,12221935,7700654
2023-05-01,1029,21,17,29,38446213,12682745,460961,,12221784,7700532
2023-05-02,4322,67,55,105,38450535,12682643,460971,,12221672,7700486
2023-05-03,5595,108,107,176,38456130,12682578,460971,,12221607,7700514
2023-05-04,8081,88,85,133,38464211,12682499,460973,,12221526,7700503
2023-05-05,13033,90,98,168,38477244,12682432,460964,,12221468,7700527
2023-05-06,15630,111,96,154,38492874,12682410,460979,,12221431,7700555
2023-05-07,6058,56,96,106,38498932,12682315,460935,,12221380,7700529
2023-05-08,2165,16,4,37,38501097,12682194,460945,,12221249,7700444
2023-05-09,12543,55,49,129,38513640,12682101,460948,,12221153,7700449
2023-05-10,14733,71,78,156,38528373,12682034,460939,,12221095,7700482
2023-05-11,13302,77,71,154,38541675,12682002,460945,,12221057,7700542
2023-05-12,13471,86,79,176,38555146,12681968,460950,,12221018,7700607
2023-05-13,11435,79,75,146,38566581,12681890,460952,,12220938,7700611
2023-05-14,4182,69,95,92,38570763,12681834,460925,,12220909,7700596
2023-05-15,1053,9,6,38,38571816,12681729,460924,,12220805,7700541
2023-05-16,8935,56,47,93,38580751,12681656,460929,,12220727,7700522
2023-05-17,11095,98,83,141,38591846,12681622,460942,,12220680,7700542
2023-05-18,10812,84,68,144,38602658,12681588,460958,,12220630,7700581
2023-05-19,10377,95,96,151,38613035,12681558,460955,,12220603,7700621
2023-05-20,9306,94,87,159,38622341,12681536,460961,,12220575,7700672
2023-05-21,3072,49,86,94,38625413,12681502,460923,,12220579,7700690
2023-05-22,960,14,10,29,38626373,12681431,460927,,12220504,7700641
2023-05-23,748,7,3,16,38627121,12681355,460931,,12220424,7700583
2023-05-24,7996,58,80,103,38635117,12681313,460909,,12220404,7700593
2023-05-25,9230,73,93,160,38644347,12681313,460887,,12220426,7700687
2023-05-26,7921,72,67,119,38652268,12681312,460892,,12220420,7700742
2023-05-27,8091,105,75,124,38660359,12681346,460920,,12220426,7700803
2023-05-28,2891,57,73,98,38663250,12681355,460903,,12220452,7700858
2023-05-29,962,13,11,30,38664212,12681314,460903,,12220411,7700842
2023-05-30,5862,63,47,105,38670074,12681322,460919,,12220403,7700896
2023-05-31,8099,96,92,119,38678173,12681393,460922,,12220471,7700993
2023-06-01,7181,76,95,114,38685354,12681462,460903,,12220559,7701101
2023-06-02,6262,52,46,119,38691616,12681509,460909,,12220600,7701216
2023-06-03,5380,78,57,117,38696996,12681578,460930,,12220648,7701325
2023-06-04,2028,50,79,75,38699024,12681627,460901,,12220726,7701399
2023-06-05,592,12,6,17,38699616,12681638,460907,,12220731,7701415
2023-06-06,4389,39,36,77,38704005,12681670,460910,,12220760,7701485
2023-06-07,5650,68,64,117,38709655,12681738,460914,,12220824,7701602
2023-06-08,5313,53,67,100,38714968,12681791,460900,,12220891,7701702
