"report_date","previous_day_total_doses_administered","previous_day_at_least_one","previous_day_fully_vaccinated","previous_day_3doses","total_doses_administered","total_individuals_at_least_one","total_individuals_partially_vaccinated","total_doses_in_fully_vaccinated_individuals","total_individuals_fully_vaccinated","total_individuals_3doses"
2021-01-01,6250,6240,2,,32179,32124,32113,22,11,
2021-01-02,4612,4600,6,,36791,36672,36659,26,13,
2021-01-03,5393,5386,3,,42184,42058,42042,32,16,
2021-01-04,5995,5993,0,,48179,48050,48035,30,15,
2021-01-05,9681,9657,19,,57860,57705,57672,66,33,
2021-01-06,12792,12327,450,,70652,70028,69549,958,479,
2021-01-07,16216,15504,697,,86868,85531,84355,2352,1176,
2021-01-08,18034,17019,1002,,104902,102550,100372,4356,2178,
2021-01-09,19498,18421,1064,,124400,120970,117728,6484,3242,
2021-01-10,11366,11327,37,,135766,132288,129010,6556,3278,
2021-01-11,11710,11661,48,,147476,143949,140623,6652,3326,
2021-01-12,14466,14160,297,,161942,158101,154478,7246,3623,
2021-01-13,15432,13811,1592,,177374,171898,166685,10426,5213,
2021-01-14,19180,16730,2435,,196554,188622,180975,15294,7647,
2021-01-15,20045,17989,2037,,216599,206600,196916,19368,9684,
2021-01-16,17115,15932,1170,,233714,222516,211662,21708,10854,
2021-01-17,11253,10010,1236,,244967,232511,220423,24176,12088,
2021-01-18,6788,6708,70,,251755,239196,227041,24310,12155,
2021-01-19,11822,9714,2094,,263577,248889,234640,28498,14249,
2021-01-20,10798,7209,3572,,274375,256075,238255,35640,17820,
2021-01-21,10964,6848,4089,,285339,262907,240998,43818,21909,
2021-01-22,9033,4317,4697,,294372,267187,240583,53208,26604,
2021-01-23,7445,3030,4387,,301817,270187,239197,61980,30990,
2021-01-24,4380,1824,2536,,306197,271993,238467,67052,33526,
2021-01-25,5317,1045,4263,,311514,273006,235218,75576,37788,
2021-01-26,9375,2852,6495,,320889,275826,231544,88564,44282,
2021-01-27,9893,2861,7004,,330782,278658,227373,102570,51285,
2021-01-28,13103,5729,7332,,343885,284354,225737,117234,58617,
2021-01-29,10681,3269,7378,,354566,287592,221598,131988,65994,
2021-01-30,9180,2721,6422,,363746,290271,217858,144826,72413,
2021-01-31,3370,1560,1767,,367116,291797,217618,148358,74179,
2021-02-01,2118,481,1609,,369234,292244,216460,151568,75784,
2021-02-02,4402,1349,2995,,373636,293555,214780,157550,78775,
2021-02-03,6228,1710,4457,,379864,295224,211999,166450,83225,
2021-02-04,9071,1702,7290,,388935,296883,206374,181018,90509,
2021-02-05,8428,1456,6901,,397363,298299,200895,194808,97404,
2021-02-06,10654,1860,8735,,408017,300104,193974,212260,106130,
2021-02-07,7566,1723,5795,,415583,301788,189874,223828,111914,
2021-02-08,8214,3092,5080,,423797,304832,187851,233962,116981,
2021-02-09,14997,3852,11079,,438794,308642,180598,256088,128044,
2021-02-10,15500,4923,10518,,454294,313513,174976,277074,138537,
2021-02-11,16354,3894,12405,,470648,317355,166444,301822,150911,
2021-02-12,17646,2091,15505,,488294,319408,153011,332794,166397,
2021-02-13,16199,2437,13746,,504493,321800,141676,360248,180124,
2021-02-14,12871,914,11925,,517364,322666,130647,384038,192019,
2021-02-15,7859,483,7328,,525223,323101,123780,398642,199321,
2021-02-16,5989,1040,4899,,531212,324098,119901,408394,204197,
2021-02-17,10160,1604,8522,,541372,325658,112967,425382,212691,
2021-02-18,13862,2950,10868,,555234,328560,105031,447058,223529,
2021-02-19,18482,6210,12206,,573716,334718,99014,471408,235704,
2021-02-20,22615,11127,11436,,596331,345782,98680,494204,247102,
2021-02-21,17227,10373,6820,,613558,356095,102215,507760,253880,
2021-02-22,13574,8749,4774,,627132,364774,106170,517208,258604,
2021-02-23,17846,11112,6663,,644978,375830,110599,530462,265231,
2021-02-24,18560,13602,4877,,663538,389376,119310,540132,270066,
2021-02-25,20796,16481,4258,,684334,405791,131515,548552,274276,
2021-02-26,24875,21822,2993,,709209,427553,150321,554464,277232,
2021-02-27,27447,23573,3834,,736656,451062,170044,562036,281018,
2021-02-28,20577,19138,1405,,757233,470146,187765,564762,282381,
2021-03-01,18213,17020,1148,,775446,487105,203622,566966,283483,
2021-03-02,24666,22266,2316,,800112,509310,223557,571506,285753,
2021-03-03,30579,27951,2575,,830691,537210,248915,576590,288295,
2021-03-04,34672,32447,2142,,865363,569591,279204,580774,290387,
2021-03-05,39964,38142,1775,,905327,607685,315557,584256,292128,
2021-03-06,44128,41925,2165,,949455,649555,355303,588504,294252,
2021-03-07,32722,31548,1170,,982177,681029,385665,590728,295364,
2021-03-08,24034,22160,1861,,1006211,703121,405950,594342,297171,
2021-03-09,33272,29828,3416,,1039483,732883,432342,601082,300541,
2021-03-10,38318,34058,4215,,1077801,766867,462159,609416,304708,
2021-03-11,43961,40690,3232,,1121762,807491,499603,615776,307888,
2021-03-12,47685,45974,1688,,1169447,853401,543875,619052,309526,
2021-03-13,57885,55016,2842,,1227332,908346,596032,624628,312314,
2021-03-14,43382,42152,1214,,1270714,950415,636955,626920,313460,
2021-03-15,32798,31102,1681,,1303512,981458,666360,630196,315098,
2021-03-16,53932,51640,2276,,1357444,1033033,715702,634662,317331,
2021-03-17,61037,58506,2489,,1418481,1091473,771703,639540,319770,
2021-03-18,61515,59064,2426,,1479996,1150465,828322,644286,322143,
2021-03-19,64444,61125,3266,,1544440,1211512,886156,650712,325356,
2021-03-20,62541,59959,2551,,1606981,1271415,943556,655718,327859,
2021-03-21,43976,42460,1530,,1650957,1313810,984458,658704,329352,
2021-03-22,30989,30027,975,,1681946,1343749,1013478,660542,330271,
2021-03-23,54587,51816,2722,,1736533,1395470,1062540,665860,332930,
2021-03-24,76400,73224,3129,,1812933,1468604,1132602,672004,336002,
2021-03-25,82887,80309,2530,,1895820,1548834,1210359,676950,338475,
2021-03-26,86969,83444,3486,,1982789,1632197,1290288,683818,341909,
2021-03-27,80829,77881,2864,,2063618,1709975,1365267,689416,344708,
2021-03-28,66974,65388,1552,,2130592,1775273,1429070,692406,346203,
2021-03-29,51723,49038,2651,,2182315,1824231,1475423,697616,348808,
2021-03-30,73552,70150,3345,,2255867,1894304,1542192,704224,352112,
2021-03-31,93133,89491,3575,,2349000,1983697,1628063,711268,355634,
2021-04-01,89282,85417,3830,,2438282,2069016,1709605,718822,359411,
2021-04-02,93058,88837,4206,,2531340,2157767,1794202,727130,363565,
2021-04-03,60972,59301,1729,,2592312,2216977,1851734,730486,365243,
2021-04-04,72312,70666,1642,,2664624,2287532,1920705,733654,366827,
2021-04-05,53725,53256,469,,2718349,2340704,1973456,734496,367248,
2021-04-06,79565,77702,1882,,2797914,2418305,2049228,738154,369077,
2021-04-07,107984,104924,3052,,2905898,2523104,2151033,744142,372071,
2021-04-08,114053,110091,4020,,3019951,2633084,2257049,752070,376035,
2021-04-09,109815,105603,4288,,3129766,2738569,2358311,760516,380258,
2021-04-10,109202,105456,3842,,3238968,2843897,2459863,768068,384034,
2021-04-11,98599,95491,3253,,3337567,2939263,2552035,774456,387228,
2021-04-12,76055,74995,1153,,3413622,3014110,2625797,776626,388313,
2021-04-13,99446,96074,3394,,3513068,3110075,2718416,783318,391659,
2021-04-14,117018,113260,3648,,3630086,3223217,2827950,790534,395267,
2021-04-15,113536,109487,3892,,3743622,3332578,2933476,798204,399102,
2021-04-16,118096,113731,4190,,3861718,3446199,3042951,806496,403248,
2021-04-17,112389,107808,4442,,3974107,3553873,3146242,815262,407631,
2021-04-18,88719,86492,2095,,4062826,3640242,3230570,819344,409672,
2021-04-19,68953,67428,1446,,4131779,3707540,3296473,822134,411067,
2021-04-20,101899,98580,3116,,4233678,3805958,3391840,828236,414118,
2021-04-21,141968,137709,4027,,4375646,3943493,3525416,836154,418077,
2021-04-22,139444,135307,3900,,4515090,4078671,3656750,843842,421921,
2021-04-23,138167,131777,6149,,4653257,4210294,3782282,856024,428012,
2021-04-24,130254,126211,3874,,4783511,4336357,3904527,863660,431830,
2021-04-25,101999,98599,3173,,4885510,4434808,3999872,869872,434936,
2021-04-26,70988,69288,1553,,4956498,4503965,4067536,872858,436429,
2021-04-27,98479,95408,2882,,5054977,4599212,4159964,878496,439248,
2021-04-28,120548,115937,4422,,5175525,4714981,4271383,887196,443598,
2021-04-29,124448,119262,5041,,5299973,4834076,4385506,897140,448570,
2021-04-30,115782,110545,5003,,5415755,4944448,4490952,906992,453496,
2021-05-01,111255,107408,3634,,5527010,5051675,4594622,914106,457053,
2021-05-02,79118,76151,2855,,5606128,5127669,4667827,919684,459842,
2021-05-03,56773,55113,1592,,5662901,5182628,4721254,922748,461374,
2021-05-04,91899,88539,3278,,5754800,5270989,4806414,929150,464575,
2021-05-05,137968,133273,4611,,5892768,5404093,4934970,938246,469123,
2021-05-06,141808,136864,4807,,6034576,5540773,5066905,947736,473868,
2021-05-07,150237,145218,4822,,6184813,5685831,5207200,957262,478631,
2021-05-08,142423,137751,4424,,6327236,5823387,5340411,965952,482976,
2021-05-09,124781,121141,3475,,6452017,5944364,5457977,972774,486387,
2021-05-10,97786,95813,1874,,6549803,6039988,5551794,976388,488194,
2021-05-11,113482,108822,4482,,6663285,6148608,5656003,985210,492605,
2021-05-12,144999,137989,6865,,6808284,6286418,5787014,998808,499404,
2021-05-13,142628,135288,7197,,6950912,6421531,5915004,1013054,506527,
2021-05-14,148858,138752,9940,,7099770,6560095,6043693,1032804,516402,
2021-05-15,159693,149666,9852,,7259463,6709574,6183395,1052358,526179,
2021-05-16,144339,136071,8064,,7403802,6845477,6311314,1068326,534163,
2021-05-17,114951,110859,3940,,7518753,6956147,6418120,1076054,538027,
2021-05-18,111280,100425,10654,,7630033,7056376,6507757,1097238,548619,
2021-05-19,149835,133443,16218,,7779868,7189667,6624904,1129526,564763,
2021-05-20,151507,131536,19760,,7931375,7321014,6736560,1168908,584454,
2021-05-21,165325,140837,24233,,8096700,7461670,6853060,1217220,608610,
2021-05-22,199372,172197,26952,,8296072,7633670,6998189,1270962,635481,
2021-05-23,139794,127429,12222,,8435866,7760921,7113280,1295282,647641,
2021-05-24,100264,93298,6823,,8536130,7854046,7199652,1308788,654394,
2021-05-25,90407,82937,7263,,8626537,7936820,7275230,1323180,661590,
2021-05-26,139729,112972,26494,,8766266,8049605,7361591,1376028,688014,
2021-05-27,152023,123009,28762,,8918289,8172457,7455750,1433414,716707,
2021-05-28,163812,132271,31240,,9082101,8304555,7556667,1495776,747888,
2021-05-29,153341,117090,36020,,9235442,8421496,7637644,1567704,783852,
2021-05-30,149688,118989,30475,,9385130,8540315,7726050,1628530,814265,
2021-05-31,99180,79788,19202,,9484310,8619933,7786530,1666806,833403,
2021-06-01,124130,90563,33236,,9608440,8710301,7843737,1733128,866564,
2021-06-02,145257,102109,42902,,9753697,8812229,7902832,1818794,909397,
2021-06-03,155315,99875,55164,,9909012,8911920,7947430,1928980,964490,
2021-06-04,181663,115503,65893,,10090675,9027224,7996929,2060590,1030295,
2021-06-05,171963,103392,68296,,10262638,9130418,8031912,2197012,1098506,
2021-06-06,163346,91829,71239,,10425984,9222069,8052394,2339350,1169675,
2021-06-07,119539,63033,56289,,10545523,9284905,8059016,2451778,1225889,
2021-06-08,161852,72418,88999,,10707375,9357134,8042326,2629616,1314808,
2021-06-09,181413,70775,110177,,10888788,9427732,8002828,2849808,1424904,
2021-06-10,185534,66394,118655,,11074322,9493923,7950455,3086936,1543468,
2021-06-11,204738,67486,136499,,11279060,9561223,7881338,3359770,1679885,
2021-06-12,199670,62640,136433,,11478730,9623681,7807455,3632452,1816226,
2021-06-13,190287,58852,130910,,11669017,9682358,7735302,3894112,1947056,
2021-06-14,137656,38670,98591,,11806673,9720832,7675290,4091084,2045542,
2021-06-15,189170,42574,146245,,11995843,9763188,7571498,4383380,2191690,
2021-06-16,206085,42408,163038,,12201928,9805400,7450775,4709250,2354625,
2021-06-17,210359,37913,171875,,12412287,9843098,7316690,5052816,2526408,
2021-06-18,217104,35336,181169,,12629391,9878244,7170759,5414970,2707485,
2021-06-19,215820,35469,179685,,12845211,9913507,7026449,5774116,2887058,
2021-06-20,186218,35535,150110,,13031429,9948844,6911784,6074120,3037060,
2021-06-21,120406,20815,99096,,13151835,9969464,6833400,6272128,3136064,
2021-06-22,204885,27486,176652,,13356720,9996756,6684149,6625214,3312607,
2021-06-23,230467,28599,201137,,13587187,10025155,6511519,7027272,3513636,
2021-06-24,227641,26657,200240,,13814828,10051616,6337850,7427532,3713766,
2021-06-25,251056,27954,222363,,14065884,10079369,6143358,7872022,3936011,
2021-06-26,261235,29975,230560,,14327119,10109119,5942688,8332862,4166431,
2021-06-27,204955,27766,176591,,14532074,10136703,5793791,8685824,4342912,
2021-06-28,199220,20944,177719,,14731294,10157449,5636943,9041012,4520506,
2021-06-29,250065,24470,224875,,14981359,10181678,5436451,9490454,4745227,
2021-06-30,275487,24159,250765,,15256846,10205634,5209771,9991726,4995863,
2021-07-01,271935,25292,246094,,15528781,10230708,4988890,10483636,5241818,
2021-07-02,144688,11572,132893,,15673469,10242106,4867497,10749218,5374609,
2021-07-03,216854,19907,196719,,15890323,10261791,4690612,11142358,5571179,
2021-07-04,196121,19382,176518,,16086444,10280987,4533409,11495156,5747578,
2021-07-05,148695,12432,136122,,16235139,10293230,4409657,11767146,5883573,
2021-07-06,219989,19974,199802,,16455128,10312988,4229759,12166458,6083229,
2021-07-07,246578,22955,223386,,16701706,10335717,4029250,12612934,6306467,
2021-07-08,231159,21334,209617,,16932865,10356845,3840896,13031898,6515949,
2021-07-09,226948,21488,205294,,17159813,10378131,3657020,13442222,6721111,
2021-07-10,209022,20523,188345,,17368835,10398450,3489131,13818638,6909319,
2021-07-11,171638,17562,153952,,17540473,10415811,3352687,14126248,7063124,
2021-07-12,123114,11440,111578,,17663587,10427062,3252497,14349130,7174565,
2021-07-13,178437,18999,159296,,17842024,10445839,3112133,14667412,7333706,
2021-07-14,179997,19284,160557,,18022021,10464909,2970809,14988200,7494100,
2021-07-15,167159,19571,147417,,18189180,10484269,2842916,15282706,7641353,
2021-07-16,169302,19874,149277,,18358482,10503941,2713464,15580954,7790477,
2021-07-17,172944,20240,152581,,18531426,10523932,2581066,15885732,7942866,
2021-07-18,133589,15911,117540,,18665015,10539659,2479401,16120516,8060258,
2021-07-19,91950,10406,81438,,18756965,10549852,2408331,16283042,8141521,
2021-07-20,133500,16929,116511,,18890465,10566541,2308685,16515712,8257856,
2021-07-21,140049,16969,123009,,19030514,10583295,2202592,16761406,8380703,
2021-07-22,125558,17617,107806,,19156072,10600688,2112356,16976664,8488332,
2021-07-23,120210,16967,103036,,19276282,10617414,2026245,17182338,8591169,
2021-07-24,126648,18314,108099,,19402930,10635525,1936420,17398210,8699105,
2021-07-25,103597,14837,88633,,19506527,10650138,1862581,17575114,8787557,
2021-07-26,66663,9877,56695,,19573190,10659797,1815726,17688142,8844071,
2021-07-27,92347,15304,76880,,19665537,10674840,1754106,17841468,8920734,
2021-07-28,93896,16438,77382,,19759433,10691043,1693118,17995850,8997925,
2021-07-29,89348,16683,72506,,19848781,10707494,1637251,18140486,9070243,
2021-07-30,84008,16078,67820,,19932789,10723344,1585469,18275750,9137875,
2021-07-31,83785,15672,67958,,20016574,10738798,1533155,18411286,9205643,
2021-08-01,61841,11304,50356,,20078415,10749876,1494068,18511616,9255808,
2021-08-02,42454,7397,34940,,20120869,10757075,1466493,18581164,9290582,
2021-08-03,33245,5936,27142,,20154114,10762778,1445264,18635028,9317514,
2021-08-04,61275,12355,48730,,20215389,10774898,1408852,18732092,9366046,
2021-08-05,59418,12522,46742,,20274807,10787212,1374588,18825248,9412624,
2021-08-06,55970,11836,43920,,20330777,10798788,1342473,18912630,9456315,
2021-08-07,62329,12115,50018,,20393106,10810642,1304527,19012230,9506115,
2021-08-08,48622,9235,39202,,20441728,10819649,1274537,19090224,9545112,
2021-08-09,30835,5928,24733,,20472563,10825363,1255705,19139316,9569658,
2021-08-10,49204,10487,38421,,20521767,10835570,1227737,19215666,9607833,
2021-08-11,48678,10750,37689,,20570445,10846073,1200767,19290612,9645306,
2021-08-12,49198,11177,37799,,20619643,10857000,1174103,19365794,9682897,
2021-08-13,49572,11709,37596,,20669215,10868468,1148186,19440564,9720282,
2021-08-14,51172,12119,38848,,20720387,10880337,1121431,19517812,9758906,
2021-08-15,41715,9825,31670,,20762102,10889960,1099556,19580808,9790404,
2021-08-16,26704,6164,20387,,20788806,10895901,1085307,19621188,9810594,
2021-08-17,40453,11032,29162,,20829259,10906683,1067153,19679060,9839530,
2021-08-18,41858,11948,29668,,20871117,10918389,1049401,19737976,9868988,
2021-08-19,45842,16504,29078,,20916959,10934642,1036799,19795686,9897843,
2021-08-20,46391,16265,29714,,20963350,10950651,1023323,19854656,9927328,
2021-08-21,47908,15129,32413,,21011258,10965520,1006006,19919028,9959514,
2021-08-22,34354,10793,23296,,21045612,10976067,993479,19965176,9982588,
2021-08-23,23201,6994,15989,,21068813,10982826,984463,19996726,9998363,
2021-08-24,37611,13356,23806,,21106424,10995928,973990,20043876,10021938,
2021-08-25,41284,14392,26292,,21147708,11010064,962071,20095986,10047993,
2021-08-26,39229,13543,24943,,21186937,11023331,950636,20145390,10072695,
2021-08-27,37618,12903,23674,,21224555,11035993,939838,20192310,10096155,
2021-08-28,40059,13402,25486,,21264614,11049117,927730,20242774,10121387,
2021-08-29,30517,10234,19930,,21295131,11059119,918015,20282208,10141104,
2021-08-30,18217,6131,11837,,21313348,11065002,912280,20305444,10152722,
2021-08-31,32670,11923,19600,,21346018,11076657,904575,20344164,10172082,
2021-09-01,36188,12920,21926,,21382206,11089344,895553,20387582,10193791,
2021-09-02,37716,15618,19640,,21419922,11104710,891506,20426408,10213204,
2021-09-03,46821,21060,22414,,21466743,11125522,890133,20470778,10235389,
2021-09-04,46840,20578,24748,,21513583,11145854,885940,20519828,10259914,
2021-09-05,33033,14195,18554,,21546616,11159805,881561,20556488,10278244,
2021-09-06,21676,9475,12019,,21568292,11169031,879000,20580062,10290031,
2021-09-07,14961,6709,8071,,21583253,11175483,877621,20595724,10297862,
2021-09-08,41104,17093,20920,,21624357,11192312,873776,20637072,10318536,
2021-09-09,41404,16953,19655,,21665761,11208988,871049,20675878,10337939,
2021-09-10,39595,15489,18975,,21705356,11224215,867545,20713340,10356670,
2021-09-11,42337,15919,23319,,21747693,11239855,860124,20759462,10379731,
2021-09-12,29935,11523,17853,,21777628,11251084,853764,20794640,10397320,
2021-09-13,16058,6393,9169,,21793686,11257243,850973,20812540,10406270,
2021-09-14,29867,11546,15271,,21823553,11268488,847221,20842534,10421267,
2021-09-15,39248,14010,19408,,21862801,11282239,841808,20880862,10440431,
2021-09-16,39310,13969,19230,,21902111,11295973,836524,20918898,10459449,
2021-09-17,38880,13592,19312,,21940991,11309322,830792,20957060,10478530,
2021-09-18,41182,14072,23490,,21982173,11323121,821353,21003536,10501768,
2021-09-19,30616,10820,18957,,22012789,11333682,813203,21040958,10520479,
2021-09-20,16721,6100,10170,,22029510,11339528,809110,21060836,10530418,
2021-09-21,31323,11201,16970,,22060833,11350464,803325,21094278,10547139,
2021-09-22,41778,14807,22907,,22102611,11364975,795204,21139542,10569771,
2021-09-23,47192,16126,26010,,22149803,11380838,785301,21191074,10595537,
2021-09-24,46257,15621,26618,,22196060,11396198,774285,21243826,10621913,
2021-09-25,48160,15245,29924,,22244220,11411190,759587,21303206,10651603,
2021-09-26,37455,12409,24457,,22281675,11423324,747518,21351612,10675806,
2021-09-27,19142,6527,12310,,22300817,11429597,741719,21375756,10687878,
2021-09-28,30917,11282,17854,,22331734,11440620,735135,21410970,10705485,
2021-09-29,37851,12466,21704,,22369585,11452815,725877,21453876,10726938,
2021-09-30,37296,11638,21348,,22406881,11464194,716148,21496092,10748046,
2021-10-01,30839,9800,18388,,22437720,11473768,707547,21532442,10766221,
2021-10-02,37101,11150,23563,,22474821,11484648,695116,21579064,10789532,
2021-10-03,27193,8159,18318,,22502014,11492566,684944,21615244,10807622,
2021-10-04,14862,4744,9799,,22516876,11497064,679871,21634386,10817193,
2021-10-05,26781,8582,15844,,22543657,11505385,672594,21665582,10832791,
2021-10-06,31632,9631,18487,,22575289,11514757,663730,21702054,10851027,
2021-10-07,30318,9386,17102,,22605607,11523892,656001,21735782,10867891,
2021-10-08,32799,10731,18832,,22638406,11534353,647887,21772932,10886466,
2021-10-09,34101,10649,20990,,22672507,11544739,637532,21814414,10907207,
2021-10-10,23384,7654,15066,,22695891,11552143,630108,21844070,10922035,
2021-10-11,11990,3837,7859,,22707881,11555730,626070,21859320,10929660,
2021-10-12,5087,1620,3254,,22712968,11557072,624421,21865302,10932651,
2021-10-13,29078,9184,18066,,22742046,11565966,615523,21900886,10950443,
2021-10-14,28986,8900,17731,,22771032,11574591,606682,21935818,10967909,
2021-10-15,29056,8816,18147,,22800088,11583144,597338,21971612,10985806,
2021-10-16,31121,8980,19860,,22831209,11591833,586446,22010774,11005387,
2021-10-17,23675,7249,15357,,22854884,11598828,578325,22041006,11020503,
2021-10-18,12297,3747,8141,,22867181,11602294,573919,22056750,11028375,
2021-10-19,21241,6618,12613,,22888422,11608630,567911,22081438,11040719,
2021-10-20,25622,7534,14892,,22914044,11615917,560540,22110754,11055377,
2021-10-21,23149,6673,13018,,22937193,11622321,554184,22136274,11068137,
2021-10-22,26080,7300,15090,,22963273,11629299,546378,22165842,11082921,
2021-10-23,28148,7598,17139,,22991421,11636635,536830,22199610,11099805,
2021-10-24,19327,5730,12578,,23010748,11642109,529970,22224278,11112139,
2021-10-25,9918,2710,6470,,23020666,11644550,526202,22236696,11118348,
2021-10-26,18867,5381,11075,,23039533,11649653,520499,22258308,11129154,
2021-10-27,22813,6067,13187,,23062346,11655465,513365,22284200,11142100,
2021-10-28,22275,5790,12625,,23084621,11660967,506519,22308896,11154448,
2021-10-29,22782,5726,13030,,23107403,11666392,499201,22334382,11167191,
2021-10-30,24078,6031,14596,,23131481,11672151,490624,22363054,11181527,
2021-10-31,16453,4587,10584,,23147934,11676444,484622,22383644,11191822,
2021-11-01,7858,2076,5051,,23155792,11678240,481634,22393212,11196606,
2021-11-02,15604,4362,7731,,23171396,11682311,478254,22408114,11204057,
2021-11-03,18598,5065,9591,,23189994,11687073,473718,22426710,11213355,
2021-11-04,19474,4864,10013,,23209468,11691661,468554,22446214,11223107,
2021-11-05,21435,4394,9509,,23230903,11695766,463425,22464682,11232341,
2021-11-06,25309,5199,12145,,23256212,11700696,456462,22488468,11244234,
2021-11-07,21426,4020,8905,,23277638,11704436,451565,22505742,11252871,
2021-11-08,11984,2108,4728,,23289622,11706249,448929,22514640,11257320,
2021-11-09,24089,3844,7623,,23313711,11709772,445140,22529264,11264632,
2021-11-10,28443,4503,8974,,23342154,11713997,440655,22546684,11273342,
2021-11-11,28731,4297,9081,,23370885,11717998,435862,22564272,11282136,
2021-11-12,26711,4156,8216,,23397596,11721863,431788,22580150,11290075,
2021-11-13,34272,5070,11391,,23431868,11726627,425458,22602338,11301169,
2021-11-14,23194,3896,8591,,23455062,11730260,420756,22619008,11309504,
2021-11-15,12689,2186,4486,,23467751,11732186,418448,22627476,11313738,
2021-11-16,26146,3921,7465,,23493897,11735850,414900,22641900,11320950,
2021-11-17,31131,4046,7787,,23525028,11739614,411149,22656930,11328465,
2021-11-18,32462,3849,7506,,23557490,11743158,407478,22671360,11335680,
2021-11-19,35434,3853,7736,,23592924,11746711,403583,22686256,11343128,
2021-11-20,40093,4379,8806,,23633017,11750811,399147,22703328,11351664,
2021-11-21,28090,3431,6935,,23661107,11753980,395629,22716702,11358351,
2021-11-22,14884,1949,3887,,23675991,11755653,393685,22723936,11361968,
2021-11-23,33029,3269,5995,,23709020,11758642,390951,22735382,11367691,
2021-11-24,42613,3748,6783,,23751633,11762086,387905,22748362,11374181,
2021-11-25,46003,3929,6545,,23797636,11765741,385286,22760910,11380455,
2021-11-26,52805,11341,6598,,23850441,11776812,390022,22773580,11386790,
2021-11-27,63479,22345,7016,,23913920,11798876,405341,22787070,11393535,
2021-11-28,51433,27732,5304,,23965353,11826316,427757,22797118,11398559,
2021-11-29,33509,18931,2871,,23998862,11844986,443806,22802360,11401180,
2021-11-30,55979,20666,5112,,24054841,11865371,459350,22812042,11406021,
2021-12-01,69504,26235,5615,,24124345,11891300,479956,22822688,11411344,
2021-12-02,71591,26480,5018,,24195936,11917483,501405,22832156,11416078,
2021-12-03,73377,25094,5146,,24269313,11942281,521347,22841868,11420934,
2021-12-04,81117,27781,6051,47264,24350430,11969769,543068,,11426701,807277
2021-12-05,62607,31926,4397,26265,24413037,12001400,570589,,11430811,833438
2021-12-06,38614,19139,2708,16752,24451651,12020250,587013,,11433237,850112
2021-12-07,60248,14846,4450,40940,24511899,12034825,597399,,11437426,890978
2021-12-08,73414,19052,4667,49693,24585313,12053600,611774,,11441826,940593
2021-12-09,74464,18270,4329,51846,24659777,12071561,625707,,11445854,992354
2021-12-10,77438,17586,4631,55213,24737215,12088866,638657,,11450209,1047486
2021-12-11,83146,20403,5812,56920,24820361,12108980,653234,,11455746,1104320
2021-12-12,60727,22693,4145,33848,24881088,12131393,671776,,11459617,1138079
2021-12-13,34910,11594,2401,20893,24915998,12142690,680959,,11461731,1158877
2021-12-14,101929,8996,3846,89045,25017927,12151377,686095,,11465282,1247802
2021-12-15,127655,12424,4495,110700,25145582,12163497,694014,,11469483,1358402
2021-12-16,139297,12446,4229,122611,25284879,12175657,702221,,11473436,1480914
2021-12-17,159127,12394,4502,142208,25444006,12187776,710104,,11477672,1623025
2021-12-18,175546,13520,4913,157071,25619552,12201002,718699,,11482303,1780001
2021-12-19,140398,18155,3922,118288,25759950,12218856,732924,,11485932,1898178
2021-12-20,106801,10305,2741,93710,25866751,12228893,740478,,11488415,1991790
2021-12-21,215190,12962,4303,197904,26081941,12241539,749130,,11492409,2189573
2021-12-22,237167,14418,5184,217682,26319108,12255659,758350,,11497309,2407138
2021-12-23,257378,11706,5073,240504,26576486,12267062,764977,,11502085,2647536
2021-12-24,223354,9442,4546,209305,26799840,12276207,769869,,11506338,2856725
2021-12-25,89685,3884,2499,83314,26889525,12279816,771249,,11508567,2939932
2021-12-26,11891,387,354,11140,26901416,12279911,771274,,11508637,2950942
2021-12-27,46919,1494,1110,44287,26948335,12281160,771651,,11509509,2995109
2021-12-28,144731,6096,3991,134583,27093066,12286962,773745,,11513217,3129561
2021-12-29,175435,9375,4566,161424,27268501,12296042,778550,,11517492,3290858
2021-12-30,200007,10126,5336,184504,27468508,12305865,783325,,11522540,3475228
2021-12-31,195170,10006,5791,179122,27663678,12315582,787531,,11528051,3654224
2022-01-01,96919,5376,3871,87347,27760597,12320650,789028,,11531622,3741423
2022-01-02,19431,937,923,17442,27780028,12321296,789033,,11532263,3758719
2022-01-03,88238,4772,4589,78795,27868266,12325758,789208,,11536550,3837361
2022-01-04,146323,5995,5305,134983,28014589,12331425,789885,,11541540,3972188
2022-01-05,177433,7613,7285,162363,28192022,12338684,790202,,11548482,4134391
2022-01-06,191475,7195,6778,176979,28383497,12345560,790608,,11554952,4311215
2022-01-07,191188,7948,6978,175452,28574685,12353164,791566,,11561598,4486494
2022-01-08,181605,8612,6626,165181,28756290,12361444,793539,,11567905,4651519
2022-01-09,131070,9860,7173,113947,28887360,12370983,796221,,11574762,4765306
2022-01-10,90544,5105,4487,80825,28977904,12375766,796829,,11578937,4845978
2022-01-11,138831,6149,6558,125418,29116735,12381569,796407,,11585162,4971207
2022-01-12,156973,8154,8039,138661,29273708,12389394,796517,,11592877,5109700
2022-01-13,162623,9206,9202,141507,29436331,12398238,796507,,11601731,5251024
2022-01-14,159807,10742,10366,136010,29596138,12408620,796878,,11611742,5386837
2022-01-15,161162,11005,11665,135858,29757300,12419255,796207,,11623048,5522502
2022-01-16,109749,9283,9670,89441,29867049,12428177,795813,,11632364,5611726
2022-01-17,65755,5933,6555,52626,29932804,12433776,795181,,11638595,5664168
2022-01-18,36076,2001,2117,31137,29968880,12435423,795055,,11640368,5695109
2022-01-19,101275,5574,6709,85933,30070155,12440597,793902,,11646695,5780815
2022-01-20,103563,6325,6996,85709,30173718,12446539,793223,,11653316,5866302
2022-01-21,102067,6227,8048,82478,30275785,12452363,791388,,11660975,5948553
2022-01-22,102544,8707,12064,78096,30378329,12460681,788024,,11672657,6026421
2022-01-23,76665,7305,13980,54781,30454994,12467643,781342,,11686301,6080980
2022-01-24,42241,3190,7928,30735,30497235,12470469,776586,,11693883,6111508
2022-01-25,62541,3755,8362,48106,30559776,12473845,771964,,11701881,6159396
2022-01-26,77858,4911,13163,55677,30637634,12478380,763707,,11714673,6214831
2022-01-27,78042,4893,13237,56027,30715676,12482901,755353,,11727548,6270621
2022-01-28,77252,4668,13668,53875,30792928,12487211,746340,,11740871,6324277
2022-01-29,84790,5528,17701,58098,30877718,12492377,734160,,11758217,6382131
2022-01-30,66479,5024,20620,40141,30944197,12497059,718550,,11778509,6422047
2022-01-31,34730,2174,9875,22341,30978927,12498914,710840,,11788074,6444199
2022-02-01,51330,3267,9651,36517,31030257,12501828,704446,,11797382,6480491
2022-02-02,57686,3844,12388,38668,31087943,12505342,695887,,11809455,6518960
2022-02-03,52569,3610,11506,34295,31140512,12508576,687979,,11820597,6553004
2022-02-04,43064,2943,10554,27271,31183576,12511210,680358,,11830852,6580082
2022-02-05,58695,3737,14463,37556,31242271,12514617,669620,,11844997,6617426
2022-02-06,49844,3637,16111,29567,31292115,12517932,657141,,11860791,6646769
2022-02-07,23219,1687,7805,13434,31315334,12519293,651010,,11868283,6659979
2022-02-08,33361,2350,7236,21959,31348695,12521313,646117,,11875196,6681705
2022-02-09,38861,2781,8909,24404,31387556,12523736,639983,,11883753,6705857
2022-02-10,37518,2763,8826,22546,31425074,12526164,633916,,11892248,6728174
2022-02-11,39420,2718,10284,22993,31464494,12528536,626341,,11902195,6750929
2022-02-12,42023,2953,11449,25304,31506517,12531156,617834,,11913322,6776009
2022-02-13,36297,2799,13137,19935,31542814,12533669,607493,,11926176,6795746
2022-02-14,16960,1173,6114,9465,31559774,12534567,602544,,11932023,6805011
2022-02-15,19329,1382,4739,11869,31579103,12535626,599177,,11936449,6816653
2022-02-16,26005,1764,7723,14943,31605108,12537094,593214,,11943880,6831396
2022-02-17,26743,1680,7517,14978,31631851,12538419,587368,,11951051,6846119
2022-02-18,23918,1352,6598,13668,31655769,12539454,582110,,11957344,6859578
2022-02-19,37820,1902,8331,26044,31693589,12541025,575676,,11965349,6885381
2022-02-20,32557,1491,7957,22801,31726146,12542217,569202,,11973015,6907979
2022-02-21,17494,912,3675,12755,31743640,12542834,566430,,11976404,6920523
2022-02-22,9089,428,1545,6947,31752729,12542973,565308,,11977665,6927260
2022-02-23,25317,1326,4785,17289,31778046,12543991,561842,,11982149,6944315
2022-02-24,24551,1395,5232,15471,31802597,12545066,558001,,11987065,6959544
2022-02-25,23085,1385,5131,14503,31825682,12546156,554248,,11991908,6973820
2022-02-26,25212,1383,5904,16547,31850894,12547229,549720,,11997509,6990141
2022-02-27,26937,1366,7359,17698,31877831,12548326,543716,,12004610,7007644
2022-02-28,10122,593,2525,6744,31887953,12548666,541776,,12006890,7014205
2022-03-01,13175,942,3142,8158,31901128,12549303,539566,,12009737,7022146
2022-03-02,15403,1162,3574,9612,31916531,12550204,537147,,12013057,7031581
2022-03-03,14287,1076,3222,8684,31930818,12550969,534994,,12015975,7040034
2022-03-04,14455,989,3440,8307,31945273,12551637,532539,,12019098,7048088
2022-03-05,18520,1277,4991,11179,31963793,12552606,528814,,12023792,7059044
2022-03-06,16503,1087,5521,9599,31980296,12553414,524374,,12029040,7068436
2022-03-07,5937,462,1854,3508,31986233,12553591,522975,,12030616,7071727
2022-03-08,7350,698,1934,4156,31993583,12554011,521732,,12032279,7075684
2022-03-09,11150,906,2735,6402,32004733,12554641,519897,,12034744,7081884
2022-03-10,12744,1040,3246,6832,32017477,12555404,517684,,12037720,7088503
2022-03-11,12875,902,3402,6860,32030352,12556017,515176,,12040841,7095147
2022-03-12,14670,1045,4174,8307,32045022,12556791,512044,,12044747,7103251
2022-03-13,14739,1089,4996,8329,32059761,12557591,508133,,12049458,7111345
2022-03-14,6325,448,2224,3497,32066086,12557769,506354,,12051415,7114628
2022-03-15,10191,789,2622,5972,32076277,12558268,504509,,12053759,7120386
2022-03-16,13047,931,3660,6950,32089324,12558911,501777,,12057134,7127106
2022-03-17,13170,1044,3954,6752,32102494,12559668,498860,,12060808,7133639
2022-03-18,11897,911,3143,6429,32114391,12560277,496618,,12063659,7139845
2022-03-19,14427,1002,4158,7895,32128818,12561000,493460,,12067540,7147522
2022-03-20,11729,990,3949,6364,32140547,12561720,490496,,12071224,7153678
2022-03-21,5054,414,1589,2812,32145601,12561876,489317,,12072559,7156288
2022-03-22,6696,550,1554,3886,32152297,12562140,488308,,12073832,7159959
2022-03-23,9961,783,2296,5191,32162258,12562608,486792,,12075816,7164909
2022-03-24,9282,723,2374,4605,32171540,12563067,485132,,12077935,7169310
2022-03-25,9209,780,2149,4743,32180749,12563584,483755,,12079829,7173841
2022-03-26,10916,932,2830,5502,32191665,12564241,481855,,12082386,7179126
2022-03-27,10219,908,3536,5298,32201884,12564890,479223,,12085667,7184213
2022-03-28,3577,319,1107,1986,32205461,12564970,478432,,12086538,7186006
2022-03-29,5333,498,1208,2686,32210794,12565185,477716,,12087469,7188471
2022-03-30,7844,747,1832,4119,32218638,12565654,476626,,12089028,7192366
2022-03-31,8642,689,1923,4410,32227280,12566055,475386,,12090669,7196555
2022-04-01,9296,801,1910,4884,32236576,12566564,474268,,12092296,7201200
2022-04-02,10424,888,2207,5562,32247000,12567165,472937,,12094228,7206545
2022-04-03,9191,877,2565,5062,32256191,12567789,471243,,12096546,7211409
2022-04-04,4194,387,1004,2405,32260385,12567915,470623,,12097292,7213611
2022-04-05,6058,597,1033,3048,32266443,12568173,470181,,12097992,7216385
2022-04-06,8364,715,1478,4371,32274807,12568598,469413,,12099185,7220530
2022-04-07,10326,732,1681,4834,32285133,12569031,468459,,12100572,7225122
2022-04-08,23980,811,1576,4834,32309113,12569564,467688,,12101876,7229740
2022-04-09,30470,968,1971,5893,32339583,12570235,466676,,12103559,7235411
2022-04-10,24844,978,2383,5330,32364427,12570956,465265,,12105691,7240541
2022-04-11,12568,385,874,2432,32376995,12571092,464772,,12106320,7242772
2022-04-12,28101,691,1013,3532,32405096,12571481,464443,,12107038,7246072
2022-04-13,37765,851,1553,4925,32442861,12572033,463737,,12108296,7250767
2022-04-14,37877,762,1608,4906,32480738,12572484,462888,,12109596,7255421
2022-04-15,43389,1230,2101,6725,32524127,12573416,462013,,12111403,7261909
2022-04-16,8086,358,649,1736,32532213,12573514,461720,,12111794,7263429
2022-04-17,21002,869,1923,4313,32553215,12574099,460659,,12113440,7267519
2022-04-18,5453,305,460,1287,32558668,12574120,460499,,12113621,7268568
2022-04-19,22644,615,770,3101,32581312,12574454,460335,,12114119,7271450
2022-04-20,40318,1063,1393,4614,32621630,12575191,460002,,12115189,7275800
2022-04-21,38739,940,1597,4677,32660369,12575836,459337,,12116499,7280243
2022-04-22,35605,1010,1426,4263,32695974,12576574,458914,,12117660,7284288
2022-04-23,34636,1004,1732,4711,32730610,12577297,458183,,12119114,7288762
2022-04-24,20801,1020,1880,3777,32751411,12578067,457320,,12120747,7292345
2022-04-25,8297,451,692,1707,32759708,12578250,457078,,12121172,7293837
2022-04-26,24597,732,939,3136,32784305,12578691,456865,,12121826,7296737
2022-04-27,33588,955,1366,3932,32817893,12579371,456446,,12122925,7300453
2022-04-28,32826,927,1411,3927,32850719,12580026,455954,,12124072,7304157
2022-04-29,32042,1095,1374,3908,32882761,12580825,455668,,12125157,7307837
2022-04-30,30267,921,1532,4020,32913028,12581451,455051,,12126400,7311622
2022-05-01,16744,767,1576,2969,32929772,12581922,454237,,12127685,7314349
2022-05-02,5931,307,524,1097,32935703,12581934,454016,,12127918,7315219
2022-05-03,20918,588,828,2344,32956621,12582217,453770,,12128447,7317324
2022-05-04,29404,799,1091,3290,32986025,12582707,453473,,12129234,7320365
2022-05-05,29086,871,1160,3121,33015111,12583267,453174,,12130093,7323243
2022-05-06,29079,1146,1279,2983,33044190,12584127,453036,,12131091,7326001
2022-05-07,28480,869,1260,3110,33072670,12584708,452640,,12132068,7328888
2022-05-08,15995,896,1309,2321,33088665,12585347,452225,,12133122,7331008
2022-05-09,5896,292,474,943,33094561,12585374,452037,,12133337,7331742
2022-05-10,21218,695,717,2118,33115779,12585752,452008,,12133744,7333601
2022-05-11,28936,835,1079,2652,33144715,12586258,451760,,12134498,7335983
2022-05-12,28229,800,1081,2510,33172944,12586762,451475,,12135287,7338252
2022-05-13,27587,879,1115,2467,33200531,12587334,451235,,12136099,7340465
2022-05-14,25681,808,1096,2607,33226212,12587827,450940,,12136887,7342818
2022-05-15,14842,751,1272,2054,33241054,12588308,450412,,12137896,7344655
2022-05-16,6379,325,532,1047,33247433,12588396,450201,,12138195,7345516
2022-05-17,19591,584,775,1740,33267024,12588668,450003,,12138665,7347009
2022-05-18,26537,877,1097,2271,33293561,12589282,449778,,12139504,7349065
2022-05-19,24427,681,1155,2157,33317988,12589696,449297,,12140399,7351005
2022-05-20,24257,799,1134,2215,33342245,12590229,448958,,12141271,7353004
2022-05-21,22392,692,1164,2344,33364637,12590615,448477,,12142138,7355109
2022-05-22,10552,551,887,1484,33375189,12590906,448136,,12142770,7356377
2022-05-23,4558,241,460,784,33379747,12590889,447915,,12142974,7356953
2022-05-24,2605,118,176,429,33382352,12590754,447855,,12142899,7357173
2022-05-25,19349,656,943,1950,33401701,12591146,447558,,12143588,7358915
2022-05-26,20632,662,948,1908,33422333,12591537,447266,,12144271,7360603
2022-05-27,21745,815,1055,2071,33444078,12592070,447023,,12145047,7362447
2022-05-28,19394,723,1162,2143,33463472,12592526,446581,,12145945,7364379
2022-05-29,12102,759,1279,1725,33475574,12593051,446054,,12146997,7365912
2022-05-30,4575,311,548,751,33480149,12593116,445814,,12147302,7366465
2022-05-31,13542,572,748,1663,33493691,12593387,445632,,12147755,7367889
2022-06-01,16604,702,970,1876,33510295,12593786,445363,,12148423,7369511
2022-06-02,14592,556,864,1670,33524887,12594031,445048,,12148983,7370941
2022-06-03,16091,697,1092,1810,33540978,12594452,444647,,12149805,7372534
2022-06-04,13309,648,1161,1840,33554287,12594844,444130,,12150714,7374173
2022-06-05,7864,587,1109,1430,33562151,12595183,443604,,12151579,7375412
2022-06-06,3293,206,444,641,33565444,12595144,443363,,12151781,7375855
2022-06-07,11205,475,725,1363,33576649,12595321,443108,,12152213,7376974
2022-06-08,14052,667,1012,1605,33590701,12595733,442758,,12152975,7378363
2022-06-09,13364,663,921,1671,33604065,12596109,442495,,12153614,7379803
2022-06-10,13840,683,1064,1693,33617905,12596509,442106,,12154403,7381269
2022-06-11,12972,613,1030,1863,33630877,12596841,441687,,12155154,7382914
2022-06-12,8091,643,1236,1498,33638968,12597229,441090,,12156139,7384208
2022-06-13,3186,284,422,709,33642154,12597250,440947,,12156303,7384711
2022-06-14,10121,510,666,1262,33652275,12597472,440785,,12156687,7385736
2022-06-15,13496,470,828,1620,33665771,12597651,440425,,12157226,7387122
2022-06-16,12529,491,854,1616,33678300,12597842,440057,,12157785,7388495
2022-06-17,11685,478,815,1652,33689985,12598035,439713,,12158322,7389913
2022-06-18,11441,435,873,1859,33701426,12598201,439272,,12158929,7391549
2022-06-19,6998,482,896,1420,33708424,12598438,438857,,12159581,7392762
2022-06-20,2286,147,301,643,33710710,12598369,438697,,12159672,7393240
2022-06-21,9536,358,614,1381,33720246,12598442,438436,,12160006,7394375
2022-06-22,13602,407,724,1697,33733848,12598580,438112,,12160468,7395850
2022-06-23,13691,399,772,1679,33747539,12598721,437737,,12160984,7397321
2022-06-24,15357,434,811,1669,33762896,12598901,437356,,12161545,7398779
2022-06-25,14461,424,851,1708,33777357,12599069,436918,,12162151,7400283
2022-06-26,8156,432,885,1280,33785513,12599249,436458,,12162791,7401354
2022-06-27,3210,171,363,593,33788723,12599179,436262,,12162917,7401745
2022-06-28,9611,370,555,1220,33798334,12599268,436073,,12163195,7402735
2022-06-29,13299,412,726,1627,33811633,12599394,435757,,12163637,7404126
2022-06-30,12221,482,845,1574,33823854,12599596,435392,,12164204,7405471
2022-07-01,13033,548,969,1946,33836887,12599893,434966,,12164927,7407216
2022-07-02,1606,110,114,362,33838493,12599732,434960,,12164772,7407350
2022-07-03,5155,261,491,957,33843648,12599745,434721,,12165024,7408100
2022-07-04,2755,131,279,614,33846403,12599633,434572,,12165061,7408520
2022-07-05,11139,372,598,1572,33857542,12599713,434338,,12165375,7409849
2022-07-06,15949,545,855,2007,33873491,12599968,434022,,12165946,7411619
2022-07-07,15652,521,831,1921,33889143,12600204,433711,,12166493,7413290
2022-07-08,17871,552,869,2241,33907014,12600462,433393,,12167069,7415288
2022-07-09,14132,450,596,1841,33921146,12600643,433246,,12167397,7416900
2022-07-10,8736,472,752,1499,33929882,12600873,432965,,12167908,7418198
2022-07-11,4093,199,331,870,33933975,12600812,432830,,12167982,7418853
2022-07-12,12098,413,522,1651,33946073,12600929,432716,,12168213,7420253
2022-07-13,16706,560,770,2141,33962779,12601201,432500,,12168701,7422158
2022-07-14,16852,485,673,2021,33979631,12601382,432301,,12169081,7423941
2022-07-15,28882,599,820,2178,34008513,12601685,432079,,12169606,7425881
2022-07-16,30281,585,770,2323,34038794,12601966,431887,,12170079,7427959
2022-07-17,22910,536,634,1875,34061704,12602269,431786,,12170483,7429643
2022-07-18,11386,187,254,851,34073090,12602192,431714,,12170478,7430274
2022-07-19,28938,593,589,2127,34102028,12602517,431715,,12170802,7432174
2022-07-20,37617,840,921,2583,34139645,12603088,431629,,12171459,7434527
2022-07-21,36339,734,807,2800,34175984,12603542,431549,,12171993,7437092
2022-07-22,35788,825,887,2680,34211772,12604088,431481,,12172607,7439541
2022-07-23,35128,818,913,2821,34246900,12604601,431378,,12173223,7442111
2022-07-24,21726,603,804,1767,34268626,12604949,431174,,12173775,7443657
2022-07-25,11925,308,307,1079,34280551,12604983,431171,,12173812,7444513
2022-07-26,26078,622,597,2207,34306629,12605329,431195,,12174134,7446481
2022-07-27,32455,810,843,2643,34339084,12605887,431160,,12174727,7448918
2022-07-28,31527,726,882,2599,34370611,12606325,431000,,12175325,7451274
2022-07-29,29978,1789,872,2638,34400589,12607831,431914,,12175917,7453667
2022-07-30,25812,2523,743,2429,34426401,12610087,433692,,12176395,7455875
2022-07-31,14285,1068,540,1556,34440686,12610897,434216,,12176681,7457213
2022-08-01,5908,335,222,680,34446594,12610979,434327,,12176652,7457675
2022-08-02,4469,305,134,597,34451063,12611021,434495,,12176526,7458053
2022-08-03,22922,2634,735,2232,34473985,12613390,436390,,12177000,7460058
2022-08-04,22215,2479,675,2127,34496200,12615552,438188,,12177364,7461929
2022-08-05,21782,2756,742,2062,34517982,12618033,440195,,12177838,7463768
2022-08-06,19639,2877,657,1989,34537621,12620609,442409,,12178200,7465508
2022-08-07,12691,2236,616,1415,34550312,12622581,444023,,12178558,7466712
2022-08-08,4764,570,188,603,34555076,12622875,444398,,12178477,7467088
2022-08-09,13999,1464,555,1589,34569075,12624059,445301,,12178758,7468441
2022-08-10,19117,2364,715,1986,34588192,12626154,446948,,12179206,7470203
2022-08-11,17070,2043,717,1849,34605262,12627937,448272,,12179665,7471832
2022-08-12,16974,2048,730,1849,34622236,12629702,449589,,12180113,7473457
2022-08-13,15940,2222,759,1803,34638176,12631650,451050,,12180600,7475029
2022-08-14,9518,1620,617,1079,34647694,12632989,452049,,12180940,7475878
2022-08-15,3867,388,268,476,34651561,12633132,452166,,12180966,7476153
2022-08-16,10798,1074,513,1354,34662359,12633915,452725,,12181190,7477265
2022-08-17,16086,1832,737,1776,34678445,12635470,453819,,12181651,7478813
2022-08-18,14917,1639,744,1685,34693362,12636801,454710,,12182091,7480242
2022-08-19,15294,1847,743,1542,34708656,12638380,455810,,12182570,7481558
2022-08-20,14275,1641,737,1543,34722931,12639737,456708,,12183029,7482867
2022-08-21,9893,1535,658,1159,34732824,12641015,457581,,12183434,7483814
2022-08-22,4161,482,269,560,34736985,12641211,457791,,12183420,7484130
2022-08-23,11117,1248,550,1487,34748102,12642165,458486,,12183679,7485376
2022-08-24,14746,1806,868,2183,34762848,12643706,459424,,12184282,7487333
2022-08-25,14020,1720,779,2117,34776868,12645149,460358,,12184791,7489213
2022-08-26,13920,1688,813,2089,34790788,12646557,461226,,12185331,7491065
2022-08-27,12408,1485,878,1994,34803196,12647728,461828,,12185900,7492801
2022-08-28,7918,1258,619,1395,34811114,12648739,462465,,12186274,7493985
2022-08-29,3393,504,282,681,34814507,12648982,462684,,12186298,7494445
2022-08-30,9900,1169,647,1853,34824407,12649810,463200,,12186610,7496010
2022-08-31,13505,1626,944,2310,34837912,12651161,463878,,12187283,7498088
2022-09-01,12895,1720,910,2136,34850807,12652595,464684,,12187911,7499987
2022-09-02,15037,1614,990,4918,34865844,12653943,465300,,12188643,7504687
2022-09-03,14705,1528,919,5510,34880549,12655209,465906,,12189303,7509980
2022-09-04,8660,1010,675,3234,34889209,12655971,466233,,12189738,7513005
2022-09-05,3549,321,229,1382,34892758,12656037,466322,,12189715,7514172
2022-09-06,2455,155,113,1124,34895213,12655955,466361,,12189594,7515100
2022-09-07,10917,1018,587,3489,34906130,12656690,466790,,12189900,7518347
2022-09-08,10859,1021,522,2790,34916989,12657406,467286,,12190120,7520879
2022-09-09,9578,1015,487,2499,34926567,12658141,467809,,12190332,7523148
2022-09-10,10649,1267,551,3162,34937216,12659146,468521,,12190625,7526088
2022-09-11,9399,984,667,3732,34946615,12659893,468832,,12191061,7529620
2022-09-12,3124,295,203,1079,34949739,12659923,468918,,12191005,7530475
2022-09-13,6009,542,281,1130,34955748,12660194,469171,,12191023,7531375
2022-09-14,14472,798,429,1843,34970220,12660690,469536,,12191154,7532966
2022-09-15,15739,779,408,1532,34985959,12661169,469903,,12191266,7534242
2022-09-16,17744,766,445,1689,35003703,12661694,470218,,12191476,7535726
2022-09-17,17599,722,455,1664,35021302,12662134,470481,,12191653,7537153
2022-09-18,11206,776,451,1685,35032508,12662669,470804,,12191865,7538631
2022-09-19,4975,402,287,670,35037483,12662817,470916,,12191901,7539098
2022-09-20,13744,438,325,940,35051227,12662956,471027,,12191929,7539783
2022-09-21,23018,643,406,1496,35074245,12663321,471260,,12192061,7541049
2022-09-22,22891,640,394,1375,35097136,12663668,471500,,12192168,7542174
2022-09-23,22930,727,598,1414,35120066,12664118,471625,,12192493,7543351
2022-09-24,21665,735,685,1496,35141731,12664580,471672,,12192908,7544624
2022-09-25,11309,594,702,1355,35153040,12664913,471560,,12193353,7545757
2022-09-26,4557,192,217,593,35157597,12664834,471531,,12193303,7546117
2022-09-27,37640,503,364,1496,35195237,12665084,471666,,12193418,7547399
2022-09-28,50939,731,668,1898,35246176,12665566,471728,,12193838,7549089
2022-09-29,47988,637,739,1836,35294164,12665911,471620,,12194291,7550670
2022-09-30,47263,679,806,2000,35341427,12666285,471491,,12194794,7552409
2022-10-01,34427,527,631,1542,35375854,12666528,471386,,12195142,7553706
2022-10-02,24233,737,1023,1710,35400087,12666994,471097,,12195897,7555183
2022-10-03,10860,240,230,610,35410947,12666969,471103,,12195866,7555576
2022-10-04,32176,476,458,1168,35443123,12667148,471117,,12196031,7556490
2022-10-05,40413,625,740,1558,35483536,12667485,470997,,12196488,7557805
2022-10-06,38672,608,652,1567,35522208,12667814,470952,,12196862,7559128
2022-10-07,42225,663,848,1742,35564433,12668160,470760,,12197400,7560592
2022-10-08,37379,788,1145,2120,35601812,12668652,470398,,12198254,7562465
2022-10-09,18810,549,727,1557,35620622,12668953,470217,,12198736,7563808
2022-10-10,6861,171,369,568,35627483,12668852,470017,,12198835,7564139
2022-10-11,4983,124,111,317,35632466,12668710,470026,,12198684,7564236
2022-10-12,35087,582,682,1424,35667553,12668987,469924,,12199063,7565393
2022-10-13,36747,644,857,1621,35704300,12669305,469709,,12199596,7566735
2022-10-14,36954,624,752,1537,35741254,12669628,469579,,12200049,7568012
2022-10-15,35439,716,1009,1624,35776693,12670086,469283,,12200803,7569417
2022-10-16,20652,652,1024,1592,35797345,12670493,468906,,12201587,7570796
2022-10-17,7349,206,478,538,35804694,12670448,468633,,12201815,7571123
2022-10-18,36408,459,498,1397,35841102,12670616,468591,,12202025,7572271
2022-10-19,49870,621,729,1982,35890972,12670964,468480,,12202484,7574026
2022-10-20,51258,624,648,2048,35942230,12671313,468455,,12202858,7575843
2022-10-21,52831,698,617,1938,35995061,12671715,468533,,12203182,7577535
2022-10-22,50847,751,904,2305,36045908,12672176,468375,,12203801,7579596
2022-10-23,30619,577,783,2118,36076527,12672481,468166,,12204315,7581482
2022-10-24,14129,232,270,979,36090656,12672449,468123,,12204326,7582232
2022-10-25,41337,475,487,1815,36131993,12672621,468109,,12204512,7583788
2022-10-26,51611,618,660,2122,36183604,12672940,468063,,12204877,7585659
2022-10-27,50089,610,768,2161,36233693,12673259,467899,,12205360,7587575
2022-10-28,49745,590,673,2093,36283438,12673543,467814,,12205729,7589397
2022-10-29,50573,738,778,2216,36334011,12673979,467770,,12206209,7591354
2022-10-30,28384,664,928,2034,36362395,12674404,467504,,12206900,7593177
2022-10-31,12435,201,234,775,36374830,12674372,467469,,12206903,7593755
2022-11-01,33059,342,194,1218,36407889,12674410,467611,,12206799,7594713
2022-11-02,44261,576,622,1903,36452150,12674707,467563,,12207144,7596362
2022-11-03,44166,541,604,1857,36496316,12674980,467498,,12207482,7597984
2022-11-04,44598,646,527,2021,36540914,12675378,467614,,12207764,7599793
2022-11-05,45183,648,755,2365,36586097,12675773,467504,,12208269,7601933
2022-11-06,26010,561,771,2095,36612107,12676046,467292,,12208754,7603777
2022-11-07,10706,243,235,876,36622813,12676066,467297,,12208769,7604467
2022-11-08,33461,488,396,1584,36656274,12676323,467386,,12208937,7605853
2022-11-09,40516,610,570,1961,36696790,12676680,467425,,12209255,7607596
2022-11-10,39128,626,547,1923,36735918,12677051,467503,,12209548,7609292
2022-11-11,43318,638,641,2204,36779236,12677437,467499,,12209938,7611277
2022-11-12,36827,641,593,2182,36816063,12677822,467541,,12210281,7613234
2022-11-13,24254,560,770,2273,36840317,12678150,467328,,12210822,7615306
2022-11-14,10959,233,204,1023,36851276,12678154,467356,,12210798,7616124
2022-11-15,33578,485,377,1690,36884854,12678353,467461,,12210892,7617570
2022-11-16,43512,804,581,2363,36928366,12678932,467683,,12211249,7619736
2022-11-17,38312,674,646,2241,36966678,12679331,467709,,12211622,7621738
2022-11-18,40588,725,531,2327,37007266,12679786,467901,,12211885,7623827
2022-11-19,39629,1015,1030,3075,37046895,12680532,467882,,12212650,7626662
2022-11-20,22406,663,715,2441,37069301,12680996,467829,,12213167,7628928
2022-11-21,8917,197,192,970,37078218,12680996,467830,,12213166,7629739
2022-11-22,26425,480,368,1511,37104643,12681188,467939,,12213249,7630996
2022-11-23,32046,688,664,2066,37136689,12681612,467961,,12213651,7632832
2022-11-24,31884,664,750,2080,37168573,12682029,467874,,12214155,7634699
2022-11-25,30738,765,829,1946,37199311,12682565,467805,,12214760,7636452
2022-11-26,30266,913,1190,2695,37229577,12683218,467522,,12215696,7638917
2022-11-27,18669,611,944,2086,37248246,12683590,467187,,12216403,7640791
2022-11-28,7534,191,280,785,37255780,12683544,467094,,12216450,7641365
2022-11-29,21010,421,450,1290,37276790,12683719,467062,,12216657,7642438
2022-11-30,27872,645,646,1839,37304662,12684124,467059,,12217065,7644062
2022-12-01,24786,594,681,1688,37329448,12684475,466970,,12217505,7645534
2022-12-02,25044,526,629,1770,37354492,12684752,466862,,12217890,7647082
2022-12-03,25533,588,779,1943,37380025,12685088,466664,,12218424,7648821
2022-12-04,15243,498,606,1698,37395268,12685334,466552,,12218782,7650293
2022-12-05,6868,169,156,741,37402136,12685274,466561,,12218713,7650838
2022-12-06,20330,421,351,1374,37422466,12685417,466630,,12218787,7651964
2022-12-07,24750,554,608,1668,37447216,12685737,466574,,12219163,7653430
2022-12-08,23143,563,523,1760,37470359,12686061,466613,,12219448,7654976
2022-12-09,23311,634,575,1631,37493670,12686448,466671,,12219777,7656396
2022-12-10,22561,512,600,1626,37516231,12686734,466582,,12220152,7657823
2022-12-11,14194,549,785,1567,37530425,12687088,466344,,12220744,7659217
2022-12-12,5506,150,157,593,37535931,12687021,466333,,12220688,7659630
2022-12-13,17780,379,365,1124,37553711,12687148,466347,,12220801,7660534
2022-12-14,21306,511,547,1450,37575017,12687453,466307,,12221146,7661802
2022-12-15,21944,531,600,1577,37596961,12687722,466237,,12221485,7663150
2022-12-16,16266,378,450,1027,37613227,12687853,466165,,12221688,7663966
2022-12-17,18682,559,504,1271,37631909,12688173,466219,,12221954,7665015
2022-12-18,12632,530,794,1303,37644541,12688486,465954,,12222532,7666121
2022-12-19,4585,133,115,448,37649126,12688369,465968,,12222401,7666346
2022-12-20,16200,501,449,1105,37665326,12688638,466017,,12222621,7667247
2022-12-21,18455,545,547,1297,37683781,12688968,466012,,12222956,7668353
2022-12-22,18581,577,587,1741,37702362,12689333,466002,,12223331,7669907
2022-12-23,15626,582,597,1712,37717988,12689658,465982,,12223676,7671404
2022-12-24,5327,222,171,670,37723315,12689656,466033,,12223623,7671868
2022-12-25,2440,154,152,480,37725755,12689586,466028,,12223558,7672152
2022-12-26,262,12,7,48,37726017,12689372,466029,,12223343,7672001
2022-12-27,2087,99,35,301,37728104,12689279,466091,,12223188,7672133
2022-12-28,8311,336,167,975,37736415,12689373,466258,,12223115,7672889
2022-12-29,13151,584,524,1600,37749566,12689724,466315,,12223409,7674284
2022-12-30,15808,673,658,1873,37765374,12690163,466327,,12223836,7675947
2022-12-31,11223,462,387,1353,37776597,12690359,466398,,12223961,7677066
2023-01-01,3882,202,214,559,37780479,12690338,466386,,12223952,7677429
2023-01-02,652,37,15,96,37781131,12690189,466408,,12223781,7677361
2023-01-03,8185,300,152,897,37789316,12690273,466551,,12223722,7678078
2023-01-04,14709,576,547,1544,37804025,12690653,466574,,12224079,7679452
2023-01-05,16101,659,533,1790,37820126,12691096,466698,,12224398,7681051
2023-01-06,18812,720,606,2041,37838938,12691609,466809,,12224800,7682908
2023-01-07,18499,709,638,2053,37857437,12692113,466877,,12225236,7684781
2023-01-08,11602,584,606,1629,37869039,12692527,466854,,12225673,7686256
2023-01-09,5295,216,196,664,37874334,12692543,466873,,12225670,7686743
2023-01-10,12154,422,315,779,37886488,12692746,466980,,12225766,7687326
2023-01-11,15532,459,370,1092,37902020,12692986,467067,,12225919,7688228
2023-01-12,14050,453,407,970,37916070,12693215,467112,,12226103,7689000
2023-01-13,14141,425,345,1035,37930211,12693465,467192,,12226273,7689870
2023-01-14,13352,478,453,1074,37943563,12693750,467215,,12226535,7690767
2023-01-15,9034,468,504,1048,37952597,12694037,467178,,12226859,7691663
2023-01-16,3743,151,130,479,37956340,12693995,467199,,12226796,7691964
2023-01-17,8837,271,178,651,37965177,12694027,467292,,12226735,7692409
2023-01-18,10236,352,273,756,37975413,12694186,467371,,12226815,7692988
2023-01-19,10554,319,318,758,37985967,12694306,467368,,12226938,7693572
2023-01-20,9812,320,271,712,37995779,12694449,467416,,12227033,7694120
2023-01-21,11287,357,398,905,38007066,12694631,467375,,12227256,7694873
2023-01-22,7561,346,404,817,38014627,12694814,467315,,12227499,7695537
2023-01-23,3375,145,131,287,38018002,12694821,467329,,12227492,7695703
2023-01-24,8258,231,165,545,38026260,12694858,467393,,12227465,7696082
2023-01-25,10304,350,296,659,38036564,12695036,467446,,12227590,7696590
2023-01-26,6715,236,203,468,38043279,12695102,467479,,12227623,7696912
2023-01-27,6897,242,197,487,38050176,12695178,467524,,12227654,7697253
2023-01-28,9317,312,337,686,38059493,12695313,467495,,12227818,7697784
2023-01-29,5954,238,340,687,38065447,12695391,467390,,12228001,7698328
2023-01-30,1897,92,79,213,38067344,12695345,467403,,12227942,7698416
2023-01-31,5841,156,150,409,38073185,12695341,467409,,12227932,7698678
2023-02-01,7282,255,247,486,38080467,12695468,467417,,12228051,7699051
2023-02-02,6452,295,239,497,38086919,12695635,467471,,12228164,7699440
2023-02-03,6527,197,191,461,38093446,12695712,467476,,12228236,7699796
2023-02-04,6647,224,303,538,38100093,12695811,467394,,12228417,7700228
2023-02-05,4166,201,288,483,38104259,12695902,467307,,12228595,7700619
2023-02-06,1829,91,97,211,38106088,12695860,467300,,12228560,7700706
2023-02-07,4941,165,182,380,38111029,12695906,467283,,12228623,7700982
2023-02-08,5759,216,206,424,38116788,12696028,467292,,12228736,7701321
2023-02-09,6099,215,245,435,38122887,12696151,467262,,12228889,7701676
2023-02-10,5031,153,205,367,38127918,12696225,467209,,12229016,7701973
2023-02-11,6001,185,257,451,38133919,12696322,467134,,12229188,7702348
2023-02-12,4061,216,342,407,38137980,12696463,467005,,12229458,7702688
2023-02-13,1478,58,87,143,38139458,12696464,466976,,12229488,7702785
2023-02-14,3908,133,176,302,38143366,12696501,466932,,12229569,7703004
2023-02-15,4502,119,189,281,38147868,12696544,466862,,12229682,7703216
2023-02-16,4891,176,284,395,38152759,12696648,466754,,12229894,7703545
2023-02-17,4941,181,208,340,38157700,12696793,466727,,12230066,7703852
2023-02-18,5064,237,293,481,38162764,12697023,466671,,12230352,7704326
2023-02-19,3320,138,242,370,38166084,12697161,466567,,12230594,7704696
2023-02-20,1408,62,54,154,38167492,12697223,466575,,12230648,7704850
2023-02-21,877,24,14,100,38168369,12697247,466585,,12230662,7704950
2023-02-22,4039,140,214,348,38172408,12697387,466511,,12230876,7705298
2023-02-23,3967,170,225,357,38176375,12697557,466456,,12231101,7705655
