"report_date","previous_day_total_doses_administered","previous_day_at_least_one","previous_day_fully_vaccinated","previous_day_3doses","total_doses_administered","total_individuals_at_least_one","total_individuals_partially_vaccinated","total_doses_in_fully_vaccinated_individuals","total_individuals_fully_vaccinated","total_individuals_3doses"
2021-01-01,6252,6242,2,,32215,32160,32149,22,11,
2021-01-02,4616,4604,6,,36831,36712,36699,26,13,
2021-01-03,5396,5389,3,,42227,42101,42085,32,16,
2021-01-04,5996,5993,0,,48223,48093,48078,30,15,
2021-01-05,9687,9662,21,,57910,57753,57718,70,35,
2021-01-06,12793,12328,450,,70703,70078,69596,964,482,
2021-01-07,16220,15508,698,,86923,85585,84405,2360,1180,
2021-01-08,18039,17024,1002,,104962,102609,100427,4364,2182,
2021-01-09,19503,18426,1064,,124465,121034,117788,6492,3246,
2021-01-10,11374,11333,39,,135839,132359,129074,6570,3285,
2021-01-11,11712,11661,48,,147551,144020,140687,6666,3333,
2021-01-12,14469,14162,298,,162020,158174,154543,7262,3631,
2021-01-13,15438,13814,1594,,177458,171974,166751,10446,5223,
2021-01-14,19193,16740,2437,,196651,188708,181049,15318,7659,
2021-01-15,20077,18019,2038,,216728,206716,197019,19394,9697,
2021-01-16,17121,15937,1171,,233849,222637,211769,21736,10868,
2021-01-17,11261,10017,1237,,245110,232639,220536,24206,12103,
2021-01-18,6796,6713,73,,251906,239329,227156,24346,12173,
2021-01-19,11830,9721,2095,,263736,249029,234761,28536,14268,
2021-01-20,10804,7215,3572,,274540,256221,238382,35678,17839,
2021-01-21,10977,6856,4093,,285517,263061,241129,43864,21932,
2021-01-22,9041,4324,4697,,294558,267348,240721,53254,26627,
2021-01-23,7462,3044,4390,,302020,270362,239346,62032,31016,
2021-01-24,4390,1833,2536,,306410,272177,238625,67104,33552,
2021-01-25,5324,1050,4265,,311734,273195,235379,75632,37816,
2021-01-26,9394,2867,6499,,321128,276030,231716,88628,44314,
2021-01-27,9899,2866,7004,,331027,278867,227550,102634,51317,
2021-01-28,13123,5744,7337,,344150,284578,225924,117308,58654,
2021-01-29,10709,3294,7379,,354859,287841,221809,132064,66032,
2021-01-30,9193,2732,6424,,364052,290531,218078,144906,72453,
2021-01-31,3384,1570,1768,,367436,292067,217847,148440,74220,
2021-02-01,2127,489,1610,,369563,292522,216696,151652,75826,
2021-02-02,4421,1368,2996,,373984,293852,215034,157636,78818,
2021-02-03,6240,1720,4458,,380224,295531,212262,166538,83269,
2021-02-04,9096,1724,7293,,389320,297212,206656,181112,90556,
2021-02-05,8447,1469,6904,,397767,298641,201187,194908,97454,
2021-02-06,10671,1873,8737,,408438,300459,194277,212364,106182,
2021-02-07,7579,1731,5796,,416017,302150,190184,223932,111966,
2021-02-08,8222,3096,5081,,424239,305198,188164,234068,117034,
2021-02-09,15011,3860,11083,,439250,309016,180915,256202,128101,
2021-02-10,15515,4936,10518,,454765,313900,175306,277188,138594,
2021-02-11,16366,3899,12409,,471131,317747,166775,301944,150972,
2021-02-12,17678,2099,15528,,488809,319807,153327,332960,166480,
2021-02-13,16214,2446,13752,,505023,322208,141995,360426,180213,
2021-02-14,12883,924,11926,,517906,323084,130975,384218,192109,
2021-02-15,7863,486,7328,,525769,323522,124111,398822,199411,
2021-02-16,5996,1042,4903,,531765,324521,120230,408582,204291,
2021-02-17,10169,1610,8525,,541934,326087,113299,425576,212788,
2021-02-18,13875,2958,10873,,555809,328997,105366,447262,223631,
2021-02-19,18491,6213,12211,,574300,335158,99347,471622,235811,
2021-02-20,22633,11136,11444,,596933,346231,99014,494434,247217,
2021-02-21,17243,10386,6823,,614176,356557,102559,507996,253998,
2021-02-22,13589,8759,4777,,627765,365247,106521,517452,258726,
2021-02-23,17870,11126,6673,,645635,376317,110954,530726,265363,
2021-02-24,18578,13613,4884,,664213,389874,119669,540410,270205,
2021-02-25,20811,16490,4264,,685024,406298,131877,548842,274421,
2021-02-26,24914,21842,3010,,709938,428080,150686,554788,277394,
2021-02-27,27469,23586,3840,,737407,451602,170416,562372,281186,
2021-02-28,20589,19147,1407,,757996,470695,188144,565102,282551,
2021-03-01,18227,17030,1148,,776223,487663,204011,567304,283652,
2021-03-02,24693,22281,2327,,800916,509883,223950,571866,285933,
2021-03-03,30602,27966,2579,,831518,537798,249319,576958,288479,
2021-03-04,34700,32466,2147,,866218,570198,279622,581152,290576,
2021-03-05,40008,38173,1786,,906226,608323,315995,584656,292328,
2021-03-06,44160,41950,2172,,950386,650218,355759,588918,294459,
2021-03-07,32738,31559,1175,,983124,681703,386127,591152,295576,
2021-03-08,24040,22164,1861,,1007164,703799,406416,594766,297383,
2021-03-09,33300,29849,3423,,1040464,733582,432822,601520,300760,
2021-03-10,38347,34084,4218,,1078811,767592,462662,609860,304930,
2021-03-11,43985,40712,3234,,1122796,808238,500126,616224,308112,
2021-03-12,47717,46005,1689,,1170513,854179,544428,619502,309751,
2021-03-13,57938,55060,2851,,1228451,909168,596620,625096,312548,
2021-03-14,43423,42183,1222,,1271874,951268,637566,627404,313702,
2021-03-15,32815,31117,1682,,1304689,982326,666985,630682,315341,
2021-03-16,53964,51664,2282,,1358653,1033925,716345,635160,317580,
2021-03-17,61071,58530,2497,,1419724,1092389,772362,640054,320027,
2021-03-18,61559,59095,2436,,1481283,1151412,829002,644820,322410,
2021-03-19,64485,61152,3275,,1545768,1212486,886854,651264,325632,
2021-03-20,62579,59987,2560,,1608347,1272417,944273,656288,328144,
2021-03-21,44007,42480,1540,,1652354,1314832,985185,659294,329647,
2021-03-22,31003,30036,978,,1683357,1344780,1014211,661138,330569,
2021-03-23,54626,51852,2723,,1737983,1396537,1063308,666458,333229,
2021-03-24,76438,73256,3134,,1814421,1469703,1133397,672612,336306,
2021-03-25,82920,80339,2534,,1897341,1549963,1211180,677566,338783,
2021-03-26,87020,83490,3490,,1984361,1633372,1291151,684442,342221,
2021-03-27,80867,77913,2868,,2065228,1711182,1366158,690048,345024,
2021-03-28,67002,65412,1555,,2132230,1776504,1429982,693044,346522,
2021-03-29,51741,49050,2652,,2183971,1825474,1476346,698256,349128,
2021-03-30,73589,70177,3350,,2257560,1895574,1543137,704874,352437,
2021-03-31,93159,89507,3586,,2350719,1984983,1629013,711940,355970,
2021-04-01,89324,85444,3840,,2440043,2070329,1710572,719514,359757,
2021-04-02,93097,88866,4213,,2533140,2159109,1795191,727836,363918,
2021-04-03,61012,59333,1735,,2594152,2218351,1852749,731204,365602,
2021-04-04,72333,70677,1651,,2666485,2288917,1921722,734390,367195,
2021-04-05,53734,53263,470,,2720219,2342096,1974479,735234,367617,
2021-04-06,79592,77719,1889,,2799811,2419713,2050261,738904,369452,
2021-04-07,108016,104947,3056,,2907827,2524535,2152085,744900,372450,
2021-04-08,114086,110111,4028,,3021913,2634535,2258113,752844,376422,
2021-04-09,109861,105628,4303,,3131774,2740045,2359385,761320,380660,
2021-04-10,109254,105490,3854,,3241028,2845407,2460959,768896,384448,
2021-04-11,98633,95514,3259,,3339661,2940796,2553148,775296,387648,
2021-04-12,76076,75011,1158,,3415737,3015659,2626921,777476,388738,
2021-04-13,99482,96097,3402,,3515219,3111647,2719555,784184,392092,
2021-04-14,117053,113288,3650,,3632272,3224817,2829115,791404,395702,
2021-04-15,113569,109508,3899,,3745841,3334199,2934655,799088,399544,
2021-04-16,118091,113717,4194,,3863932,3447806,3044112,807388,403694,
2021-04-17,112428,107834,4454,,3976360,3555506,3147417,816178,408089,
2021-04-18,88750,86512,2102,,4065110,3641895,3231758,820274,410137,
2021-04-19,68976,67441,1453,,4134086,3709206,3297667,823078,411539,
2021-04-20,102121,98794,3121,,4236207,3807838,3393243,829190,414595,
2021-04-21,142054,137773,4045,,4378261,3945437,3526865,837144,418572,
2021-04-22,139508,135352,3914,,4517769,4080660,3658230,844860,422430,
2021-04-23,138226,131802,6176,,4655995,4212308,3783760,857096,428548,
2021-04-24,130305,126236,3894,,4786300,4338396,3906010,864772,432386,
2021-04-25,102024,98612,3180,,4888324,4436860,4001361,870998,435499,
2021-04-26,71008,69302,1558,,4959332,4506031,4069034,873994,436997,
2021-04-27,98520,95426,2900,,5057852,4601296,4161462,879668,439834,
2021-04-28,120587,115957,4437,,5178439,4717085,4272886,888398,444199,
2021-04-29,124498,119296,5050,,5302937,4836214,4387034,898360,449180,
2021-04-30,115835,110578,5015,,5418772,4946619,4492501,908236,454118,
2021-05-01,111315,107438,3654,,5530087,5053876,4596181,915390,457695,
2021-05-02,79149,76172,2864,,5609236,5129891,4669398,920986,460493,
2021-05-03,56797,55125,1599,,5666033,5184861,4722829,924064,462032,
2021-05-04,91940,88567,3285,,5757973,5273250,4808010,930480,465240,
2021-05-05,138009,133297,4620,,5895982,5406378,4936581,939594,469797,
2021-05-06,141843,136886,4819,,6037825,5543080,5068526,949108,474554,
2021-05-07,150301,145254,4840,,6188126,5688174,5208839,958670,479335,
2021-05-08,142476,137784,4440,,6330602,5825763,5342067,967392,483696,
2021-05-09,124820,121165,3484,,6455422,5946764,5459648,974232,487116,
2021-05-10,97817,95827,1885,,6553239,6042402,5553468,977868,488934,
2021-05-11,113547,108862,4497,,6666786,6151062,5657702,986720,493360,
2021-05-12,145062,138026,6886,,6811848,6288909,5788729,1000360,500180,
2021-05-13,142718,135324,7238,,6954566,6424058,5916714,1014688,507344,
2021-05-14,148881,138787,9922,,7103447,6562657,6045456,1034402,517201,
2021-05-15,159755,149704,9870,,7263202,6712174,6185178,1053992,526996,
2021-05-16,144371,136100,8064,,7407573,6848106,6313126,1069960,534980,
2021-05-17,114986,110888,3944,,7522559,6958805,6419957,1077696,538848,
2021-05-18,111354,100486,10665,,7633913,7059095,6509644,1098902,549451,
2021-05-19,149893,133476,16238,,7783806,7192419,6626804,1131230,565615,
2021-05-20,151584,131585,19778,,7935390,7323815,6738491,1170648,585324,
2021-05-21,165409,140899,24250,,8100799,7464533,6855036,1218994,609497,
2021-05-22,199460,172257,26975,,8300259,7636592,7000201,1272782,636391,
2021-05-23,139847,127474,12227,,8440106,7763888,7115332,1297112,648556,
2021-05-24,100302,93330,6827,,8540408,7857045,7201732,1310626,655313,
2021-05-25,90482,82994,7277,,8630890,7939876,7277353,1325046,662523,
2021-05-26,139797,113026,26507,,8770687,8052715,7363755,1377920,688960,
2021-05-27,152073,123053,28768,,8922760,8175611,7457952,1435318,717659,
2021-05-28,163881,132322,31250,,9086641,8307760,7558910,1497700,748850,
2021-05-29,153403,117139,36031,,9240044,8424749,7639924,1569650,784825,
2021-05-30,149734,119027,30479,,9389778,8543606,7728364,1630484,815242,
2021-05-31,99224,79829,19202,,9489002,8623265,7788885,1668760,834380,
2021-06-01,124217,90627,33251,,9613219,8713697,7846141,1735112,867556,
2021-06-02,145335,102165,42917,,9758554,8815681,7905277,1820808,910404,
2021-06-03,155387,99929,55177,,9913941,8915425,7949915,1931020,965510,
2021-06-04,181736,115548,65915,,10095677,9030774,7999437,2062674,1031337,
2021-06-05,172051,103449,68318,,10267728,9134025,8034455,2199140,1099570,
2021-06-06,163405,91878,71246,,10431133,9225725,8054979,2341492,1170746,
2021-06-07,119571,63063,56290,,10550704,9288591,8061630,2453922,1226961,
2021-06-08,161912,72465,89006,,10712616,9360867,8044980,2631774,1315887,
2021-06-09,181479,70817,110191,,10894095,9431507,8005510,2851994,1425997,
2021-06-10,185601,66436,118672,,11079696,9497740,7953162,3089156,1544578,
2021-06-11,204808,67528,136517,,11284504,9565082,7884069,3362026,1681013,
2021-06-12,199758,62688,136467,,11484262,9627588,7810200,3634776,1817388,
2021-06-13,190356,58902,130920,,11674618,9686315,7738087,3896456,1948228,
2021-06-14,137700,38702,98596,,11812318,9724821,7678102,4093438,2046719,
2021-06-15,189570,42625,146586,,12001888,9767227,7574019,4386416,2193208,
2021-06-16,206275,42443,163184,,12208163,9809474,7453185,4712578,2356289,
2021-06-17,210493,37953,171953,,12418656,9847212,7319062,5056300,2528150,
2021-06-18,217220,35375,181240,,12635876,9882397,7173099,5418596,2709298,
2021-06-19,215913,35507,179728,,12851789,9917698,7028784,5777828,2888914,
2021-06-20,186293,35583,150132,,13038082,9953083,6914145,6077876,3038938,
2021-06-21,120444,20835,99103,,13158526,9973723,6835774,6275898,3137949,
2021-06-22,204961,27533,176669,,13363487,10001062,6686553,6629018,3314509,
2021-06-23,230557,28642,201165,,13594044,10029504,6513938,7031132,3515566,
2021-06-24,227724,26686,200273,,13821768,10055994,6340265,7431458,3715729,
2021-06-25,251144,28006,222386,,14072912,10083798,6145802,7875992,3937996,
2021-06-26,261327,30021,230596,,14334239,10113593,5945142,8336902,4168451,
2021-06-27,205024,27806,176610,,14539263,10141217,5796266,8689902,4344951,
2021-06-28,199264,20958,177737,,14738527,10161977,5639414,9045126,4522563,
2021-06-29,250127,24500,224890,,14988654,10186236,5438937,9494598,4747299,
2021-06-30,275559,24183,250807,,15264213,10210216,5212239,9995954,4997977,
2021-07-01,271985,25315,246114,,15536198,10235313,4991361,10487904,5243952,
2021-07-02,144742,11597,132913,,15680940,10246736,4869973,10753526,5376763,
2021-07-03,216911,19938,196742,,15897851,10266452,4693096,11146712,5573356,
2021-07-04,196234,19468,176539,,16094085,10285734,4535958,11499552,5749776,
2021-07-05,148732,12451,136136,,16242817,10297995,4412211,11771568,5885784,
2021-07-06,220052,20003,199831,,16462869,10317782,4232313,12170938,6085469,
2021-07-07,246630,22975,223411,,16709499,10340531,4031799,12617464,6308732,
2021-07-08,231234,21372,209645,,16940733,10361697,3843455,13036484,6518242,
2021-07-09,227021,21519,205331,,17167754,10383014,3659573,13446882,6723441,
2021-07-10,209076,20544,188375,,17376830,10403354,3491675,13823358,6911679,
2021-07-11,171690,17589,153973,,17548520,10420742,3355237,14131010,7065505,
2021-07-12,123139,11445,111593,,17671659,10431998,3255037,14353922,7176961,
2021-07-13,178532,19044,159344,,17850191,10450820,3114670,14672300,7336150,
2021-07-14,180050,19308,160584,,18030241,10469913,2973342,14993142,7496571,
2021-07-15,167220,19594,147450,,18197461,10489296,2845439,15287714,7643857,
2021-07-16,169381,19924,149305,,18366842,10509018,2716009,15586018,7793009,
2021-07-17,173034,20279,152624,,18539876,10529048,2583607,15890882,7945441,
2021-07-18,133652,15945,117568,,18673528,10544809,2481948,16125722,8062861,
2021-07-19,91992,10422,81462,,18765520,10555018,2410870,16288296,8144148,
2021-07-20,133554,16962,116538,,18899074,10571740,2311230,16521020,8260510,
2021-07-21,140092,16988,123034,,19039166,10588513,2205131,16766764,8383382,
2021-07-22,125649,17667,107843,,19164815,10605956,2114908,16982096,8491048,
2021-07-23,120291,17001,103082,,19285106,10622716,2028785,17187862,8593931,
2021-07-24,126711,18339,108134,,19411817,10640852,1938950,17403804,8701902,
2021-07-25,103657,14871,88655,,19515474,10655499,1865123,17580752,8790376,
2021-07-26,66699,9892,56712,,19582173,10665174,1818266,17693816,8846908,
2021-07-27,92402,15327,76913,,19674575,10680240,1756636,17847208,8923604,
2021-07-28,93960,16477,77412,,19768535,10696482,1695657,18001650,9000825,
2021-07-29,89416,16711,72542,,19857951,10712961,1639782,18146358,9073179,
2021-07-30,84081,16110,67857,,19942032,10728843,1587995,18281696,9140848,
2021-07-31,83884,15741,67994,,20025916,10744366,1535714,18417304,9208652,
2021-08-01,61886,11327,50373,,20087802,10755467,1496633,18517668,9258834,
2021-08-02,42503,7425,34957,,20130305,10762694,1469069,18587250,9293625,
2021-08-03,33310,5964,27173,,20163615,10768425,1447837,18641176,9320588,
2021-08-04,61335,12381,48763,,20224950,10780571,1411418,18738306,9369153,
2021-08-05,59471,12559,46760,,20284421,10792922,1377173,18831498,9415749,
2021-08-06,56038,11863,43961,,20340459,10804525,1345044,18918962,9459481,
2021-08-07,62387,12138,50054,,20402846,10816402,1307085,19018634,9509317,
2021-08-08,48712,9283,39237,,20451558,10825457,1277108,19096698,9548349,
2021-08-09,30866,5941,24747,,20482424,10831184,1258275,19145818,9572909,
2021-08-10,49279,10520,38455,,20531703,10841424,1230306,19222236,9611118,
2021-08-11,48733,10769,37713,,20580436,10851946,1203331,19297230,9648615,
2021-08-12,49271,11212,37825,,20629707,10862907,1176676,19372462,9686231,
2021-08-13,49647,11740,37632,,20679354,10874406,1150754,19447304,9723652,
2021-08-14,51237,12141,38885,,20730591,10886297,1123984,19524626,9762313,
2021-08-15,41787,9862,31697,,20772378,10895957,1102119,19587676,9793838,
2021-08-16,26752,6192,20408,,20799130,10901926,1087877,19628098,9814049,
2021-08-17,40519,11065,29185,,20839649,10912741,1069733,19686016,9843008,
2021-08-18,41910,11979,29688,,20881559,10924478,1051992,19744972,9872486,
2021-08-19,45912,16544,29103,,20927471,10940771,1039405,19802732,9901366,
2021-08-20,46471,16308,29750,,20973942,10956823,1025936,19861774,9930887,
2021-08-21,47969,15154,32448,,21021911,10971717,1008609,19926216,9963108,
2021-08-22,34411,10815,23323,,21056322,10982285,996077,19972416,9986208,
2021-08-23,23228,7008,16001,,21079550,10989058,987063,20003990,10001995,
2021-08-24,37659,13378,23824,,21117209,11002182,976594,20051176,10025588,
2021-08-25,41373,14428,26333,,21158582,11016354,964670,20103368,10051684,
2021-08-26,39289,13560,24984,,21197871,11029638,953211,20152854,10076427,
2021-08-27,37687,12950,23691,,21235558,11042347,942443,20199808,10099904,
2021-08-28,40140,13429,25531,,21275698,11055497,930317,20250360,10125180,
2021-08-29,30568,10257,19947,,21306266,11065522,920608,20289828,10144914,
2021-08-30,18245,6144,11848,,21324511,11071418,914875,20313086,10156543,
2021-08-31,32720,11940,19625,,21357231,11083090,907162,20351856,10175928,
2021-09-01,36264,12955,21963,,21393495,11095812,898138,20395348,10197674,
2021-09-02,37795,15651,19676,,21431290,11111211,894088,20434246,10217123,
2021-09-03,46902,21102,22448,,21478192,11132064,892723,20478682,10239341,
2021-09-04,46894,20592,24784,,21525086,11152410,888508,20527804,10263902,
2021-09-05,33093,14211,18586,,21558179,11166377,884113,20564528,10282264,
2021-09-06,21727,9493,12042,,21579906,11175621,881547,20588148,10294074,
2021-09-07,15022,6733,8103,,21594928,11182097,880160,20603874,10301937,
2021-09-08,41157,17117,20940,,21636085,11198950,876319,20645262,10322631,
2021-09-09,41474,16991,19685,,21677559,11215664,873600,20684128,10342064,
2021-09-10,39669,15517,19017,,21717228,11230918,870082,20721672,10360836,
2021-09-11,42396,15940,23343,,21759624,11246579,862658,20767842,10383921,
2021-09-12,29984,11537,17877,,21789608,11257822,856288,20803068,10401534,
2021-09-13,16097,6408,9188,,21805705,11263996,853493,20821006,10410503,
2021-09-14,29921,11566,15298,,21835626,11275260,849734,20851052,10425526,
2021-09-15,39288,14025,19427,,21874914,11289025,844316,20889418,10444709,
2021-09-16,39359,13991,19252,,21914273,11302781,839032,20927498,10463749,
2021-09-17,38942,13615,19346,,21953215,11316153,833289,20965728,10482864,
2021-09-18,41268,14091,23553,,21994483,11329971,823806,21012330,10506165,
2021-09-19,30671,10830,18989,,22025154,11340542,815634,21049816,10524908,
2021-09-20,16737,6100,10179,,22041891,11346388,811532,21069712,10534856,
2021-09-21,31370,11218,16996,,22073261,11357341,805738,21103206,10551603,
2021-09-22,41822,14820,22931,,22115083,11371865,797606,21148518,10574259,
2021-09-23,47236,16139,26035,,22162319,11387739,787691,21200096,10600048,
2021-09-24,46332,15641,26667,,22208651,11403120,776646,21252948,10626474,
2021-09-25,48209,15258,29955,,22256860,11418125,761930,21312390,10656195,
2021-09-26,37519,12424,24499,,22294379,11430274,749834,21360880,10680440,
2021-09-27,19165,6532,12326,,22313544,11436552,744024,21385056,10692528,
2021-09-28,30971,11295,17892,,22344515,11447588,737415,21420346,10710173,
2021-09-29,37897,12477,21734,,22382412,11459794,728138,21463312,10731656,
2021-09-30,37356,11658,21381,,22419768,11471193,718396,21505594,10752797,
2021-10-01,30889,9811,18419,,22450657,11480777,709775,21542004,10771002,
2021-10-02,37148,11160,23592,,22487805,11491667,697325,21588684,10794342,
2021-10-03,27211,8167,18325,,22515016,11499593,687154,21624878,10812439,
2021-10-04,14870,4748,9803,,22529886,11504094,682081,21644026,10822013,
2021-10-05,26851,8601,15888,,22556737,11512434,674779,21675310,10837655,
2021-10-06,31682,9642,18523,,22588419,11521817,665890,21711854,10855927,
2021-10-07,30362,9404,17125,,22618781,11530970,658156,21745628,10872814,
2021-10-08,32851,10745,18860,,22651632,11541444,650027,21782834,10891417,
2021-10-09,34158,10669,21027,,22685790,11551850,639655,21824390,10912195,
2021-10-10,23424,7662,15092,,22709214,11559261,632213,21854096,10927048,
2021-10-11,12007,3840,7868,,22721221,11562851,628169,21869364,10934682,
2021-10-12,5125,1631,3276,,22726346,11564204,626509,21875390,10937695,
2021-10-13,29123,9193,18099,,22755469,11573107,617587,21911040,10955520,
2021-10-14,29026,8905,17756,,22784495,11581736,608726,21946020,10973010,
2021-10-15,29109,8833,18175,,22813604,11590306,599371,21981870,10990935,
2021-10-16,31144,8988,19873,,22844748,11599003,588474,22021058,11010529,
2021-10-17,23723,7264,15386,,22868471,11606013,580339,22051348,11025674,
2021-10-18,12311,3747,8151,,22880782,11609479,575923,22067112,11033556,
2021-10-19,21289,6631,12645,,22902071,11615827,569896,22091862,11045931,
2021-10-20,25678,7541,14928,,22927749,11623121,562496,22121250,11060625,
2021-10-21,23189,6685,13038,,22950938,11629537,556132,22146810,11073405,
2021-10-22,26138,7319,15123,,22977076,11636533,548312,22176442,11088221,
2021-10-23,28194,7607,17166,,23005270,11643878,538746,22210264,11105132,
2021-10-24,19362,5729,12607,,23024632,11649351,531856,22234990,11117495,
2021-10-25,9933,2710,6477,,23034565,11651792,528081,22247422,11123711,
2021-10-26,18930,5395,11108,,23053495,11656909,522359,22269100,11134550,
2021-10-27,22869,6082,13222,,23076364,11662736,515205,22295062,11147531,
2021-10-28,22314,5792,12648,,23098678,11668240,508338,22319804,11159902,
2021-10-29,22825,5733,13058,,23121503,11673671,500998,22345346,11172673,
2021-10-30,24128,6049,14624,,23145631,11679448,492411,22374074,11187037,
2021-10-31,16490,4596,10607,,23162121,11683750,486395,22394710,11197355,
2021-11-01,7879,2084,5058,,23170000,11685554,483408,22404292,11202146,
2021-11-02,15632,4365,7748,,23185632,11689630,480014,22419232,11209616,
2021-11-03,18637,5070,9609,,23204269,11694397,475465,22437864,11218932,
2021-11-04,19514,4875,10039,,23223783,11698996,470286,22457420,11228710,
2021-11-05,21475,4405,9526,,23245258,11703112,465151,22475922,11237961,
2021-11-06,25344,5210,12158,,23270602,11708053,458186,22499734,11249867,
2021-11-07,21459,4027,8928,,23292061,11711799,453273,22517052,11258526,
2021-11-08,11993,2111,4733,,23304054,11713615,450635,22525960,11262980,
2021-11-09,24140,3855,7657,,23328194,11717149,446823,22540652,11270326,
2021-11-10,28489,4510,9003,,23356683,11721383,442316,22558134,11279067,
2021-11-11,28777,4311,9104,,23385460,11725397,437514,22575766,11287883,
2021-11-12,26754,4166,8246,,23412214,11729272,433420,22591704,11295852,
2021-11-13,34321,5083,11416,,23446535,11734049,427078,22613942,11306971,
2021-11-14,23231,3901,8613,,23469766,11737687,422359,22630656,11315328,
2021-11-15,12704,2187,4496,,23482470,11739614,420042,22639144,11319572,
2021-11-16,26193,3935,7490,,23508663,11743293,416483,22653620,11326810,
2021-11-17,31186,4046,7834,,23539849,11747057,412685,22668744,11334372,
2021-11-18,32515,3868,7534,,23572364,11750618,409005,22683226,11341613,
2021-11-19,35490,3866,7761,,23607854,11754183,405098,22698170,11349085,
2021-11-20,40123,4383,8825,,23647977,11758285,400647,22715276,11357638,
2021-11-21,28129,3439,6953,,23676106,11761462,397119,22728686,11364343,
2021-11-22,14902,1951,3896,,23691008,11763136,395168,22735936,11367968,
2021-11-23,33067,3280,6016,,23724075,11766136,392424,22747424,11373712,
2021-11-24,42678,3762,6818,,23766753,11769594,389357,22760474,11380237,
2021-11-25,46052,3936,6578,,23812805,11773255,386712,22773086,11386543,
2021-11-26,52870,11348,6618,,23865675,11784332,391435,22785794,11392897,
2021-11-27,63533,22361,7043,,23929208,11806412,406743,22799338,11399669,
2021-11-28,51467,27742,5322,,23980675,11833862,429151,22809422,11404711,
2021-11-29,33532,18933,2887,,24014207,11852534,445186,22814696,11407348,
2021-11-30,56054,20690,5142,,24070261,11872943,460724,22824438,11412219,
2021-12-01,69553,26244,5644,,24139814,11898881,481310,22835142,11417571,
2021-12-02,71643,26489,5042,,24211457,11925072,502744,22844656,11422328,
2021-12-03,73436,25100,5175,,24284893,11949876,522663,22854426,11427213,
2021-12-04,81166,27786,6078,47282,24366059,11977368,544362,,11433006,807793
2021-12-05,62644,31933,4419,26270,24428703,12009006,571868,,11437138,833959
2021-12-06,38632,19144,2715,16758,24467335,12027860,588290,,11439570,850639
2021-12-07,60303,14853,4487,40949,24527638,12042441,598646,,11443795,891514
2021-12-08,73458,19058,4684,49713,24601096,12061222,613010,,11448212,941149
2021-12-09,74513,18280,4347,51866,24675609,12079193,626935,,11452258,992930
2021-12-10,77514,17590,4661,55251,24753123,12096502,639859,,11456643,1048100
2021-12-11,83203,20407,5843,56942,24836326,12116620,654409,,11462211,1104956
2021-12-12,60769,22699,4164,33863,24897095,12139039,672938,,11466101,1138730
2021-12-13,34940,11603,2415,20899,24932035,12150345,682116,,11468229,1159534
2021-12-14,101992,9002,3876,89070,25034027,12159036,687227,,11471809,1248484
2021-12-15,127708,12430,4516,110724,25161735,12171162,695131,,11476031,1359108
2021-12-16,139378,12470,4257,122634,25301113,12183346,703334,,11480012,1481643
2021-12-17,159190,12406,4527,142235,25460303,12195477,711204,,11484273,1623781
2021-12-18,175601,13524,4928,157104,25635904,12208707,719788,,11488919,1780790
2021-12-19,140449,18161,3937,118313,25776353,12226567,734004,,11492563,1898992
2021-12-20,106827,10305,2748,93727,25883180,12236604,741551,,11495053,1992621
2021-12-21,215406,12968,4325,198091,26098586,12249256,750187,,11499069,2190591
2021-12-22,237270,14427,5205,217754,26335856,12263383,759395,,11503988,2408227
2021-12-23,257795,11734,5095,240868,26593651,12274811,766028,,11508783,2648989
2021-12-24,223649,9465,4579,209537,26817300,12283979,770910,,11513069,2858410
2021-12-25,89740,3892,2514,83346,26907040,12287596,772283,,11515313,2941649
2021-12-26,11901,389,360,11142,26918941,12287693,772304,,11515389,2952661
2021-12-27,46948,1491,1116,44310,26965889,12288939,772672,,11516267,2996851
2021-12-28,144794,6101,4013,134617,27110683,12294746,774749,,11519997,3131337
2021-12-29,175478,9377,4586,161445,27286161,12303827,779536,,11524291,3292654
2021-12-30,200083,10136,5357,184548,27486244,12313660,784300,,11529360,3477068
2021-12-31,195224,10009,5811,179151,27681468,12323380,788489,,11534891,3656093
2022-01-01,96963,5384,3885,87367,27778431,12328455,789980,,11538475,3743311
2022-01-02,19456,944,933,17449,27797887,12329108,789982,,11539126,3760614
2022-01-03,88260,4774,4594,78811,27886147,12333572,790154,,11543418,3839272
2022-01-04,146387,6003,5327,135018,28032534,12339247,790817,,11548430,3974134
2022-01-05,177530,7637,7300,162419,28210064,12346530,791143,,11555387,4136393
2022-01-06,191564,7218,6791,177028,28401628,12353429,791559,,11561870,4313266
2022-01-07,191318,7971,7010,175523,28592946,12361056,792508,,11568548,4488616
2022-01-08,181701,8634,6647,165231,28774647,12369358,794482,,11574876,4653691
2022-01-09,131116,9871,7193,113959,28905763,12378907,797155,,11581752,4767490
2022-01-10,90565,5108,4490,80836,28996328,12383692,797763,,11585929,4848173
2022-01-11,138912,6168,6584,125454,29135240,12389513,797334,,11592179,4973437
2022-01-12,157056,8169,8064,138700,29292296,12397353,797434,,11599919,5111969
2022-01-13,162699,9216,9221,141552,29454995,12406207,797415,,11608792,5253338
2022-01-14,159907,10757,10390,136069,29614902,12416602,797777,,11618825,5389209
2022-01-15,161221,11017,11679,135891,29776123,12427247,797104,,11630143,5524907
2022-01-16,109794,9296,9679,89458,29885917,12436181,796714,,11639467,5614147
2022-01-17,65794,5942,6568,52642,29951711,12441787,796078,,11645709,5666604
2022-01-18,36134,2010,2139,31162,29987845,12443442,795938,,11647504,5697570
2022-01-19,101340,5590,6724,85966,30089185,12448632,794786,,11653846,5783309
2022-01-20,103623,6329,7010,85746,30192808,12454577,794097,,11660480,5868832
2022-01-21,102122,6237,8060,82513,30294930,12460410,792260,,11668150,5951117
2022-01-22,102607,8729,12078,78123,30397537,12468750,788904,,11679846,6029012
2022-01-23,76711,7310,14000,54802,30474248,12475717,782207,,11693510,6083592
2022-01-24,42269,3199,7936,30746,30516517,12478552,777452,,11701100,6114131
2022-01-25,62583,3763,8374,48125,30579100,12481933,772826,,11709107,6162036
2022-01-26,77900,4921,13172,55696,30657000,12486477,764570,,11721907,6217490
2022-01-27,78092,4900,13251,56055,30735092,12491005,756209,,11734796,6273308
2022-01-28,77300,4678,13679,53904,30812392,12495325,747195,,11748130,6326993
2022-01-29,84838,5534,17719,58121,30897230,12500495,735003,,11765492,6384869
2022-01-30,66518,5026,20635,40160,30963748,12505179,719380,,11785799,6424804
2022-01-31,34758,2179,9889,22351,30998506,12507039,711661,,11795378,6446966
2022-02-01,51360,3269,9665,36531,31049866,12509955,705255,,11804700,6483272
2022-02-02,57729,3849,12406,38686,31107595,12513473,696683,,11816790,6521758
2022-02-03,52593,3612,11515,34305,31160188,12516708,688768,,11827940,6555812
2022-02-04,43105,2946,10569,27288,31203293,12519342,681135,,11838207,6582905
2022-02-05,58738,3752,14476,37566,31262031,12522762,670399,,11852363,6620258
2022-02-06,49869,3643,16120,29575,31311900,12526082,657917,,11868165,6649609
2022-02-07,23247,1695,7812,13448,31335147,12527451,651787,,11875664,6662833
2022-02-08,33415,2363,7256,21976,31368562,12529484,646887,,11882597,6684576
2022-02-09,38897,2788,8925,24411,31407459,12531913,640744,,11891169,6708735
2022-02-10,37551,2766,8840,22559,31445010,12534342,634666,,11899676,6731063
2022-02-11,39455,2725,10297,23007,31484465,12536719,627084,,11909635,6753831
2022-02-12,42059,2961,11460,25320,31526524,12539346,618574,,11920772,6778927
2022-02-13,36334,2805,13148,19943,31562858,12541864,608228,,11933636,6798672
2022-02-14,16987,1177,6124,9475,31579845,12542766,603273,,11939493,6807947
2022-02-15,19374,1389,4760,11880,31599219,12543831,599892,,11943939,6819600
2022-02-16,26035,1768,7741,14949,31625254,12545302,593915,,11951387,6834348
2022-02-17,26777,1685,7528,14987,31652031,12546632,588063,,11958569,6849080
2022-02-18,23962,1357,6618,13682,31675993,12547672,582790,,11964882,6862553
2022-02-19,37846,1904,8344,26056,31713839,12549243,576345,,11972898,6888366
2022-02-20,32584,1500,7965,22809,31746423,12550442,569872,,11980570,6910970
2022-02-21,17506,914,3679,12759,31763929,12551060,567098,,11983962,6923517
2022-02-22,9114,431,1555,6958,31773043,12551201,565969,,11985232,6930264
2022-02-23,25351,1328,4801,17300,31798394,12552219,562489,,11989730,6947328
2022-02-24,24582,1402,5234,15486,31822976,12553299,558652,,11994647,6962571
2022-02-25,23114,1397,5138,14510,31846090,12554402,554904,,11999498,6976855
2022-02-26,25240,1386,5911,16560,31871330,12555478,550372,,12005106,6993189
2022-02-27,26965,1372,7374,17705,31898295,12556581,544359,,12012222,7010699
2022-02-28,10130,594,2531,6745,31908425,12556922,542414,,12014508,7017261
2022-03-01,13207,950,3152,8168,31921632,12557567,540202,,12017365,7025212
2022-03-02,15421,1165,3577,9622,31937053,12558470,537783,,12020687,7034656
2022-03-03,14306,1081,3228,8689,31951359,12559239,535628,,12023611,7043114
2022-03-04,14483,993,3446,8319,31965842,12559911,533171,,12026740,7051180
2022-03-05,18542,1278,5000,11188,31984384,12560879,529438,,12031441,7062144
2022-03-06,16522,1090,5526,9608,32000906,12561688,524996,,12036692,7071545
2022-03-07,5951,469,1862,3509,32006857,12561872,523596,,12038276,7074837
2022-03-08,7374,701,1947,4160,32014231,12562295,522343,,12039952,7078798
2022-03-09,11180,909,2741,6407,32025411,12562928,520505,,12042423,7085003
2022-03-10,12772,1046,3261,6842,32038183,12563697,518283,,12045414,7091632
2022-03-11,12895,905,3411,6867,32051078,12564313,515769,,12048544,7098283
2022-03-12,14695,1049,4191,8310,32065773,12565090,512624,,12052466,7106389
2022-03-13,14754,1091,4999,8336,32080527,12565890,508712,,12057178,7114488
2022-03-14,6337,451,2230,3500,32086864,12566069,506930,,12059139,7117774
2022-03-15,10203,793,2627,5975,32097067,12566572,505084,,12061488,7123535
2022-03-16,13073,936,3670,6954,32110140,12567218,502347,,12064871,7130258
2022-03-17,13204,1050,3966,6759,32123344,12567980,499424,,12068556,7136797
2022-03-18,11911,916,3148,6433,32135255,12568593,497182,,12071411,7143006
2022-03-19,14444,1005,4163,7903,32149699,12569318,494022,,12075296,7150690
2022-03-20,11754,992,3960,6374,32161453,12570038,491049,,12078989,7156856
2022-03-21,5059,415,1589,2814,32166512,12570194,489871,,12080323,7159467
2022-03-22,6717,552,1559,3894,32173229,12570459,488858,,12081601,7163146
2022-03-23,9977,789,2303,5196,32183206,12570932,487341,,12083591,7168101
2022-03-24,9299,723,2377,4615,32192505,12571391,485678,,12085713,7172512
2022-03-25,9234,782,2159,4754,32201739,12571910,484293,,12087617,7177054
2022-03-26,10936,938,2838,5507,32212675,12572571,482391,,12090180,7182342
2022-03-27,10230,912,3539,5301,32222905,12573223,479760,,12093463,7187432
2022-03-28,3584,322,1109,1987,32226489,12573304,478970,,12094334,7189224
2022-03-29,5353,500,1217,2693,32231842,12573519,478247,,12095272,7191695
2022-03-30,7859,748,1840,4124,32239701,12573988,477150,,12096838,7195594
2022-03-31,8657,690,1926,4415,32248358,12574389,475908,,12098481,7199787
2022-04-01,9320,802,1918,4890,32257678,12574899,474783,,12100116,7204438
2022-04-02,10448,886,2216,5573,32268126,12575498,473441,,12102057,7209794
2022-04-03,9213,880,2569,5067,32277339,12576121,471746,,12104375,7214659
2022-04-04,4205,388,1006,2407,32281544,12576247,471125,,12105122,7216862
2022-04-05,6085,601,1039,3054,32287629,12576507,470681,,12105826,7219640
2022-04-06,8386,716,1480,4384,32296015,12576932,469912,,12107020,7223797
2022-04-07,10357,733,1691,4838,32306372,12577365,468949,,12108416,7228392
2022-04-08,23999,812,1585,4837,32330371,12577899,468170,,12109729,7233013
2022-04-09,30504,971,1978,5894,32360875,12578572,467154,,12111418,7238684
2022-04-10,24873,976,2394,5336,32385748,12579289,465730,,12113559,7243818
2022-04-11,12578,386,877,2432,32398326,12579425,465235,,12114190,7246048
2022-04-12,28137,693,1024,3537,32426463,12579814,464897,,12114917,7249352
2022-04-13,37787,853,1562,4928,32464250,12580368,464184,,12116184,7254050
2022-04-14,37911,764,1619,4915,32502161,12580818,463326,,12117492,7258711
2022-04-15,43405,1234,2104,6726,32545566,12581754,462452,,12119302,7265200
2022-04-16,8098,357,651,1743,32553664,12581851,462156,,12119695,7266727
2022-04-17,21028,871,1925,4319,32574692,12582438,461095,,12121343,7270823
2022-04-18,5466,306,465,1290,32580158,12582457,460931,,12121526,7271872
2022-04-19,22662,615,775,3103,32602820,12582789,460762,,12122027,7274755
2022-04-20,40347,1063,1403,4620,32643167,12583526,460419,,12123107,7279111
2022-04-21,38762,943,1600,4685,32681929,12584173,459753,,12124420,7283562
2022-04-22,35640,1017,1437,4271,32717569,12584918,459326,,12125592,7287615
2022-04-23,34660,1005,1740,4714,32752229,12585639,458588,,12127051,7292090
2022-04-24,20818,1021,1891,3777,32773047,12586410,457715,,12128695,7295673
2022-04-25,8299,453,691,1707,32781346,12586594,457476,,12129118,7297164
2022-04-26,24625,734,948,3145,32805971,12587036,457256,,12129780,7300072
2022-04-27,33607,955,1372,3940,32839578,12587714,456831,,12130883,7303794
2022-04-28,32846,930,1420,3931,32872424,12588371,456332,,12132039,7307502
2022-04-29,32065,1098,1381,3909,32904489,12589171,456042,,12133129,7311182
2022-04-30,30296,926,1542,4025,32934785,12589799,455419,,12134380,7314971
2022-05-01,16759,770,1582,2970,32951544,12590271,454602,,12135669,7317697
2022-05-02,5937,309,526,1099,32957481,12590284,454381,,12135903,7318569
2022-05-03,20935,589,835,2347,32978416,12590568,454129,,12136439,7320677
2022-05-04,29418,800,1093,3290,33007834,12591058,453831,,12137227,7323718
2022-05-05,29102,872,1167,3125,33036936,12591617,453526,,12138091,7326598
2022-05-06,29102,1147,1287,2988,33066038,12592475,453381,,12139094,7329359
2022-05-07,28495,870,1266,3113,33094533,12593055,452980,,12140075,7332248
2022-05-08,16002,895,1310,2323,33110535,12593693,452563,,12141130,7334370
2022-05-09,5897,293,474,943,33116432,12593719,452375,,12141344,7335103
2022-05-10,21232,698,724,2120,33137664,12594099,452342,,12141757,7336963
2022-05-11,28956,837,1087,2656,33166620,12594604,452088,,12142516,7339348
2022-05-12,28249,799,1088,2517,33194869,12595106,451795,,12143311,7341624
2022-05-13,27599,879,1119,2469,33222468,12595674,451550,,12144124,7343836
2022-05-14,25695,807,1101,2610,33248163,12596168,451249,,12144919,7346192
2022-05-15,14853,751,1277,2058,33263016,12596647,450716,,12145931,7348031
2022-05-16,6387,326,533,1048,33269403,12596735,450505,,12146230,7348892
2022-05-17,19607,590,781,1743,33289010,12597009,450307,,12146702,7350386
2022-05-18,26549,876,1101,2278,33315559,12597620,450077,,12147543,7352448
2022-05-19,24447,684,1159,2164,33340006,12598037,449595,,12148442,7354395
2022-05-20,24273,801,1141,2218,33364279,12598567,449251,,12149316,7356393
2022-05-21,22408,692,1168,2351,33386687,12598949,448766,,12150183,7358501
2022-05-22,10564,549,894,1489,33397251,12599237,448416,,12150821,7359773
2022-05-23,4576,242,465,795,33401827,12599219,448191,,12151028,7360359
2022-05-24,2630,120,183,442,33404457,12599083,448126,,12150957,7360590
2022-05-25,19371,655,951,1955,33423828,12599471,447820,,12151651,7362334
2022-05-26,20658,665,953,1915,33444486,12599862,447526,,12152336,7364026
2022-05-27,21769,819,1063,2076,33466255,12600392,447279,,12153113,7365868
2022-05-28,19421,723,1168,2152,33485676,12600844,446831,,12154013,7367805
2022-05-29,12115,761,1285,1727,33497791,12601370,446300,,12155070,7369340
2022-05-30,4581,311,550,752,33502372,12601434,446057,,12155377,7369894
2022-05-31,13555,573,754,1668,33515927,12601705,445870,,12155835,7371322
2022-06-01,16619,704,976,1879,33532546,12602107,445596,,12156511,7372948
2022-06-02,14615,557,869,1679,33547161,12602352,445277,,12157075,7374386
2022-06-03,16112,699,1096,1818,33563273,12602771,444874,,12157897,7375984
2022-06-04,13328,647,1168,1845,33576601,12603160,444348,,12158812,7377627
2022-06-05,7870,587,1113,1432,33584471,12603498,443818,,12159680,7378867
2022-06-06,3295,207,446,641,33587766,12603456,443576,,12159880,7379306
2022-06-07,11231,477,729,1375,33598997,12603633,443319,,12160314,7380437
2022-06-08,14073,670,1014,1612,33613070,12604042,442970,,12161072,7381829
2022-06-09,13388,663,929,1678,33626458,12604417,442699,,12161718,7383275
2022-06-10,13859,686,1071,1699,33640317,12604815,442305,,12162510,7384744
2022-06-11,12988,616,1031,1848,33653305,12605145,441888,,12163257,7386369
2022-06-12,8100,643,1238,1504,33661405,12605529,441289,,12164240,7387666
2022-06-13,3191,284,422,713,33664596,12605545,441146,,12164399,7388169
2022-06-14,10133,513,666,1266,33674729,12605769,440987,,12164782,7389197
2022-06-15,13513,474,833,1622,33688242,12605946,440626,,12165320,7390580
2022-06-16,12553,498,858,1619,33700795,12606137,440260,,12165877,7391952
2022-06-17,11694,479,819,1653,33712489,12606327,439913,,12166414,7393367
2022-06-18,11456,438,876,1861,33723945,12606494,439472,,12167022,7395004
2022-06-19,7006,485,899,1420,33730951,12606725,439057,,12167668,7396208
2022-06-20,2287,147,301,643,33733238,12606648,438897,,12167751,7396681
2022-06-21,9548,358,616,1387,33742786,12606719,438634,,12168085,7397820
2022-06-22,13619,407,729,1706,33756405,12606854,438305,,12168549,7399301
2022-06-23,13709,405,777,1684,33770114,12606992,437930,,12169062,7400771
2022-06-24,15368,436,812,1675,33785482,12607168,437550,,12169618,7402231
2022-06-25,14475,427,853,1714,33799957,12607333,437113,,12170220,7403735
2022-06-26,8161,432,886,1280,33808118,12607503,436652,,12170851,7404798
2022-06-27,3214,171,365,594,33811332,12607424,436454,,12170970,7405184
2022-06-28,9619,369,559,1226,33820951,12607506,436260,,12171246,7406176
2022-06-29,13327,416,733,1635,33834278,12607631,435941,,12171690,7407571
2022-06-30,12234,482,848,1581,33846512,12607828,435573,,12172255,7408918
2022-07-01,13043,550,972,1949,33859555,12608120,435146,,12172974,7410661
2022-07-02,1620,111,118,366,33861175,12607955,435137,,12172818,7410795
2022-07-03,5167,260,495,963,33866342,12607956,434893,,12173063,7411541
2022-07-04,2758,132,279,615,33869100,12607841,434745,,12173096,7411959
2022-07-05,11150,372,601,1577,33880250,12607915,434508,,12173407,7413288
2022-07-06,15962,549,860,2010,33896212,12608167,434191,,12173976,7415054
2022-07-07,15671,521,832,1928,33911883,12608399,433879,,12174520,7416729
2022-07-08,17892,555,871,2248,33929775,12608649,433562,,12175087,7418728
2022-07-09,14153,452,597,1851,33943928,12608822,433416,,12175406,7420341
2022-07-10,8753,475,755,1506,33952681,12609047,433135,,12175912,7421639
2022-07-11,4095,199,331,871,33956776,12608979,433000,,12175979,7422288
2022-07-12,12113,411,527,1659,33968889,12609091,432879,,12176212,7423693
2022-07-13,16723,565,773,2144,33985612,12609358,432665,,12176693,7425592
2022-07-14,16863,483,676,2024,34002475,12609535,432461,,12177074,7427376
2022-07-15,28903,598,824,2187,34031378,12609832,432234,,12177598,7429321
2022-07-16,30306,586,775,2331,34061684,12610104,432037,,12178067,7431399
2022-07-17,22939,539,637,1895,34084623,12610404,431936,,12178468,7433098
2022-07-18,11398,189,255,857,34096021,12610324,431865,,12178459,7433732
2022-07-19,28964,593,592,2141,34124985,12610641,431863,,12178778,7435641
2022-07-20,37647,839,924,2598,34162632,12611199,431773,,12179426,7438000
2022-07-21,36371,734,812,2812,34199003,12611644,431688,,12179956,7440570
2022-07-22,35812,824,895,2689,34234815,12612178,431610,,12180568,7443021
2022-07-23,35159,821,914,2837,34269974,12612683,431509,,12181174,7445601
2022-07-24,21743,599,806,1780,34291717,12613019,431299,,12181720,7447156
2022-07-25,11938,307,311,1083,34303655,12613040,431290,,12181750,7448007
2022-07-26,26100,621,605,2215,34329755,12613376,431305,,12182071,7449978
2022-07-27,32482,810,850,2655,34362237,12613927,431263,,12182664,7452421
2022-07-28,31547,724,884,2612,34393784,12614352,431099,,12183253,7454780
2022-07-29,30004,1791,875,2650,34423788,12615849,432011,,12183838,7457178
2022-07-30,25843,2526,747,2442,34449631,12618093,433788,,12184305,7459386
2022-07-31,14320,1067,541,1572,34463951,12618890,434310,,12184580,7460729
2022-08-01,5918,337,223,685,34469869,12618967,434422,,12184545,7461191
2022-08-02,4490,306,138,608,34474359,12619002,434586,,12184416,7461576
2022-08-03,22953,2640,741,2244,34497312,12621365,436481,,12184884,7463584
2022-08-04,22243,2481,684,2136,34519555,12623517,438272,,12185245,7465455
2022-08-05,21802,2755,747,2072,34541357,12625990,440272,,12185718,7467298
2022-08-06,19656,2875,657,2002,34561013,12628552,442484,,12186068,7469040
2022-08-07,12712,2236,621,1425,34573725,12630512,444093,,12186419,7470246
2022-08-08,4766,570,188,603,34578491,12630793,444468,,12186325,7470611
2022-08-09,14023,1467,560,1600,34592514,12631971,445369,,12186602,7471969
2022-08-10,19135,2363,716,1998,34611649,12634059,447014,,12187045,7473737
2022-08-11,17085,2042,718,1860,34628734,12635825,448336,,12187489,7475364
2022-08-12,16989,2049,735,1853,34645723,12637585,449649,,12187936,7476988
2022-08-13,15957,2224,766,1809,34661680,12639522,451105,,12188417,7478554
2022-08-14,9531,1621,619,1087,34671211,12640853,452103,,12188750,7479405
2022-08-15,3876,388,271,482,34675087,12640984,452217,,12188767,7479677
2022-08-16,10811,1075,516,1356,34685898,12641757,452774,,12188983,7480781
2022-08-17,16111,1834,740,1788,34702009,12643301,453866,,12189435,7482332
2022-08-18,14939,1640,752,1699,34716948,12644616,454750,,12189866,7483759
2022-08-19,15320,1848,750,1552,34732268,12646185,455844,,12190341,7485077
2022-08-20,14290,1641,742,1548,34746558,12647533,456737,,12190796,7486385
2022-08-21,9909,1533,661,1166,34756467,12648800,457605,,12191195,7487334
2022-08-22,4167,481,272,563,34760634,12648976,457811,,12191165,7487637
2022-08-23,11141,1248,555,1500,34771775,12649915,458500,,12191415,7488884
2022-08-24,14769,1807,873,2192,34786544,12651450,459434,,12192016,7490844
2022-08-25,14032,1716,780,2126,34800576,12652876,460363,,12192513,7492723
2022-08-26,13930,1687,816,2094,34814506,12654265,461227,,12193038,7494567
2022-08-27,12420,1487,878,2001,34826926,12655424,461830,,12193594,7496301
2022-08-28,7927,1260,622,1398,34834853,12656422,462466,,12193956,7497478
2022-08-29,3401,503,286,684,34838254,12656643,462678,,12193965,7497927
2022-08-30,9908,1167,652,1857,34848162,12657451,463187,,12194264,7499480
2022-08-31,13519,1627,946,2317,34861681,12658784,463864,,12194920,7501551
2022-09-01,12909,1720,914,2143,34874590,12660208,464665,,12195543,7503448
2022-09-02,15049,1616,995,4917,34889639,12661547,465278,,12196269,7508137
2022-09-03,14723,1526,924,5518,34904362,12662786,465877,,12196909,7513418
2022-09-04,8669,1009,677,3238,34913031,12663528,466199,,12197329,7516434
2022-09-05,3557,321,229,1387,34916588,12663582,466288,,12197294,7517598
2022-09-06,2471,157,116,1132,34919059,12663482,466326,,12197156,7518520
2022-09-07,10929,1020,588,3494,34929988,12664201,466754,,12197447,7521760
2022-09-08,10874,1022,527,2792,34940862,12664893,467246,,12197647,7524274
2022-09-09,9587,1013,489,2505,34950449,12665617,467765,,12197852,7526542
2022-09-10,10637,1264,552,3168,34961086,12666601,468470,,12198131,7529474
2022-09-11,9412,980,667,3739,34970498,12667330,468777,,12198553,7533002
2022-09-12,3128,295,205,1080,34973626,12667340,468860,,12198480,7533844
2022-09-13,6021,545,284,1133,34979647,12667595,469112,,12198483,7534731
2022-09-14,14484,799,436,1844,34994131,12668073,469471,,12198602,7536307
2022-09-15,15762,782,412,1534,35009893,12668534,469836,,12198698,7537569
2022-09-16,17761,766,448,1693,35027654,12669037,470148,,12198889,7539038
2022-09-17,17623,723,458,1668,35045277,12669453,470409,,12199044,7540449
2022-09-18,11214,773,451,1688,35056491,12669962,470729,,12199233,7541911
2022-09-19,4979,404,288,670,35061470,12670092,470840,,12199252,7542366
2022-09-20,13774,443,332,948,35075244,12670220,470949,,12199271,7543051
2022-09-21,23047,648,410,1501,35098291,12670556,471182,,12199374,7544295
2022-09-22,22921,637,399,1382,35121212,12670883,471414,,12199469,7545414
2022-09-23,22952,727,603,1419,35144164,12671305,471533,,12199772,7546574
2022-09-24,21697,738,689,1499,35165861,12671748,471578,,12200170,7547837
2022-09-25,11321,595,703,1357,35177182,12672060,471464,,12200596,7548956
2022-09-26,4565,191,220,594,35181747,12671959,471429,,12200530,7549305
2022-09-27,37655,497,366,1498,35219402,12672185,471556,,12200629,7550575
2022-09-28,50973,731,670,1903,35270375,12672646,471616,,12201030,7552251
2022-09-29,48012,637,742,1838,35318387,12672958,471503,,12201455,7553809
2022-09-30,47275,677,807,2005,35365662,12673307,471371,,12201936,7555532
2022-10-01,34456,527,634,1549,35400118,12673524,471262,,12202262,7556813
2022-10-02,24247,736,1028,1712,35424365,12673962,470967,,12202995,7558271
2022-10-03,10871,238,231,613,35435236,12673907,470970,,12202937,7558645
2022-10-04,32199,477,460,1170,35467435,12674062,470983,,12203079,7559536
2022-10-05,40442,633,742,1562,35507877,12674371,470867,,12203504,7560831
2022-10-06,38697,610,653,1569,35546574,12674676,470822,,12203854,7562138
2022-10-07,42245,662,852,1742,35588819,12674990,470624,,12204366,7563578
2022-10-08,37402,782,1145,2121,35626221,12675439,470255,,12205184,7565423
2022-10-09,18813,548,727,1556,35645034,12675707,470073,,12205634,7566739
2022-10-10,6866,166,371,567,35651900,12675573,469865,,12205708,7567044
2022-10-11,4996,125,111,318,35656896,12675402,469874,,12205528,7567123
2022-10-12,35118,579,685,1429,35692014,12675645,469766,,12205879,7568260
2022-10-13,36765,643,859,1621,35728779,12675917,469546,,12206371,7569569
2022-10-14,36977,621,753,1541,35765756,12676202,469410,,12206792,7570828
2022-10-15,35455,714,1013,1628,35801211,12676622,469108,,12207514,7572205
2022-10-16,20663,654,1024,1593,35821874,12677003,468732,,12208271,7573565
2022-10-17,7356,206,477,541,35829230,12676919,468459,,12208460,7573862
2022-10-18,36430,454,503,1402,35865660,12677049,468405,,12208644,7574990
2022-10-19,49905,618,730,1983,35915565,12677363,468289,,12209074,7576721
2022-10-20,51294,621,650,2050,35966859,12677668,468257,,12209411,7578504
2022-10-21,52854,695,620,1937,36019713,12678032,468326,,12209706,7580170
2022-10-22,50869,750,905,2313,36070582,12678449,468166,,12210283,7582206
2022-10-23,30643,571,786,2121,36101225,12678702,467944,,12210758,7584062
2022-10-24,14134,232,271,978,36115359,12678628,467900,,12210728,7584779
2022-10-25,41376,472,489,1821,36156735,12678746,467880,,12210866,7586299
2022-10-26,51660,615,660,2124,36208395,12679023,467831,,12211192,7588141
2022-10-27,50120,603,768,2164,36258515,12679295,467658,,12211637,7590030
2022-10-28,49808,590,675,2095,36308323,12679521,467568,,12211953,7591814
2022-10-29,50608,733,779,2222,36358931,12679901,467518,,12212383,7593732
2022-10-30,28405,662,930,2038,36387336,12680273,467246,,12213027,7595522
2022-10-31,12440,200,234,777,36399776,12680188,467208,,12212980,7596061
2022-11-01,33097,338,198,1220,36432873,12680177,467342,,12212835,7596988
2022-11-02,44294,574,625,1903,36477167,12680415,467287,,12213128,7598588
2022-11-03,44195,540,606,1856,36521362,12680621,467216,,12213405,7600155
2022-11-04,44647,648,528,2030,36566009,12680961,467329,,12213632,7601928
2022-11-05,45213,647,753,2369,36611222,12681303,467220,,12214083,7604028
2022-11-06,26021,558,771,2098,36637243,12681516,467004,,12214512,7605825
2022-11-07,10711,242,235,877,36647954,12681463,467008,,12214455,7606458
2022-11-08,33490,486,397,1586,36681444,12681655,467094,,12214561,7607797
2022-11-09,40532,604,570,1966,36721976,12681934,467126,,12214808,7609487
2022-11-10,39181,620,548,1928,36761157,12682229,467192,,12215037,7611136
2022-11-11,43355,636,642,2209,36804512,12682543,467185,,12215358,7613066
2022-11-12,36854,638,593,2185,36841366,12682854,467222,,12215632,7614966
2022-11-13,24270,557,771,2278,36865636,12683110,467002,,12216108,7616986
2022-11-14,10968,232,205,1024,36876604,12683044,467028,,12216016,7617750
2022-11-15,33636,484,380,1696,36910240,12683156,467126,,12216030,7619131
2022-11-16,43543,799,584,2371,36953783,12683648,467335,,12216313,7621244
2022-11-17,38342,674,647,2241,36992125,12683978,467358,,12216620,7623192
2022-11-18,40630,723,530,2335,37032755,12684349,467547,,12216802,7625223
2022-11-19,39664,1004,1031,3060,37072419,12685001,467513,,12217488,7627974
2022-11-20,22425,658,719,2445,37094844,12685374,467448,,12217926,7630184
2022-11-21,8922,196,193,968,37103766,12685302,467446,,12217856,7630942
2022-11-22,26443,481,370,1513,37130209,12685413,467552,,12217861,7632132
2022-11-23,32089,685,668,2071,37162298,12685758,467566,,12218192,7633916
2022-11-24,31913,662,753,2086,37194211,12686099,467473,,12218626,7635734
2022-11-25,30754,763,827,1953,37224965,12686545,467403,,12219142,7637420
2022-11-26,30295,908,1194,2699,37255260,12687105,467108,,12219997,7639822
2022-11-27,18680,607,943,2088,37273940,12687398,466766,,12220632,7641646
2022-11-28,7541,190,282,788,37281481,12687280,466666,,12220614,7642166
2022-11-29,21028,421,454,1292,37302509,12687364,466629,,12220735,7643174
2022-11-30,27894,643,649,1841,37330403,12687679,466621,,12221058,7644730
2022-12-01,24810,593,682,1693,37355213,12687937,466528,,12221409,7646132
2022-12-02,25060,523,630,1777,37380273,12688123,466415,,12221708,7647619
2022-12-03,25559,587,782,1945,37405832,12688377,466210,,12222167,7649291
2022-12-04,15252,494,606,1702,37421084,12688528,466092,,12222436,7650693
2022-12-05,6877,167,157,746,37427961,12688395,466097,,12222298,7651185
2022-12-06,20356,419,353,1379,37448317,12688435,466157,,12222278,7652244
2022-12-07,24789,553,612,1672,37473106,12688660,466090,,12222570,7653637
2022-12-08,23164,564,520,1767,37496270,12688896,466132,,12222764,7655117
2022-12-09,23335,637,576,1633,37519605,12689191,466189,,12223002,7656466
2022-12-10,22581,508,603,1631,37542186,12689370,466091,,12223279,7657811
2022-12-11,14206,548,787,1567,37556392,12689642,465849,,12223793,7659142
2022-12-12,5507,149,156,595,37561899,12689492,465837,,12223655,7659492
2022-12-13,17799,375,371,1125,37579698,12689538,465839,,12223699,7660338
2022-12-14,21325,511,547,1454,37601023,12689744,465797,,12223947,7661539
2022-12-15,21976,530,603,1579,37622999,12689920,465722,,12224198,7662814
2022-12-16,16295,378,451,1031,37639294,12689967,465646,,12224321,7663566
2022-12-17,18703,554,510,1279,37657997,12690189,465688,,12224501,7664553
2022-12-18,12647,531,795,1307,37670644,12690430,465423,,12225007,7665600
2022-12-19,4587,131,116,450,37675231,12690217,465434,,12224783,7665757
2022-12-20,16217,499,450,1111,37691448,12690389,465475,,12224914,7666595
2022-12-21,18476,541,552,1303,37709924,12690617,465460,,12225157,7667625
2022-12-22,18608,574,591,1748,37728532,12690885,465443,,12225442,7669107
2022-12-23,15654,577,602,1716,37744186,12691097,465413,,12225684,7670520
2022-12-24,5341,224,173,675,37749527,12690998,465463,,12225535,7670905
2022-12-25,2445,153,154,480,37751972,12690837,465452,,12225385,7671115
2022-12-26,262,12,7,48,37752234,12690539,465452,,12225087,7670904
2022-12-27,2099,98,37,307,37754333,12690343,465509,,12224834,7670969
2022-12-28,8321,337,168,975,37762654,12690356,465673,,12224683,7671664
2022-12-29,13167,583,529,1601,37775821,12690593,465723,,12224870,7672967
2022-12-30,15824,667,658,1881,37791645,12690941,465729,,12225212,7674564
2022-12-31,11238,459,389,1356,37802883,12691035,465795,,12225240,7675606
2023-01-01,3910,201,219,562,37806793,12690913,465775,,12225138,7675886
2023-01-02,652,37,13,97,37807445,12690654,465798,,12224856,7675729
2023-01-03,8197,297,151,902,37815642,12690652,465938,,12224714,7676379
2023-01-04,14724,574,547,1547,37830366,12690932,465958,,12224974,7677669
2023-01-05,16120,643,535,1797,37846486,12691264,466058,,12225206,7679196
2023-01-06,18838,715,613,2047,37865324,12691672,466157,,12225515,7680978
2023-01-07,18525,701,639,2057,37883849,12692086,466214,,12225872,7682785
2023-01-08,11613,579,608,1633,37895462,12692401,466182,,12226219,7684187
2023-01-09,5299,215,196,664,37900761,12692301,466198,,12226103,7684585
2023-01-10,12163,414,317,787,37912924,12692399,466293,,12226106,7685097
2023-01-11,15546,458,370,1097,37928470,12692525,466375,,12226150,7685915
2023-01-12,14085,444,409,973,37942555,12692651,466409,,12226242,7686618
2023-01-13,14176,418,344,1041,37956731,12692803,466480,,12226323,7687426
2023-01-14,13394,471,451,1079,37970125,12692955,466494,,12226461,7688225
2023-01-15,9047,459,508,1055,37979172,12693120,466444,,12226676,7689032
2023-01-16,3746,146,130,479,37982918,12692979,466460,,12226519,7689258
2023-01-17,8855,265,179,654,37991773,12692897,466542,,12226355,7689619
2023-01-18,10268,349,273,762,38002041,12692940,466615,,12226325,7690108
2023-01-19,10593,315,318,761,38012634,12692949,466607,,12226342,7690612
2023-01-20,9839,319,273,717,38022473,12692970,466651,,12226319,7691067
2023-01-21,11311,354,401,905,38033784,12693012,466603,,12226409,7691710
2023-01-22,7570,343,405,819,38041354,12693082,466538,,12226544,7692290
2023-01-23,3382,143,131,288,38044736,12692976,466549,,12226427,7692359
2023-01-24,8291,226,166,553,38053027,12692878,466606,,12226272,7692630
2023-01-25,10312,346,299,664,38063339,12692945,466649,,12226296,7693060
2023-01-26,6728,236,206,469,38070067,12692876,466675,,12226201,7693274
2023-01-27,6912,237,197,498,38076979,12692794,466712,,12226082,7693500
2023-01-28,9354,314,339,695,38086333,12692808,466681,,12226127,7693938
2023-01-29,5973,234,341,694,38092306,12692755,466569,,12226186,7694377
2023-01-30,1901,88,80,215,38094207,12692546,466575,,12225971,7694333
2023-01-31,5885,156,152,414,38100092,12692381,466575,,12225806,7694463
2023-02-01,7304,248,250,494,38107396,12692365,466570,,12225795,7694734
2023-02-02,6487,297,242,503,38113883,12692379,466622,,12225757,7695008
2023-02-03,6551,197,194,463,38120434,12692303,466621,,12225682,7695231
2023-02-04,6731,233,307,544,38127165,12692262,466541,,12225721,7695541
2023-02-05,4178,199,291,485,38131343,12692173,466444,,12225729,7695789
2023-02-06,1834,90,98,212,38133177,12691957,466433,,12225524,7695731
2023-02-07,4967,160,182,384,38138144,12691802,466408,,12225394,7695853
2023-02-08,5771,212,206,430,38143915,12691725,466409,,12225316,7696033
2023-02-09,6124,211,244,439,38150039,12691651,466375,,12225276,7696230
2023-02-10,5092,158,208,373,38155131,12691571,466321,,12225250,7696397
2023-02-11,6056,186,261,458,38161187,12691463,466242,,12225221,7696589
2023-02-12,4085,220,342,409,38165272,12691425,466116,,12225309,7696770
2023-02-13,1483,57,87,146,38166755,12691224,466084,,12225140,7696699
2023-02-14,3949,131,179,310,38170704,12691063,466034,,12225029,7696748
2023-02-15,4542,119,191,286,38175246,12690902,465959,,12224943,7696796
2023-02-16,4917,175,284,400,38180163,12690789,465846,,12224943,7696948
2023-02-17,4984,180,211,344,38185147,12690710,465811,,12224899,7697072
2023-02-18,5119,233,295,487,38190266,12690669,465747,,12224922,7697326
2023-02-19,3354,132,244,373,38193620,12690526,465630,,12224896,7697470
2023-02-20,1424,63,54,158,38195044,12690326,465636,,12224690,7697406
2023-02-21,915,27,14,107,38195959,12690095,465645,,12224450,7697286
2023-02-22,4137,131,212,370,38200096,12689960,465558,,12224402,7697438
2023-02-23,4283,162,231,393,38204379,12689838,465482,,12224356,7697588
2023-02-24,3035,136,232,274,38207414,12689703,465382,,12224321,7697618
2023-02-25,5024,213,541,386,38212438,12689657,465052,,12224605,7697787
2023-02-26,3473,146,681,384,38215911,12689525,464513,,12225012,7697941
2023-02-27,1075,37,57,97,38216986,12689308,464488,,12224820,7697827
2023-02-28,2732,99,163,232,38219718,12689115,464422,,12224693,7697799
2023-03-01,3850,137,428,336,38223568,12688935,464125,,12224810,7697853
2023-03-02,4595,158,495,329,38228163,12688771,463777,,12224994,7697916
2023-03-03,4371,159,357,334,38232534,12688647,463576,,12225071,7697998
2023-03-04,4970,208,623,350,38237504,12688563,463158,,12225405,7698098
2023-03-05,2537,110,450,251,38240041,12688365,462817,,12225548,7698082
2023-03-06,1157,48,37,114,38241198,12688146,462825,,12225321,7697964
2023-03-07,3221,87,172,225,38244419,12687906,462735,,12225171,7697915
2023-03-08,4320,133,412,284,38248739,12687732,462454,,12225278,7697926
2023-03-09,4624,173,453,312,38253363,12687611,462168,,12225443,7697986
2023-03-10,3942,99,139,255,38257305,12687450,462125,,12225325,7698021
2023-03-11,4065,139,172,286,38261370,12687345,462088,,12225257,7698094
2023-03-12,2893,109,234,301,38264263,12687173,461954,,12225219,7698153
2023-03-13,862,29,32,106,38265125,12686950,461947,,12225003,7698039
2023-03-14,3080,100,109,257,38268205,12686765,461938,,12224827,7698054
2023-03-15,4099,138,163,313,38272304,12686641,461911,,12224730,7698137
2023-03-16,4027,176,234,277,38276331,12686488,461844,,12224644,7698143
2023-03-17,4292,168,202,311,38280623,12686349,461806,,12224543,7698181
2023-03-18,4363,144,194,298,38284986,12686208,461755,,12224453,7698229
2023-03-19,2722,128,233,256,38287708,12686101,461648,,12224453,7698273
2023-03-20,774,31,19,74,38288482,12685855,461658,,12224197,7698109
2023-03-21,2899,69,86,201,38291381,12685651,461636,,12224015,7698078
2023-03-22,3895,130,134,248,38295276,12685484,461629,,12223855,7698061
2023-03-23,3811,118,172,226,38299087,12685303,461569,,12223734,7698032
2023-03-24,3694,102,116,238,38302781,12685141,461553,,12223588,7698049
2023-03-25,4274,108,171,252,38307055,12684981,461483,,12223498,7698070
2023-03-26,2480,112,213,202,38309535,12684824,461376,,12223448,7698044
2023-03-27,915,48,32,68,38310450,12684640,461391,,12223249,7697907
2023-03-28,3109,87,79,203,38313559,12684436,461391,,12223045,7697862
2023-03-29,4173,125,137,225,38317732,12684275,461375,,12222900,7697841
2023-03-30,3838,108,164,211,38321570,12684105,461318,,12222787,7697801
2023-03-31,3987,140,109,222,38325557,12683966,461348,,12222618,7697787
2023-04-01,4196,135,147,226,38329753,12683829,461333,,12222496,7697784
2023-04-02,2183,59,123,172,38331936,12683590,461265,,12222325,7697700
2023-04-03,781,24,12,53,38332717,12683361,461275,,12222086,7697532
2023-04-04,3419,74,76,169,38336136,12683174,461271,,12221903,7697466
2023-04-05,4374,94,109,250,38340510,12682977,461253,,12221724,7697468
2023-04-06,3703,108,109,190,38344213,12682823,461250,,12221573,7697429
2023-04-07,4599,105,115,243,38348812,12682645,461237,,12221408,7697431
2023-04-08,836,23,11,54,38349648,12682416,461244,,12221172,7697269
2023-04-09,2441,81,103,161,38352089,12682269,461219,,12221050,7697238
2023-04-10,360,9,6,20,38352449,12682016,461216,,12220800,7697045
2023-04-11,2772,34,28,121,38355221,12681757,461221,,12220536,7696905
2023-04-12,6347,105,96,188,38361568,12681599,461223,,12220376,7696878
2023-04-13,6999,105,128,207,38368567,12681431,461192,,12220239,7696848
2023-04-14,6514,88,103,206,38375081,12681253,461169,,12220084,7696837
2023-04-15,6949,107,149,230,38382030,12681097,461125,,12219972,7696846
2023-04-16,3277,83,144,166,38385307,12680901,461060,,12219841,7696772
2023-04-17,864,12,13,49,38386171,12680680,461056,,12219624,7696628
2023-04-18,4786,101,77,161,38390957,12680501,461077,,12219424,7696546
2023-04-19,6568,117,99,177,38397525,12680339,461092,,12219247,7696479
2023-04-20,6391,102,153,210,38403916,12680190,461039,,12219151,7696472
2023-04-21,5774,85,76,133,38409690,12680006,461045,,12218961,7696376
2023-04-22,6392,95,91,180,38416082,12679840,461046,,12218794,7696339
2023-04-23,3301,119,147,170,38419383,12679720,461017,,12218703,7696300
2023-04-24,955,4,12,59,38420338,12679477,461007,,12218470,7696158
2023-04-25,4813,69,70,187,38425151,12679290,461006,,12218284,7696118
2023-04-26,6593,108,93,208,38431744,12679161,461020,,12218141,7696118
2023-04-27,6899,118,152,207,38438643,12679015,460981,,12218034,7696098
2023-04-28,6638,86,86,185,38445281,12678846,460979,,12217867,7696053
2023-04-29,6534,121,111,200,38451815,12678716,460985,,12217731,7696035
2023-04-30,2643,95,129,145,38454458,12678582,460950,,12217632,7695978
2023-05-01,1030,20,17,30,38455488,12678345,460948,,12217397,7695784
2023-05-02,4348,67,55,106,38459836,12678147,460955,,12217192,7695664
2023-05-03,5609,108,107,176,38465445,12678000,460950,,12217050,7695626
2023-05-04,8087,87,85,135,38473532,12677823,460949,,12216874,7695543
2023-05-05,13049,89,98,168,38486581,12677673,460937,,12216736,7695504
2023-05-06,15659,113,96,156,38502240,12677563,460952,,12216611,7695457
2023-05-07,6067,56,95,106,38508307,12677393,460909,,12216484,7695366
2023-05-08,2167,16,4,37,38510474,12677177,460918,,12216259,7695202
2023-05-09,12573,55,49,129,38523047,12676991,460921,,12216070,7695129
2023-05-10,14773,70,79,157,38537820,12676822,460910,,12215912,7695077
2023-05-11,13366,76,72,155,38551186,12676683,460913,,12215770,7695041
2023-05-12,13492,83,79,177,38564678,12676541,460915,,12215626,7695015
2023-05-13,11449,80,75,147,38576127,12676354,460916,,12215438,7694928
2023-05-14,4188,68,95,94,38580315,12676205,460885,,12215320,7694847
2023-05-15,1055,9,6,38,38581370,12676004,460882,,12215122,7694706
2023-05-16,8949,56,48,93,38590319,12675823,460884,,12214939,7694593
2023-05-17,11134,99,83,141,38601453,12675674,460896,,12214778,7694504
2023-05-18,10838,81,69,144,38612291,12675508,460907,,12214601,7694430
2023-05-19,10516,95,97,154,38622807,12675365,460901,,12214464,7694368
2023-05-20,9407,91,88,165,38632214,12675210,460903,,12214307,7694309
2023-05-21,3083,47,86,95,38635297,12675063,460862,,12214201,7694231
2023-05-22,971,14,11,30,38636268,12674859,460864,,12213995,7694069
2023-05-23,754,8,3,16,38637022,12674658,460868,,12213790,7693904
2023-05-24,8033,57,80,105,38645055,12674478,460844,,12213634,7693794
2023-05-25,9346,74,93,162,38654401,12674323,460823,,12213500,7693755
2023-05-26,7998,66,70,124,38662399,12674180,460819,,12213361,7693692
2023-05-27,8232,108,76,126,38670631,12674064,460849,,12213215,7693631
2023-05-28,2905,56,72,101,38673536,12673926,460830,,12213096,7693556
2023-05-29,972,13,11,30,38674508,12673727,460829,,12212898,7693393
2023-05-30,6072,60,50,113,38680580,12673560,460837,,12212723,7693304
2023-05-31,8174,92,94,122,38688754,12673418,460832,,12212586,7693229
2023-06-01,7403,69,92,125,38696157,12673270,460807,,12212463,7693161
2023-06-02,6342,52,49,121,38702499,12673092,460809,,12212283,7693071
2023-06-03,5491,70,63,123,38707990,12672922,460815,,12212107,7692983
2023-06-04,2052,47,78,77,38710042,12672771,460781,,12211990,7692883
2023-06-05,600,11,6,18,38710642,12672584,460784,,12211800,7692723
2023-06-06,4465,39,38,79,38715107,12672398,460782,,12211616,7692602
2023-06-07,5816,63,65,121,38720923,12672263,460776,,12211487,7692556
2023-06-08,5757,58,68,112,38726680,12672140,460763,,12211377,7692513
2023-06-09,6191,77,81,122,38732871,12672003,460757,,12211246,7692445
2023-06-10,5352,76,95,116,38738223,12671846,460733,,12211113,7692358
2023-06-11,2010,55,62,105,38740233,12671708,460721,,12210987,7692300
2023-06-12,691,11,7,38,38740924,12671540,460724,,12210816,7692180
2023-06-13,4228,54,58,104,38745152,12671386,460719,,12210667,7692108
2023-06-14,5470,72,83,118,38750622,12671233,460707,,12210526,7692034
2023-06-15,5111,72,75,121,38755733,12671066,460700,,12210366,7691947
2023-06-16,5697,70,64,121,38761430,12670916,460702,,12210214,7691877
2023-06-17,4121,63,62,114,38765551,12670761,460703,,12210058,7691797
2023-06-18,1561,41,61,98,38767112,12670600,460681,,12209919,7691721
2023-06-19,373,6,2,16,38767485,12670402,460683,,12209719,7691560
2023-06-20,3206,51,42,89,38770691,12670221,460689,,12209532,7691446
2023-06-21,3695,42,57,89,38774386,12670067,460670,,12209397,7691358
2023-06-22,3981,75,73,118,38778367,12669939,460670,,12209269,7691296
2023-06-23,4510,54,44,90,38782877,12669811,460678,,12209133,7691226
2023-06-24,3698,49,61,73,38786575,12669624,460663,,12208961,7691097
2023-06-25,1521,31,52,93,38788096,12669462,460640,,12208822,7691022
2023-06-26,511,11,9,24,38788607,12669300,460639,,12208661,7690887
2023-06-27,3119,80,45,91,38791726,12669163,460671,,12208492,7690792
2023-06-28,4074,69,60,91,38795800,12669035,460679,,12208356,7690704
2023-06-29,3984,64,72,84,38799784,12668919,460665,,12208254,7690633
2023-06-30,3836,74,61,128,38803620,12668791,460673,,12208118,7690580
2023-07-01,3222,51,88,118,38806842,12668626,460634,,12207992,7690514
2023-07-02,272,10,5,15,38807114,12668444,460638,,12207806,7690363
2023-07-03,380,7,5,26,38807494,12668286,460639,,12207647,7690249
2023-07-04,1244,18,14,49,38808738,12668108,460643,,12207465,7690123
2023-07-05,2391,56,40,70,38811129,12667977,460657,,12207320,7690035
2023-07-06,2535,38,69,85,38813664,12667805,460624,,12207181,7689937
2023-07-07,2825,53,46,71,38816489,12667687,460629,,12207058,7689860
2023-07-08,2421,64,43,94,38818910,12667549,460649,,12206900,7689774
2023-07-09,916,31,45,37,38819826,12667405,460635,,12206770,7689651
2023-07-10,289,4,2,15,38820115,12667201,460635,,12206566,7689483
2023-07-11,1793,34,20,59,38821908,12667043,460645,,12206398,7689382
2023-07-12,2321,49,52,86,38824229,12666910,460642,,12206268,7689304
2023-07-13,2288,52,68,67,38826517,12666772,460624,,12206148,7689208
2023-07-14,2029,64,49,60,38828546,12666663,460636,,12206027,7689119
2023-07-15,1945,52,56,77,38830491,12666543,460631,,12205912,7689047
2023-07-16,806,36,30,43,38831297,12666389,460637,,12205752,7688925
2023-07-17,193,5,1,11,38831490,12666234,460638,,12205596,7688797
2023-07-18,1308,42,44,56,38832798,12666084,460636,,12205448,7688690
2023-07-19,1797,55,51,57,38834595,12665971,460638,,12205333,7688606
2023-07-20,1613,77,57,61,38836208,12665878,460656,,12205222,7688508
2023-07-21,1735,54,40,50,38837943,12665763,460666,,12205097,7688406
2023-07-22,1510,38,62,76,38839453,12665642,460642,,12205000,7688331
2023-07-23,699,28,31,49,38840152,12665506,460637,,12204869,7688234
2023-07-24,235,11,2,15,38840387,12665357,460645,,12204712,7688104
2023-07-25,1085,48,25,51,38841472,12665206,460668,,12204538,7687974
2023-07-26,1347,49,49,41,38842819,12665099,460667,,12204432,7687873
2023-07-27,1287,68,47,55,38844106,12665012,460687,,12204325,7687790
2023-07-28,1449,46,47,58,38845555,12664878,460685,,12204193,7687688
2023-07-29,1308,50,49,69,38846863,12664756,460683,,12204073,7687607
2023-07-30,648,29,19,29,38847511,12664627,460692,,12203935,7687497
2023-07-31,229,6,4,15,38847740,12664484,460691,,12203793,7687377
2023-08-01,1116,47,32,35,38848856,12664380,460705,,12203675,7687277
2023-08-02,1435,73,55,56,38850291,12664279,460721,,12203558,7687189
2023-08-03,1155,61,38,47,38851446,12664184,460744,,12203440,7687096
2023-08-04,1297,46,48,60,38852743,12664073,460742,,12203331,7687013
2023-08-05,1319,48,50,49,38854062,12663969,460739,,12203230,7686926
2023-08-06,576,25,19,23,38854638,12663873,460745,,12203128,7686838
2023-08-07,245,8,4,9,38854883,12663753,460746,,12203007,7686737
2023-08-08,330,8,4,15,38855213,12663621,460747,,12202874,7686629
2023-08-09,1253,45,43,45,38856466,12663526,460748,,12202778,7686553
2023-08-10,1604,96,52,70,38858070,12663499,460790,,12202709,7686513
2023-08-11,1680,57,47,63,38859750,12663426,460800,,12202626,7686461
2023-08-12,1653,65,47,68,38861403,12663378,460818,,12202560,7686431
2023-08-13,797,28,32,32,38862200,12663289,460814,,12202475,7686356
2023-08-14,247,6,1,6,38862447,12663187,460817,,12202370,7686269
2023-08-15,1288,38,27,40,38863735,12663066,460827,,12202239,7686173
2023-08-16,1636,59,49,49,38865371,12663013,460836,,12202177,7686121
2023-08-17,1703,77,66,63,38867074,12662977,460846,,12202131,7686085
2023-08-18,1683,86,60,51,38868757,12662952,460871,,12202081,7686033
2023-08-19,1711,82,54,63,38870468,12662926,460898,,12202028,7686002
2023-08-20,839,57,44,32,38871307,12662891,460910,,12201981,7685955
2023-08-21,228,4,2,8,38871535,12662779,460911,,12201868,7685866
2023-08-22,1249,56,47,48,38872784,12662715,460920,,12201795,7685812
2023-08-23,1531,67,50,53,38874315,12662679,460937,,12201742,7685771
2023-08-24,1581,95,68,72,38875896,12662675,460964,,12201711,7685754
2023-08-25,1445,87,44,51,38877341,12662674,461006,,12201668,7685726
2023-08-26,1641,80,56,67,38878982,12662668,461030,,12201638,7685718
2023-08-27,792,29,44,49,38879774,12662633,461012,,12201621,7685711
2023-08-28,187,5,3,9,38879961,12662578,461014,,12201564,7685664
2023-08-29,920,51,31,43,38880881,12662574,461034,,12201540,7685657
2023-08-30,1374,125,64,69,38882255,12662640,461095,,12201545,7685672
2023-08-31,1460,99,90,81,38883715,12662694,461104,,12201590,7685714
2023-09-01,1482,100,82,97,38885197,12662787,461122,,12201665,7685806
2023-09-02,1253,77,62,65,38886450,12662859,461137,,12201722,7685867
2023-09-03,666,47,41,32,38887116,12662906,461143,,12201763,7685899
2023-09-04,144,2,0,9,38887260,12662908,461145,,12201763,7685908
2023-09-05,127,4,2,6,38887387,12662912,461147,,12201765,7685914
2023-09-06,940,48,37,57,38888327,12662960,461158,,12201802,7685971
2023-09-07,1104,55,36,65,38889431,12663015,461177,,12201838,7686036
