"report_date","previous_day_total_doses_administered","previous_day_at_least_one","previous_day_fully_vaccinated","previous_day_3doses","total_doses_administered","total_individuals_at_least_one","total_individuals_partially_vaccinated","total_doses_in_fully_vaccinated_individuals","total_individuals_fully_vaccinated","total_individuals_3doses"
2021-01-01,6252,6242,2,,32218,32163,32152,22,11,
2021-01-02,4616,4604,6,,36834,36715,36702,26,13,
2021-01-03,5396,5389,3,,42230,42104,42088,32,16,
2021-01-04,5996,5993,0,,48226,48096,48081,30,15,
2021-01-05,9687,9662,21,,57913,57756,57721,70,35,
2021-01-06,12793,12328,450,,70706,70081,69599,964,482,
2021-01-07,16220,15508,698,,86926,85588,84408,2360,1180,
2021-01-08,18040,17024,1003,,104966,102612,100429,4366,2183,
2021-01-09,19503,18426,1064,,124469,121037,117790,6494,3247,
2021-01-10,11374,11333,39,,135843,132362,129076,6572,3286,
2021-01-11,11712,11661,48,,147555,144023,140689,6668,3334,
2021-01-12,14469,14162,298,,162024,158177,154545,7264,3632,
2021-01-13,15438,13814,1594,,177462,171977,166753,10448,5224,
2021-01-14,19193,16740,2437,,196655,188711,181051,15320,7660,
2021-01-15,20077,18019,2038,,216732,206719,197021,19396,9698,
2021-01-16,17121,15937,1171,,233853,222640,211771,21738,10869,
2021-01-17,11261,10017,1237,,245114,232642,220538,24208,12104,
2021-01-18,6797,6713,74,,251911,239332,227157,24350,12175,
2021-01-19,11830,9721,2095,,263741,249032,234762,28540,14270,
2021-01-20,10804,7215,3572,,274545,256224,238383,35682,17841,
2021-01-21,10977,6856,4093,,285522,263064,241130,43868,21934,
2021-01-22,9041,4324,4697,,294563,267351,240722,53258,26629,
2021-01-23,7462,3044,4390,,302025,270365,239347,62036,31018,
2021-01-24,4390,1833,2536,,306415,272180,238626,67108,33554,
2021-01-25,5324,1050,4265,,311739,273198,235380,75636,37818,
2021-01-26,9394,2867,6499,,321133,276033,231717,88632,44316,
2021-01-27,9899,2866,7004,,331032,278870,227551,102638,51319,
2021-01-28,13123,5744,7337,,344155,284581,225925,117312,58656,
2021-01-29,10709,3294,7379,,354864,287844,221810,132068,66034,
2021-01-30,9194,2733,6424,,364058,290535,218080,144910,72455,
2021-01-31,3384,1570,1768,,367442,292071,217849,148444,74222,
2021-02-01,2127,489,1610,,369569,292526,216698,151656,75828,
2021-02-02,4421,1368,2996,,373990,293856,215036,157640,78820,
2021-02-03,6241,1721,4458,,380231,295536,212265,166542,83271,
2021-02-04,9097,1725,7293,,389328,297218,206660,181116,90558,
2021-02-05,8447,1469,6904,,397775,298647,201191,194912,97456,
2021-02-06,10671,1873,8737,,408446,300465,194281,212368,106184,
2021-02-07,7580,1731,5796,,416026,302156,190188,223936,111968,
2021-02-08,8222,3096,5081,,424248,305204,188168,234072,117036,
2021-02-09,15011,3860,11083,,439259,309022,180919,256206,128103,
2021-02-10,15515,4936,10518,,454774,313906,175310,277192,138596,
2021-02-11,16366,3899,12409,,471140,317753,166779,301948,150974,
2021-02-12,17678,2099,15528,,488818,319813,153331,332964,166482,
2021-02-13,16214,2446,13752,,505032,322214,141999,360430,180215,
2021-02-14,12883,924,11926,,517915,323090,130979,384222,192111,
2021-02-15,7863,486,7328,,525778,323528,124115,398826,199413,
2021-02-16,5996,1042,4903,,531774,324527,120234,408586,204293,
2021-02-17,10169,1610,8525,,541943,326093,113303,425580,212790,
2021-02-18,13875,2958,10873,,555818,329003,105370,447266,223633,
2021-02-19,18491,6213,12211,,574309,335164,99351,471626,235813,
2021-02-20,22633,11136,11444,,596942,346237,99018,494438,247219,
2021-02-21,17243,10386,6823,,614185,356563,102563,508000,254000,
2021-02-22,13590,8759,4777,,627775,365253,106525,517456,258728,
2021-02-23,17870,11126,6673,,645645,376323,110958,530730,265365,
2021-02-24,18579,13614,4884,,664224,389881,119674,540414,270207,
2021-02-25,20813,16491,4265,,685037,406306,131882,548848,274424,
2021-02-26,24914,21842,3010,,709951,428088,150691,554794,277397,
2021-02-27,27469,23586,3840,,737420,451610,170421,562378,281189,
2021-02-28,20588,19146,1407,,758008,470702,188148,565108,282554,
2021-03-01,18227,17030,1148,,776235,487670,204015,567310,283655,
2021-03-02,24693,22281,2327,,800928,509890,223954,571872,285936,
2021-03-03,30602,27966,2579,,831530,537805,249323,576964,288482,
2021-03-04,34701,32467,2147,,866231,570206,279627,581158,290579,
2021-03-05,40008,38173,1786,,906239,608331,316000,584662,292331,
2021-03-06,44161,41951,2172,,950400,650227,355765,588924,294462,
2021-03-07,32739,31560,1175,,983139,681713,386134,591158,295579,
2021-03-08,24040,22164,1861,,1007179,703809,406423,594772,297386,
2021-03-09,33300,29849,3423,,1040479,733592,432829,601526,300763,
2021-03-10,38349,34086,4218,,1078828,767604,462671,609866,304933,
2021-03-11,43987,40714,3234,,1122815,808252,500137,616230,308115,
2021-03-12,47717,46005,1689,,1170532,854193,544439,619508,309754,
2021-03-13,57940,55062,2851,,1228472,909184,596633,625102,312551,
2021-03-14,43425,42185,1222,,1271897,951286,637581,627410,313705,
2021-03-15,32815,31117,1682,,1304712,982344,667000,630688,315344,
2021-03-16,53964,51664,2282,,1358676,1033943,716360,635166,317583,
2021-03-17,61071,58530,2497,,1419747,1092407,772377,640060,320030,
2021-03-18,61562,59096,2437,,1481309,1151431,829017,644828,322414,
2021-03-19,64485,61152,3275,,1545794,1212505,886869,651272,325636,
2021-03-20,62579,59987,2560,,1608373,1272436,944288,656296,328148,
2021-03-21,44007,42480,1540,,1652380,1314851,985200,659302,329651,
2021-03-22,31003,30036,978,,1683383,1344799,1014226,661146,330573,
2021-03-23,54626,51852,2723,,1738009,1396556,1063323,666466,333233,
2021-03-24,76439,73257,3134,,1814448,1469723,1133413,672620,336310,
2021-03-25,82923,80342,2534,,1897371,1549986,1211199,677574,338787,
2021-03-26,87020,83490,3490,,1984391,1633395,1291170,684450,342225,
2021-03-27,80868,77914,2868,,2065259,1711206,1366178,690056,345028,
2021-03-28,67002,65412,1555,,2132261,1776528,1430002,693052,346526,
2021-03-29,51741,49050,2652,,2184002,1825498,1476366,698264,349132,
2021-03-30,73590,70178,3350,,2257592,1895599,1543158,704882,352441,
2021-03-31,93161,89508,3587,,2350753,1985009,1629034,711950,355975,
2021-04-01,89329,85447,3841,,2440082,2070358,1710595,719526,359763,
2021-04-02,93097,88866,4213,,2533179,2159138,1795214,727848,363924,
2021-04-03,61012,59333,1735,,2594191,2218380,1852772,731216,365608,
2021-04-04,72333,70677,1651,,2666524,2288946,1921745,734402,367201,
2021-04-05,53735,53264,470,,2720259,2342126,1974503,735246,367623,
2021-04-06,79592,77718,1890,,2799851,2419742,2050283,738918,369459,
2021-04-07,108017,104948,3056,,2907868,2524565,2152108,744914,372457,
2021-04-08,114087,110111,4028,,3021955,2634565,2258136,752858,376429,
2021-04-09,109864,105630,4304,,3131819,2740077,2359409,761336,380668,
2021-04-10,109256,105492,3854,,3241075,2845441,2460985,768912,384456,
2021-04-11,98634,95515,3259,,3339709,2940831,2553175,775312,387656,
2021-04-12,76077,75012,1158,,3415786,3015695,2626949,777492,388746,
2021-04-13,99483,96097,3402,,3515269,3111683,2719583,784200,392100,
2021-04-14,117055,113290,3650,,3632324,3224855,2829145,791420,395710,
2021-04-15,113572,109510,3899,,3745896,3334239,2934687,799104,399552,
2021-04-16,118093,113719,4194,,3863989,3447848,3044146,807404,403702,
2021-04-17,112428,107834,4454,,3976417,3555548,3147451,816194,408097,
2021-04-18,88751,86512,2102,,4065168,3641937,3231792,820290,410145,
2021-04-19,68978,67443,1453,,4134146,3709250,3297703,823094,411547,
2021-04-20,102124,98795,3122,,4236270,3807883,3393279,829208,414604,
2021-04-21,142055,137774,4045,,4378325,3945483,3526902,837162,418581,
2021-04-22,139510,135354,3914,,4517835,4080708,3658269,844878,422439,
2021-04-23,138227,131803,6176,,4656062,4212357,3783800,857114,428557,
2021-04-24,130306,126237,3894,,4786368,4338446,3906051,864790,432395,
2021-04-25,102024,98612,3180,,4888392,4436910,4001402,871016,435508,
2021-04-26,71008,69302,1558,,4959400,4506081,4069075,874012,437006,
2021-04-27,98521,95427,2900,,5057921,4601347,4161504,879686,439843,
2021-04-28,120589,115959,4437,,5178510,4717138,4272930,888416,444208,
2021-04-29,124500,119296,5051,,5303010,4836267,4387077,898380,449190,
2021-04-30,115837,110579,5015,,5418847,4946673,4492545,908256,454128,
2021-05-01,111317,107440,3654,,5530164,5053932,4596227,915410,457705,
2021-05-02,79150,76172,2865,,5609314,5129947,4669443,921008,460504,
2021-05-03,56797,55125,1599,,5666111,5184917,4722874,924086,462043,
2021-05-04,91940,88567,3285,,5758051,5273306,4808055,930502,465251,
2021-05-05,138010,133299,4619,,5896061,5406436,4936629,939614,469807,
2021-05-06,141844,136887,4819,,6037905,5543139,5068575,949128,474564,
2021-05-07,150304,145256,4840,,6188209,5688235,5208890,958690,479345,
2021-05-08,142479,137787,4440,,6330688,5825826,5342120,967412,483706,
2021-05-09,124820,121165,3484,,6455508,5946827,5459701,974252,487126,
2021-05-10,97818,95827,1885,,6553326,6042465,5553521,977888,488944,
2021-05-11,113549,108864,4497,,6666875,6151127,5657757,986740,493370,
2021-05-12,145062,138026,6886,,6811937,6288974,5788784,1000380,500190,
2021-05-13,142721,135326,7238,,6954658,6424125,5916771,1014708,507354,
2021-05-14,148882,138788,9922,,7103540,6562725,6045514,1034422,517211,
2021-05-15,159757,149705,9871,,7263297,6712243,6185236,1054014,527007,
2021-05-16,144373,136102,8064,,7407670,6848177,6313186,1069982,534991,
2021-05-17,114988,110889,3945,,7522658,6958877,6420017,1077720,538860,
2021-05-18,111356,100487,10666,,7634014,7059168,6509704,1098928,549464,
2021-05-19,149894,133477,16238,,7783908,7192493,6626865,1131256,565628,
2021-05-20,151590,131591,19778,,7935498,7323895,6738558,1170674,585337,
2021-05-21,165410,140899,24251,,8100908,7464613,6855102,1219022,609511,
2021-05-22,199465,172261,26976,,8300373,7636676,7000270,1272812,636406,
2021-05-23,139847,127474,12227,,8440220,7763972,7115401,1297142,648571,
2021-05-24,100303,93331,6827,,8540523,7857130,7201802,1310656,655328,
2021-05-25,90485,82997,7277,,8631008,7939964,7277426,1325076,662538,
2021-05-26,139800,113028,26508,,8770808,8052805,7363829,1377952,688976,
2021-05-27,152076,123055,28769,,8922884,8175703,7458027,1435352,717676,
2021-05-28,163885,132324,31252,,9086769,8307854,7558985,1497738,748869,
2021-05-29,153403,117139,36030,,9240172,8424843,7640000,1569686,784843,
2021-05-30,149736,119029,30479,,9389908,8543702,7728442,1630520,815260,
2021-05-31,99225,79830,19202,,9489133,8623362,7788964,1668796,834398,
2021-06-01,124219,90629,33251,,9613352,8713796,7846222,1735148,867574,
2021-06-02,145336,102165,42918,,9758688,8815780,7905357,1820846,910423,
2021-06-03,155389,99931,55177,,9914077,8915526,7949997,1931058,965529,
2021-06-04,181739,115549,65917,,10095816,9030876,7999518,2062716,1031358,
2021-06-05,172052,103449,68319,,10267868,9134127,8034535,2199184,1099592,
2021-06-06,163407,91880,71246,,10431275,9225829,8055061,2341536,1170768,
2021-06-07,119573,63065,56290,,10550848,9288697,8061714,2453966,1226983,
2021-06-08,161912,72465,89006,,10712760,9360973,8045064,2631818,1315909,
2021-06-09,181480,70818,110191,,10894240,9431614,8005595,2852038,1426019,
2021-06-10,185603,66437,118673,,11079843,9497848,7953247,3089202,1544601,
2021-06-11,204811,67530,136518,,11284654,9565192,7884155,3362074,1681037,
2021-06-12,199758,62688,136467,,11484412,9627698,7810286,3634824,1817412,
2021-06-13,190356,58902,130920,,11674768,9686425,7738173,3896504,1948252,
2021-06-14,137700,38702,98596,,11812468,9724931,7678188,4093486,2046743,
2021-06-15,189574,42628,146587,,12002042,9767340,7574107,4386466,2193233,
2021-06-16,206276,42443,163185,,12208318,9809587,7453272,4712630,2356315,
2021-06-17,210495,37955,171953,,12418813,9847327,7319151,5056352,2528176,
2021-06-18,217223,35376,181242,,12636036,9882513,7173187,5418652,2709326,
2021-06-19,215916,35509,179728,,12851952,9917816,7028874,5777884,2888942,
2021-06-20,186293,35583,150132,,13038245,9953201,6914235,6077932,3038966,
2021-06-21,120446,20837,99103,,13158691,9973843,6835866,6275954,3137977,
2021-06-22,204964,27533,176671,,13363655,10001182,6686643,6629078,3314539,
2021-06-23,230562,28644,201167,,13594217,10029626,6514028,7031196,3515598,
2021-06-24,227728,26688,200274,,13821945,10056118,6340356,7431524,3715762,
2021-06-25,251145,28006,222387,,14073090,10083922,6145892,7876060,3938030,
2021-06-26,261330,30022,230598,,14334420,10113718,5945231,8336974,4168487,
2021-06-27,205026,27808,176610,,14539446,10141344,5796357,8689974,4344987,
2021-06-28,199265,20959,177737,,14738711,10162105,5639506,9045198,4522599,
2021-06-29,250129,24502,224891,,14988840,10186366,5439030,9494672,4747336,
2021-06-30,275561,24184,250808,,15264401,10210347,5212332,9996030,4998015,
2021-07-01,271985,25315,246114,,15536386,10235444,4991454,10487980,5243990,
2021-07-02,144742,11597,132913,,15681128,10246867,4870066,10753602,5376801,
2021-07-03,216912,19939,196742,,15898040,10266584,4693190,11146788,5573394,
2021-07-04,196238,19472,176539,,16094278,10285870,4536056,11499628,5749814,
2021-07-05,148734,12453,136136,,16243012,10298133,4412311,11771644,5885822,
2021-07-06,220053,20003,199832,,16463065,10317920,4232412,12171016,6085508,
2021-07-07,246636,22976,223413,,16709701,10340670,4031897,12617546,6308773,
2021-07-08,231235,21373,209645,,16940936,10361837,3843554,13036566,6518283,
2021-07-09,227021,21519,205331,,17167957,10383154,3659672,13446964,6723482,
2021-07-10,209079,20546,188376,,17377036,10403496,3491775,13823442,6911721,
2021-07-11,171692,17590,153974,,17548728,10420885,3355337,14131096,7065548,
2021-07-12,123139,11445,111593,,17671867,10432141,3255137,14354008,7177004,
2021-07-13,178536,19047,159345,,17850403,10450966,3114772,14672388,7336194,
2021-07-14,180053,19308,160586,,18030456,10470059,2973442,14993234,7496617,
2021-07-15,167224,19594,147453,,18197680,10489442,2845536,15287812,7643906,
2021-07-16,169384,19925,149305,,18367064,10509165,2716107,15586116,7793058,
2021-07-17,173036,20280,152625,,18540100,10529196,2583705,15890982,7945491,
2021-07-18,133653,15946,117568,,18673753,10544958,2482047,16125822,8062911,
2021-07-19,91993,10422,81463,,18765746,10555167,2410968,16288398,8144199,
2021-07-20,133554,16962,116538,,18899300,10571889,2311328,16521122,8260561,
2021-07-21,140095,16988,123037,,19039395,10588662,2205226,16766872,8383436,
2021-07-22,125653,17670,107844,,19165048,10606108,2115005,16982206,8491103,
2021-07-23,120294,17003,103083,,19285342,10622870,2028883,17187974,8593987,
2021-07-24,126711,18339,108134,,19412053,10641006,1939048,17403916,8701958,
2021-07-25,103660,14873,88656,,19515713,10655655,1865222,17580866,8790433,
2021-07-26,66701,9894,56712,,19582414,10665332,1818367,17693930,8846965,
2021-07-27,92405,15329,76916,,19674819,10680400,1756736,17847328,8923664,
2021-07-28,93961,16477,77413,,19768780,10696642,1695756,18001772,9000886,
2021-07-29,89418,16712,72543,,19858198,10713122,1639881,18146482,9073241,
2021-07-30,84085,16110,67861,,19942283,10729004,1588090,18281828,9140914,
2021-07-31,83886,15742,67996,,20026169,10744528,1535808,18417440,9208720,
2021-08-01,61887,11327,50374,,20088056,10755629,1496726,18517806,9258903,
2021-08-02,42505,7427,34957,,20130561,10762858,1469164,18587388,9293694,
2021-08-03,33311,5965,27174,,20163872,10768590,1447932,18641316,9320658,
2021-08-04,61339,12381,48766,,20225211,10780736,1411510,18738452,9369226,
2021-08-05,59474,12560,46761,,20284685,10793088,1377265,18831646,9415823,
2021-08-06,56038,11863,43961,,20340723,10804691,1345136,18919110,9459555,
2021-08-07,62388,12139,50054,,20403111,10816569,1307178,19018782,9509391,
2021-08-08,48715,9285,39238,,20451826,10825626,1277202,19096848,9548424,
2021-08-09,30868,5942,24748,,20482694,10831354,1258369,19145970,9572985,
2021-08-10,49282,10522,38455,,20531976,10841596,1230402,19222388,9611194,
2021-08-11,48735,10770,37714,,20580711,10852119,1203427,19297384,9648692,
2021-08-12,49272,11212,37826,,20629983,10863080,1176771,19372618,9686309,
2021-08-13,49649,11741,37633,,20679632,10874580,1150849,19447462,9723731,
2021-08-14,51241,12143,38886,,20730873,10886473,1124080,19524786,9762393,
2021-08-15,41793,9863,31700,,20772666,10896134,1102213,19587842,9793921,
2021-08-16,26754,6194,20408,,20799420,10902105,1087973,19628264,9814132,
2021-08-17,40520,11066,29185,,20839940,10912921,1069830,19686182,9843091,
2021-08-18,41913,11981,29689,,20881853,10924660,1052090,19745140,9872570,
2021-08-19,45915,16547,29103,,20927768,10940956,1039506,19802900,9901450,
2021-08-20,46472,16309,29750,,20974240,10957009,1026038,19861942,9930971,
2021-08-21,47972,15154,32451,,21022212,10971903,1008708,19926390,9963195,
2021-08-22,34414,10818,23323,,21056626,10982474,996179,19972590,9986295,
2021-08-23,23228,7008,16001,,21079854,10989247,987165,20004164,10002082,
2021-08-24,37661,13378,23825,,21117515,11002371,976695,20051352,10025676,
2021-08-25,41376,14428,26336,,21158891,11016543,964768,20103550,10051775,
2021-08-26,39293,13562,24986,,21198184,11029829,953309,20153040,10076520,
2021-08-27,37690,12952,23692,,21235874,11042540,942542,20199996,10099998,
2021-08-28,40141,13430,25531,,21276015,11055691,930417,20250548,10125274,
2021-08-29,30569,10257,19948,,21306584,11065716,920707,20290018,10145009,
2021-08-30,18245,6144,11848,,21324829,11071612,914974,20313276,10156638,
2021-08-31,32723,11942,19626,,21357552,11083286,907262,20352048,10176024,
2021-09-01,36265,12956,21963,,21393817,11096009,898239,20395540,10197770,
2021-09-02,37795,15651,19676,,21431612,11111408,894189,20434438,10217219,
2021-09-03,46905,21104,22449,,21478517,11132263,892825,20478876,10239438,
2021-09-04,46897,20595,24784,,21525414,11152612,888613,20527998,10263999,
2021-09-05,33094,14211,18587,,21558508,11166579,884217,20564724,10282362,
2021-09-06,21729,9493,12043,,21580237,11175823,881650,20588346,10294173,
2021-09-07,15022,6733,8103,,21595259,11182299,880263,20604072,10302036,
2021-09-08,41158,17118,20940,,21636417,11199153,876423,20645460,10322730,
2021-09-09,41474,16991,19685,,21677891,11215867,873704,20684326,10342163,
2021-09-10,39674,15518,19021,,21717565,11231122,870183,20721878,10360939,
2021-09-11,42399,15942,23344,,21759964,11246785,862760,20768050,10384025,
2021-09-12,29984,11537,17877,,21789948,11258028,856390,20803276,10401638,
2021-09-13,16097,6408,9188,,21806045,11264202,853595,20821214,10410607,
2021-09-14,29923,11567,15299,,21835968,11275467,849836,20851262,10425631,
2021-09-15,39289,14026,19427,,21875257,11289233,844419,20889628,10444814,
2021-09-16,39362,13993,19253,,21914619,11302991,839136,20927710,10463855,
2021-09-17,38947,13619,19347,,21953566,11316367,833396,20965942,10482971,
2021-09-18,41272,14091,23557,,21994838,11330185,823909,21012552,10506276,
2021-09-19,30672,10831,18989,,22025510,11340757,815738,21050038,10525019,
2021-09-20,16737,6100,10179,,22042247,11346603,811636,21069934,10534967,
2021-09-21,31370,11218,16996,,22073617,11357556,805842,21103428,10551714,
2021-09-22,41822,14820,22931,,22115439,11372080,797710,21148740,10574370,
2021-09-23,47239,16140,26036,,22162678,11387955,787795,21200320,10600160,
2021-09-24,46334,15641,26669,,22209012,11403336,776748,21253176,10626588,
2021-09-25,48212,15259,29956,,22257224,11418342,762032,21312620,10656310,
2021-09-26,37519,12424,24499,,22294743,11430491,749936,21361110,10680555,
2021-09-27,19166,6532,12327,,22313909,11436769,744125,21385288,10692644,
2021-09-28,30973,11296,17893,,22344882,11447806,737516,21420580,10710290,
2021-09-29,37898,12477,21735,,22382780,11460012,728238,21463548,10731774,
2021-09-30,37358,11660,21381,,22420138,11471413,718498,21505830,10752915,
2021-10-01,30889,9811,18419,,22451027,11480997,709877,21542240,10771120,
2021-10-02,37150,11160,23594,,22488177,11491887,697425,21588924,10794462,
2021-10-03,27212,8167,18326,,22515389,11499813,687253,21625120,10812560,
2021-10-04,14870,4748,9803,,22530259,11504314,682180,21644268,10822134,
2021-10-05,26853,8601,15890,,22557112,11512654,674876,21675556,10837778,
2021-10-06,31683,9643,18523,,22588795,11522038,665988,21712100,10856050,
2021-10-07,30362,9404,17125,,22619157,11531191,658254,21745874,10872937,
2021-10-08,32852,10745,18861,,22652009,11541665,650124,21783082,10891541,
2021-10-09,34160,10670,21028,,22686169,11552072,639752,21824640,10912320,
2021-10-10,23424,7662,15092,,22709593,11559483,632310,21854346,10927173,
2021-10-11,12007,3840,7868,,22721600,11563073,628266,21869614,10934807,
2021-10-12,5125,1631,3276,,22726725,11564426,626606,21875640,10937820,
2021-10-13,29125,9194,18100,,22755850,11573330,617684,21911292,10955646,
2021-10-14,29028,8905,17758,,22784878,11581959,608821,21946276,10973138,
2021-10-15,29111,8833,18176,,22813989,11590529,599465,21982128,10991064,
2021-10-16,31147,8989,19874,,22845136,11599227,588568,22021318,11010659,
2021-10-17,23723,7264,15386,,22868859,11606237,580433,22051608,11025804,
2021-10-18,12314,3747,8154,,22881173,11609703,576014,22067378,11033689,
2021-10-19,21291,6631,12646,,22902464,11616051,569986,22092130,11046065,
2021-10-20,25679,7542,14928,,22928143,11623346,562587,22121518,11060759,
2021-10-21,23189,6685,13038,,22951332,11629762,556223,22147078,11073539,
2021-10-22,26138,7319,15123,,22977470,11636758,548403,22176710,11088355,
2021-10-23,28195,7607,17167,,23005665,11644103,538836,22210534,11105267,
2021-10-24,19362,5729,12607,,23025027,11649576,531946,22235260,11117630,
2021-10-25,9933,2710,6477,,23034960,11652017,528171,22247692,11123846,
2021-10-26,18931,5395,11109,,23053891,11657134,522448,22269372,11134686,
2021-10-27,22871,6082,13224,,23076762,11662961,515292,22295338,11147669,
2021-10-28,22315,5792,12649,,23099077,11668465,508424,22320082,11160041,
2021-10-29,22826,5733,13059,,23121903,11673896,501083,22345626,11172813,
2021-10-30,24130,6050,14625,,23146033,11679674,492496,22374356,11187178,
2021-10-31,16491,4596,10609,,23162524,11683976,486478,22394996,11197498,
2021-11-01,7880,2085,5058,,23170404,11685781,483492,22404578,11202289,
2021-11-02,15633,4365,7749,,23186037,11689857,480097,22419520,11209760,
2021-11-03,18638,5070,9610,,23204675,11694624,475547,22438154,11219077,
2021-11-04,19517,4876,10041,,23224192,11699224,470367,22457714,11228857,
2021-11-05,21476,4405,9526,,23245668,11703340,465232,22476216,11238108,
2021-11-06,25345,5211,12158,,23271013,11708282,458268,22500028,11250014,
2021-11-07,21462,4027,8931,,23292475,11712028,453352,22517352,11258676,
2021-11-08,11995,2111,4735,,23304470,11713844,450712,22526264,11263132,
2021-11-09,24140,3855,7657,,23328610,11717378,446900,22540956,11270478,
2021-11-10,28490,4510,9005,,23357100,11721612,442391,22558442,11279221,
2021-11-11,28781,4312,9106,,23385881,11725627,437588,22576078,11288039,
2021-11-12,26756,4166,8248,,23412637,11729502,433492,22592020,11296010,
2021-11-13,34321,5083,11416,,23446958,11734279,427150,22614258,11307129,
2021-11-14,23232,3901,8614,,23470190,11737917,422430,22630974,11315487,
2021-11-15,12705,2187,4496,,23482895,11739844,420113,22639462,11319731,
2021-11-16,26194,3935,7491,,23509089,11743523,416553,22653940,11326970,
2021-11-17,31187,4046,7834,,23540276,11747287,412755,22669064,11334532,
2021-11-18,32517,3868,7535,,23572793,11750848,409074,22683548,11341774,
2021-11-19,35490,3866,7761,,23608283,11754413,405167,22698492,11349246,
2021-11-20,40125,4383,8826,,23648408,11758514,400715,22715598,11357799,
2021-11-21,28130,3439,6954,,23676538,11761691,397186,22729010,11364505,
2021-11-22,14903,1951,3897,,23691441,11763365,395234,22736262,11368131,
2021-11-23,33069,3280,6018,,23724510,11766365,392488,22747754,11373877,
2021-11-24,42680,3762,6819,,23767190,11769823,389420,22760806,11380403,
2021-11-25,46053,3936,6578,,23813243,11773484,386775,22773418,11386709,
2021-11-26,52870,11348,6618,,23866113,11784561,391498,22786126,11393063,
2021-11-27,63533,22361,7043,,23929646,11806641,406806,22799670,11399835,
2021-11-28,51467,27742,5322,,23981113,11834091,429214,22809754,11404877,
2021-11-29,33532,18933,2887,,24014645,11852763,445249,22815028,11407514,
2021-11-30,56058,20692,5144,,24070703,11873174,460787,22824774,11412387,
2021-12-01,69556,26244,5647,,24140259,11899112,481370,22835484,11417742,
2021-12-02,71644,26489,5042,,24211903,11925303,502804,22844998,11422499,
2021-12-03,73436,25100,5175,,24285339,11950107,522723,22854768,11427384,
2021-12-04,81168,27786,6080,47282,24366507,11977599,544420,,11433179,807800
2021-12-05,62645,31934,4420,26270,24429152,12009238,571926,,11437312,833966
2021-12-06,38633,19145,2715,16758,24467785,12028093,588349,,11439744,850646
2021-12-07,60303,14853,4487,40949,24528088,12042674,598705,,11443969,891521
2021-12-08,73459,19058,4685,49713,24601547,12061455,613068,,11448387,941156
2021-12-09,74514,18280,4347,51867,24676061,12079426,626993,,11452433,992938
2021-12-10,77515,17590,4661,55252,24753576,12096735,639917,,11456818,1048109
2021-12-11,83207,20409,5844,56943,24836783,12116855,654468,,11462387,1104966
2021-12-12,60770,22699,4164,33864,24897553,12139274,672997,,11466277,1138741
2021-12-13,34940,11603,2415,20899,24932493,12150580,682175,,11468405,1159545
2021-12-14,101993,9002,3876,89071,25034486,12159271,687286,,11471985,1248496
2021-12-15,127709,12430,4516,110725,25162195,12171397,695190,,11476207,1359121
2021-12-16,139378,12470,4257,122634,25301573,12183581,703393,,11480188,1481656
2021-12-17,159193,12407,4527,142237,25460766,12195713,711264,,11484449,1623796
2021-12-18,175603,13524,4928,157104,25636369,12208943,719848,,11489095,1780805
2021-12-19,140451,18161,3937,118315,25776820,12226803,734064,,11492739,1899009
2021-12-20,106828,10305,2748,93727,25883648,12236840,741611,,11495229,1992638
2021-12-21,215405,12968,4324,198091,26099053,12249492,750248,,11499244,2190608
2021-12-22,237272,14427,5206,217755,26336325,12263619,759455,,11504164,2408245
2021-12-23,257796,11734,5095,240869,26594121,12275047,766088,,11508959,2649008
2021-12-24,223651,9465,4580,209538,26817772,12284215,770969,,11513246,2858430
2021-12-25,89742,3892,2515,83347,26907514,12287832,772341,,11515491,2941670
2021-12-26,11901,389,360,11142,26919415,12287929,772362,,11515567,2952682
2021-12-27,46949,1491,1116,44311,26966364,12289175,772730,,11516445,2996873
2021-12-28,144794,6101,4013,134617,27111158,12294982,774807,,11520175,3131359
2021-12-29,175481,9378,4589,161445,27286639,12304064,779592,,11524472,3292676
2021-12-30,200085,10136,5359,184548,27486724,12313897,784354,,11529543,3477090
2021-12-31,195227,10010,5813,179151,27681951,12323618,788542,,11535076,3656115
2022-01-01,96964,5384,3887,87366,27778915,12328693,790031,,11538662,3743332
2022-01-02,19456,944,933,17449,27798371,12329346,790033,,11539313,3760635
2022-01-03,88261,4774,4595,78811,27886632,12333810,790204,,11543606,3839293
2022-01-04,146388,6003,5327,135019,28033020,12339485,790867,,11548618,3974156
2022-01-05,177532,7637,7302,162419,28210552,12346768,791191,,11555577,4136415
2022-01-06,191565,7218,6791,177029,28402117,12353667,791607,,11562060,4313289
2022-01-07,191321,7972,7011,175524,28593438,12361295,792556,,11568739,4488640
2022-01-08,181703,8634,6649,165231,28775141,12369597,794528,,11575069,4653715
2022-01-09,131119,9872,7194,113960,28906260,12379147,797201,,11581946,4767515
2022-01-10,90566,5108,4490,80837,28996826,12383932,797809,,11586123,4848199
2022-01-11,138916,6169,6584,125457,29135742,12389754,797381,,11592373,4973466
2022-01-12,157056,8169,8064,138700,29292798,12397594,797481,,11600113,5111998
2022-01-13,162702,9216,9221,141554,29455500,12406448,797462,,11608986,5253369
2022-01-14,159911,10758,10391,136071,29615411,12416844,797824,,11619020,5389242
2022-01-15,161221,11017,11679,135891,29776632,12427489,797151,,11630338,5524940
2022-01-16,109795,9296,9680,89458,29886427,12436423,796760,,11639663,5614180
2022-01-17,65794,5942,6568,52642,29952221,12442029,796124,,11645905,5666637
2022-01-18,36135,2010,2139,31163,29988356,12443684,795984,,11647700,5697604
2022-01-19,101340,5590,6724,85966,30089696,12448874,794832,,11654042,5783343
2022-01-20,103624,6330,7010,85746,30193320,12454820,794144,,11660676,5868866
2022-01-21,102124,6237,8060,82515,30295444,12460653,792307,,11668346,5951153
2022-01-22,102607,8729,12078,78123,30398051,12468993,788951,,11680042,6029048
2022-01-23,76711,7310,14000,54802,30474762,12475960,782254,,11693706,6083628
2022-01-24,42270,3199,7937,30746,30517032,12478795,777498,,11701297,6114167
2022-01-25,62585,3763,8375,48126,30579617,12482176,772871,,11709305,6162073
2022-01-26,77900,4920,13172,55697,30657517,12486719,764614,,11722105,6217528
2022-01-27,78093,4900,13251,56056,30735610,12491247,756253,,11734994,6273347
2022-01-28,77302,4679,13679,53905,30812912,12495568,747240,,11748328,6327033
2022-01-29,84840,5535,17719,58122,30897752,12500739,735049,,11765690,6384910
2022-01-30,66522,5028,20636,40161,30964274,12505425,719427,,11785998,6424846
2022-01-31,34759,2179,9890,22351,30999033,12507285,711707,,11795578,6447008
2022-02-01,51361,3269,9665,36532,31050394,12510201,705301,,11804900,6483315
2022-02-02,57732,3850,12408,38686,31108126,12513720,696728,,11816992,6521801
2022-02-03,52593,3612,11515,34305,31160719,12516955,688813,,11828142,6555855
2022-02-04,43106,2947,10570,27288,31203825,12519590,681180,,11838410,6582948
2022-02-05,58738,3752,14476,37566,31262563,12523010,670444,,11852566,6620301
2022-02-06,49870,3643,16121,29575,31312433,12526330,657961,,11868369,6649652
2022-02-07,23248,1696,7812,13448,31335681,12527700,651832,,11875868,6662876
2022-02-08,33415,2363,7256,21977,31369096,12529733,646932,,11882801,6684620
2022-02-09,38898,2788,8925,24411,31407994,12532162,640789,,11891373,6708779
2022-02-10,37553,2766,8842,22559,31445547,12534591,634709,,11899882,6731107
2022-02-11,39455,2725,10297,23007,31485002,12536968,627127,,11909841,6753875
2022-02-12,42060,2961,11461,25320,31527062,12539595,618616,,11920979,6778971
2022-02-13,36336,2806,13148,19944,31563398,12542114,608271,,11933843,6798717
2022-02-14,16988,1177,6125,9475,31580386,12543016,603315,,11939701,6807992
2022-02-15,19377,1391,4760,11881,31599763,12544083,599936,,11944147,6819646
2022-02-16,26035,1768,7741,14949,31625798,12545554,593959,,11951595,6834394
2022-02-17,26778,1685,7529,14987,31652576,12546884,588106,,11958778,6849126
2022-02-18,23963,1357,6619,13682,31676539,12547924,582832,,11965092,6862599
2022-02-19,37847,1904,8344,26057,31714386,12549495,576387,,11973108,6888413
2022-02-20,32585,1500,7966,22809,31746971,12550694,569913,,11980781,6911017
2022-02-21,17507,914,3679,12760,31764478,12551312,567139,,11984173,6923565
2022-02-22,9115,431,1555,6958,31773593,12551453,566010,,11985443,6930312
2022-02-23,25352,1328,4802,17300,31798945,12552471,562529,,11989942,6947376
2022-02-24,24583,1402,5234,15487,31823528,12553551,558692,,11994859,6962620
2022-02-25,23114,1397,5138,14510,31846642,12554654,554944,,11999710,6976904
2022-02-26,25241,1386,5912,16560,31871883,12555730,550411,,12005319,6993238
2022-02-27,26966,1372,7374,17706,31898849,12556833,544398,,12012435,7010749
2022-02-28,10130,594,2531,6745,31908979,12557174,542453,,12014721,7017311
2022-03-01,13207,950,3152,8168,31922186,12557819,540241,,12017578,7025262
2022-03-02,15422,1165,3578,9622,31937608,12558722,537821,,12020901,7034706
2022-03-03,14307,1081,3228,8690,31951915,12559491,535666,,12023825,7043165
2022-03-04,14485,993,3446,8321,31966400,12560163,533209,,12026954,7051233
2022-03-05,18542,1278,5000,11188,31984942,12561131,529476,,12031655,7062197
2022-03-06,16523,1090,5526,9609,32001465,12561940,525034,,12036906,7071599
2022-03-07,5951,469,1862,3509,32007416,12562124,523634,,12038490,7074891
2022-03-08,7375,702,1947,4160,32014791,12562548,522382,,12040166,7078852
2022-03-09,11180,909,2741,6407,32025971,12563181,520544,,12042637,7085057
2022-03-10,12774,1047,3261,6843,32038745,12563951,518323,,12045628,7091687
2022-03-11,12896,906,3412,6867,32051641,12564568,515809,,12048759,7098338
2022-03-12,14696,1049,4192,8310,32066337,12565345,512663,,12052682,7106444
2022-03-13,14756,1091,4999,8336,32081093,12566145,508751,,12057394,7114543
2022-03-14,6337,451,2230,3500,32087430,12566324,506969,,12059355,7117829
2022-03-15,10203,793,2627,5975,32097633,12566826,505123,,12061703,7123589
2022-03-16,13074,937,3671,6954,32110707,12567473,502386,,12065087,7130312
2022-03-17,13204,1050,3966,6759,32123911,12568235,499463,,12068772,7136851
2022-03-18,11911,916,3148,6433,32135822,12568848,497221,,12071627,7143060
2022-03-19,14444,1005,4163,7903,32150266,12569573,494061,,12075512,7150744
2022-03-20,11754,992,3960,6374,32162020,12570293,491088,,12079205,7156910
2022-03-21,5059,415,1589,2814,32167079,12570449,489910,,12080539,7159521
2022-03-22,6718,552,1560,3894,32173797,12570714,488896,,12081818,7163200
2022-03-23,9979,789,2304,5197,32183776,12571187,487378,,12083809,7168156
2022-03-24,9299,723,2377,4615,32193075,12571646,485715,,12085931,7172567
2022-03-25,9235,782,2159,4755,32202310,12572165,484330,,12087835,7177110
2022-03-26,10936,938,2838,5507,32213246,12572826,482428,,12090398,7182398
2022-03-27,10231,912,3539,5302,32223477,12573478,479797,,12093681,7187489
2022-03-28,3585,322,1109,1988,32227062,12573559,479007,,12094552,7189282
2022-03-29,5353,500,1217,2693,32232415,12573774,478284,,12095490,7191753
2022-03-30,7860,748,1841,4124,32240275,12574242,477186,,12097056,7195651
2022-03-31,8657,690,1926,4415,32248932,12574643,475944,,12098699,7199844
2022-04-01,9321,803,1918,4890,32258253,12575154,474820,,12100334,7204495
2022-04-02,10448,886,2216,5573,32268701,12575753,473478,,12102275,7209851
2022-04-03,9213,880,2569,5067,32277914,12576376,471783,,12104593,7214716
2022-04-04,4205,388,1006,2407,32282119,12576502,471162,,12105340,7216919
2022-04-05,6085,601,1039,3054,32288204,12576762,470718,,12106044,7219697
2022-04-06,8388,717,1482,4384,32296592,12577188,469948,,12107240,7223854
2022-04-07,10357,733,1691,4838,32306949,12577621,468985,,12108636,7228449
2022-04-08,24001,812,1586,4837,32330950,12578155,468205,,12109950,7233070
2022-04-09,30504,971,1978,5894,32361454,12578828,467189,,12111639,7238741
2022-04-10,24873,976,2394,5336,32386327,12579545,465765,,12113780,7243875
2022-04-11,12578,386,877,2432,32398905,12579680,465270,,12114410,7246105
2022-04-12,28138,693,1024,3537,32427043,12580069,464932,,12115137,7249409
2022-04-13,37787,853,1562,4928,32464830,12580623,464219,,12116404,7254107
2022-04-14,37911,764,1619,4915,32502741,12581073,463361,,12117712,7258768
2022-04-15,43405,1234,2104,6726,32546146,12582009,462487,,12119522,7265257
2022-04-16,8099,357,651,1744,32554245,12582106,462191,,12119915,7266785
2022-04-17,21028,871,1925,4319,32575273,12582693,461130,,12121563,7270881
2022-04-18,5466,306,465,1290,32580739,12582712,460966,,12121746,7271930
2022-04-19,22662,615,775,3103,32603401,12583044,460797,,12122247,7274813
2022-04-20,40348,1063,1404,4620,32643749,12583781,460453,,12123328,7279169
2022-04-21,38762,943,1600,4685,32682511,12584428,459787,,12124641,7283620
2022-04-22,35642,1018,1438,4271,32718153,12585174,459360,,12125814,7287673
2022-04-23,34660,1005,1740,4714,32752813,12585895,458622,,12127273,7292148
2022-04-24,20818,1021,1891,3777,32773631,12586666,457749,,12128917,7295731
2022-04-25,8299,453,691,1707,32781930,12586850,457510,,12129340,7297222
2022-04-26,24625,734,948,3145,32806555,12587292,457290,,12130002,7300130
2022-04-27,33608,955,1373,3940,32840163,12587969,456864,,12131105,7303852
2022-04-28,32847,930,1421,3931,32873010,12588626,456364,,12132262,7307560
2022-04-29,32068,1098,1383,3910,32905078,12589426,456072,,12133354,7311241
2022-04-30,30296,926,1542,4025,32935374,12590054,455449,,12134605,7315030
2022-05-01,16759,770,1582,2970,32952133,12590525,454632,,12135893,7317756
2022-05-02,5937,309,526,1099,32958070,12590538,454411,,12136127,7318628
2022-05-03,20936,589,835,2348,32979006,12590822,454159,,12136663,7320737
2022-05-04,29418,800,1093,3290,33008424,12591312,453861,,12137451,7323778
2022-05-05,29102,872,1167,3125,33037526,12591871,453556,,12138315,7326658
2022-05-06,29102,1147,1287,2988,33066628,12592729,453411,,12139318,7329419
2022-05-07,28496,870,1267,3113,33095124,12593309,453009,,12140300,7332308
2022-05-08,16003,895,1310,2324,33111127,12593947,452592,,12141355,7334431
2022-05-09,5897,293,474,943,33117024,12593973,452404,,12141569,7335164
2022-05-10,21232,698,724,2120,33138256,12594353,452371,,12141982,7337024
2022-05-11,28957,838,1088,2656,33167213,12594859,452117,,12142742,7339409
2022-05-12,28249,799,1088,2517,33195462,12595361,451824,,12143537,7341685
2022-05-13,27599,879,1119,2469,33223061,12595929,451579,,12144350,7343897
2022-05-14,25697,807,1101,2611,33248758,12596423,451278,,12145145,7346254
2022-05-15,14855,751,1278,2059,33263613,12596902,450744,,12146158,7348094
2022-05-16,6387,326,533,1048,33270000,12596990,450533,,12146457,7348955
2022-05-17,19607,590,781,1743,33289607,12597264,450335,,12146929,7350449
2022-05-18,26548,876,1101,2278,33316155,12597875,450105,,12147770,7352511
2022-05-19,24447,684,1159,2164,33340602,12598292,449623,,12148669,7354458
2022-05-20,24273,801,1141,2218,33364875,12598822,449279,,12149543,7356456
2022-05-21,22408,692,1168,2351,33387283,12599204,448794,,12150410,7358564
2022-05-22,10565,549,895,1489,33397848,12599492,448443,,12151049,7359836
2022-05-23,4576,242,465,795,33402424,12599474,448218,,12151256,7360422
2022-05-24,2630,120,183,442,33405054,12599338,448153,,12151185,7360653
2022-05-25,19371,655,951,1955,33424425,12599726,447847,,12151879,7362397
2022-05-26,20659,665,953,1915,33445084,12600117,447553,,12152564,7364089
2022-05-27,21769,819,1063,2076,33466853,12600647,447306,,12153341,7365931
2022-05-28,19423,723,1169,2152,33486276,12601099,446857,,12154242,7367868
2022-05-29,12115,761,1285,1727,33498391,12601625,446326,,12155299,7369403
2022-05-30,4581,311,550,752,33502972,12601689,446083,,12155606,7369957
2022-05-31,13558,574,755,1669,33516530,12601961,445896,,12156065,7371386
2022-06-01,16619,704,976,1879,33533149,12602362,445622,,12156740,7373012
2022-06-02,14615,557,869,1679,33547764,12602607,445303,,12157304,7374450
2022-06-03,16112,699,1096,1818,33563876,12603024,444900,,12158124,7376046
2022-06-04,13328,647,1168,1845,33577204,12603413,444374,,12159039,7377689
2022-06-05,7871,587,1113,1432,33585075,12603751,443844,,12159907,7378929
2022-06-06,3295,207,446,641,33588370,12603709,443602,,12160107,7379368
2022-06-07,11233,477,729,1377,33599603,12603886,443345,,12160541,7380501
2022-06-08,14073,670,1014,1612,33613676,12604295,442996,,12161299,7381893
2022-06-09,13390,664,929,1679,33627066,12604671,442726,,12161945,7383340
2022-06-10,13860,686,1071,1700,33640926,12605069,442332,,12162737,7384810
2022-06-11,12988,616,1031,1848,33653914,12605399,441915,,12163484,7386435
2022-06-12,8100,643,1238,1504,33662014,12605783,441316,,12164467,7387732
2022-06-13,3192,284,422,714,33665206,12605799,441173,,12164626,7388236
2022-06-14,10133,513,666,1266,33675339,12606023,441014,,12165009,7389264
2022-06-15,13513,474,833,1622,33688852,12606200,440653,,12165547,7390647
2022-06-16,12554,498,858,1620,33701406,12606391,440287,,12166104,7392020
2022-06-17,11694,479,819,1653,33713100,12606581,439940,,12166641,7393435
2022-06-18,11457,438,876,1862,33724557,12606748,439499,,12167249,7395073
2022-06-19,7007,485,900,1420,33731564,12606979,439083,,12167896,7396277
2022-06-20,2287,147,301,643,33733851,12606902,438923,,12167979,7396750
2022-06-21,9550,358,617,1388,33743401,12606973,438659,,12168314,7397890
2022-06-22,13620,407,729,1707,33757021,12607108,438330,,12168778,7399372
2022-06-23,13709,405,777,1684,33770730,12607246,437955,,12169291,7400842
2022-06-24,15368,436,812,1675,33786098,12607422,437575,,12169847,7402302
2022-06-25,14475,427,853,1714,33800573,12607587,437138,,12170449,7403806
2022-06-26,8161,432,886,1280,33808734,12607757,436677,,12171080,7404869
2022-06-27,3214,171,365,594,33811948,12607678,436479,,12171199,7405255
2022-06-28,9619,369,559,1226,33821567,12607760,436285,,12171475,7406247
2022-06-29,13327,416,733,1635,33834894,12607885,435966,,12171919,7407642
2022-06-30,12234,482,848,1581,33847128,12608082,435598,,12172484,7408989
2022-07-01,13043,550,972,1949,33860171,12608374,435171,,12173203,7410732
2022-07-02,1620,111,118,366,33861791,12608209,435162,,12173047,7410866
2022-07-03,5167,260,495,963,33866958,12608210,434918,,12173292,7411612
2022-07-04,2758,132,279,615,33869716,12608095,434770,,12173325,7412030
2022-07-05,11150,372,601,1577,33880866,12608169,434533,,12173636,7413359
2022-07-06,15962,549,860,2010,33896828,12608421,434216,,12174205,7415125
2022-07-07,15672,521,832,1928,33912500,12608653,433904,,12174749,7416800
2022-07-08,17893,555,871,2248,33930393,12608903,433587,,12175316,7418799
2022-07-09,14154,452,597,1852,33944547,12609076,433441,,12175635,7420413
2022-07-10,8753,475,755,1506,33953300,12609301,433160,,12176141,7421711
2022-07-11,4095,199,331,871,33957395,12609233,433025,,12176208,7422360
2022-07-12,12113,411,527,1659,33969508,12609345,432904,,12176441,7423765
2022-07-13,16724,565,773,2144,33986232,12609612,432690,,12176922,7425664
2022-07-14,16863,483,676,2024,34003095,12609789,432486,,12177303,7427448
2022-07-15,28904,598,825,2187,34031999,12610086,432258,,12177828,7429393
2022-07-16,30306,586,775,2331,34062305,12610358,432061,,12178297,7431471
2022-07-17,22939,539,637,1895,34085244,12610658,431960,,12178698,7433170
2022-07-18,11398,189,255,857,34096642,12610578,431889,,12178689,7433804
2022-07-19,28964,593,592,2141,34125606,12610895,431887,,12179008,7435713
2022-07-20,37647,839,924,2598,34163253,12611453,431797,,12179656,7438072
2022-07-21,36372,734,812,2813,34199625,12611898,431712,,12180186,7440643
2022-07-22,35813,824,895,2690,34235438,12612432,431634,,12180798,7443095
2022-07-23,35160,821,914,2838,34270598,12612937,431533,,12181404,7445676
2022-07-24,21745,599,806,1780,34292343,12613273,431323,,12181950,7447231
2022-07-25,11938,307,311,1083,34304281,12613294,431314,,12181980,7448082
2022-07-26,26103,621,605,2218,34330384,12613630,431329,,12182301,7450056
2022-07-27,32482,810,850,2655,34362866,12614181,431287,,12182894,7452499
2022-07-28,31547,724,884,2612,34394413,12614606,431123,,12183483,7454858
2022-07-29,30005,1791,875,2651,34424418,12616103,432035,,12184068,7457257
2022-07-30,25845,2526,747,2443,34450263,12618347,433812,,12184535,7459466
2022-07-31,14320,1067,541,1572,34464583,12619143,434334,,12184809,7460809
2022-08-01,5918,337,223,685,34470501,12619220,434446,,12184774,7461271
2022-08-02,4492,307,138,609,34474993,12619256,434611,,12184645,7461657
2022-08-03,22954,2640,742,2244,34497947,12621619,436505,,12185114,7463665
2022-08-04,22244,2481,684,2137,34520191,12623771,438296,,12185475,7465537
2022-08-05,21803,2755,747,2073,34541994,12626244,440296,,12185948,7467381
2022-08-06,19657,2875,657,2003,34561651,12628806,442508,,12186298,7469124
2022-08-07,12712,2236,621,1425,34574363,12630766,444117,,12186649,7470330
2022-08-08,4766,570,188,603,34579129,12631047,444492,,12186555,7470695
2022-08-09,14023,1467,560,1600,34593152,12632225,445393,,12186832,7472053
2022-08-10,19136,2363,716,1999,34612288,12634313,447038,,12187275,7473822
2022-08-11,17085,2042,718,1860,34629373,12636079,448360,,12187719,7475449
2022-08-12,16989,2049,735,1853,34646362,12637839,449673,,12188166,7477073
2022-08-13,15961,2227,766,1810,34662323,12639779,451132,,12188647,7478640
2022-08-14,9531,1621,619,1087,34671854,12641109,452130,,12188979,7479490
2022-08-15,3876,388,271,482,34675730,12641240,452244,,12188996,7479762
2022-08-16,10812,1076,517,1356,34686542,12642013,452801,,12189212,7480865
2022-08-17,16111,1834,740,1788,34702653,12643557,453893,,12189664,7482416
2022-08-18,14939,1640,752,1699,34717592,12644872,454777,,12190095,7483843
2022-08-19,15321,1848,750,1553,34732913,12646441,455871,,12190570,7485162
2022-08-20,14290,1641,742,1548,34747203,12647788,456764,,12191024,7486469
2022-08-21,9909,1533,661,1166,34757112,12649055,457632,,12191423,7487418
2022-08-22,4167,481,272,563,34761279,12649231,457838,,12191393,7487721
2022-08-23,11143,1248,555,1500,34772422,12650170,458527,,12191643,7488968
2022-08-24,14769,1807,873,2192,34787191,12651705,459461,,12192244,7490928
2022-08-25,14032,1716,780,2126,34801223,12653131,460390,,12192741,7492807
2022-08-26,13931,1687,816,2094,34815154,12654520,461254,,12193266,7494651
2022-08-27,12421,1487,878,2002,34827575,12655679,461857,,12193822,7496386
2022-08-28,7928,1260,622,1398,34835503,12656677,462493,,12194184,7497563
2022-08-29,3401,503,286,684,34838904,12656898,462705,,12194193,7498012
2022-08-30,9908,1167,652,1857,34848812,12657706,463214,,12194492,7499565
2022-08-31,13519,1627,946,2317,34862331,12659038,463891,,12195147,7501636
2022-09-01,12910,1720,915,2143,34875241,12660462,464691,,12195771,7503533
2022-09-02,15050,1616,996,4917,34890291,12661801,465303,,12196498,7508222
2022-09-03,14723,1526,924,5518,34905014,12663040,465902,,12197138,7513503
2022-09-04,8670,1009,677,3239,34913684,12663782,466224,,12197558,7516520
2022-09-05,3557,321,229,1387,34917241,12663835,466313,,12197522,7517683
2022-09-06,2472,157,116,1133,34919713,12663735,466351,,12197384,7518606
2022-09-07,10929,1020,588,3494,34930642,12664454,466779,,12197675,7521846
2022-09-08,10875,1023,528,2792,34941517,12665147,467271,,12197876,7524360
2022-09-09,9587,1013,489,2505,34951104,12665871,467790,,12198081,7526628
2022-09-10,10638,1265,553,3168,34961742,12666856,468495,,12198361,7529560
2022-09-11,9412,980,667,3739,34971154,12667585,468802,,12198783,7533088
2022-09-12,3128,295,205,1080,34974282,12667595,468885,,12198710,7533930
2022-09-13,6022,546,284,1133,34980304,12667851,469138,,12198713,7534817
2022-09-14,14484,799,436,1844,34994788,12668329,469497,,12198832,7536393
2022-09-15,15765,782,413,1536,35010553,12668790,469861,,12198929,7537657
2022-09-16,17762,767,448,1693,35028315,12669293,470174,,12199119,7539125
2022-09-17,17623,723,458,1668,35045938,12669709,470435,,12199274,7540536
2022-09-18,11214,773,451,1688,35057152,12670218,470755,,12199463,7541998
2022-09-19,4980,404,288,670,35062132,12670348,470866,,12199482,7542453
2022-09-20,13774,443,332,948,35075906,12670476,470975,,12199501,7543138
2022-09-21,23047,648,410,1501,35098953,12670812,471208,,12199604,7544382
2022-09-22,22921,636,399,1383,35121874,12671138,471439,,12199699,7545502
2022-09-23,22952,727,603,1419,35144826,12671560,471558,,12200002,7546662
2022-09-24,21697,738,689,1499,35166523,12672003,471603,,12200400,7547925
2022-09-25,11322,595,703,1358,35177845,12672315,471489,,12200826,7549045
2022-09-26,4565,191,220,594,35182410,12672213,471454,,12200759,7549393
2022-09-27,37655,497,366,1498,35220065,12672439,471581,,12200858,7550663
2022-09-28,50973,731,670,1903,35271038,12672900,471641,,12201259,7552339
2022-09-29,48014,637,742,1838,35319052,12673212,471528,,12201684,7553897
2022-09-30,47275,677,806,2006,35366327,12673561,471397,,12202164,7555621
2022-10-01,34456,527,634,1549,35400783,12673778,471288,,12202490,7556902
2022-10-02,24247,736,1028,1712,35425030,12674216,470993,,12203223,7558360
2022-10-03,10871,238,231,613,35435901,12674161,470996,,12203165,7558734
2022-10-04,32199,477,461,1170,35468100,12674315,471008,,12203307,7559624
2022-10-05,40442,633,742,1562,35508542,12674624,470892,,12203732,7560919
2022-10-06,38697,610,653,1569,35547239,12674928,470847,,12204081,7562225
2022-10-07,42245,662,852,1742,35589484,12675242,470649,,12204593,7563665
2022-10-08,37402,782,1145,2121,35626886,12675691,470280,,12205411,7565510
2022-10-09,18813,548,727,1556,35645699,12675958,470098,,12205860,7566825
2022-10-10,6866,166,371,567,35652565,12675824,469890,,12205934,7567130
2022-10-11,4996,125,111,318,35657561,12675653,469899,,12205754,7567209
2022-10-12,35119,579,686,1429,35692680,12675896,469790,,12206106,7568346
2022-10-13,36765,643,859,1621,35729445,12676167,469570,,12206597,7569654
2022-10-14,36978,622,754,1541,35766423,12676453,469434,,12207019,7570913
2022-10-15,35456,714,1013,1628,35801879,12676872,469132,,12207740,7572290
2022-10-16,20663,654,1024,1593,35822542,12677253,468756,,12208497,7573650
2022-10-17,7357,206,477,541,35829899,12677169,468483,,12208686,7573947
2022-10-18,36431,455,504,1402,35866330,12677300,468429,,12208871,7575075
2022-10-19,49905,618,730,1983,35916235,12677614,468313,,12209301,7576806
2022-10-20,51296,621,650,2050,35967531,12677917,468281,,12209636,7578588
2022-10-21,52854,695,620,1936,36020385,12678281,468350,,12209931,7580253
2022-10-22,50869,750,905,2313,36071254,12678695,468190,,12210505,7582286
2022-10-23,30643,571,786,2121,36101897,12678948,467968,,12210980,7584142
2022-10-24,14134,232,271,978,36116031,12678874,467924,,12210950,7584859
2022-10-25,41376,472,489,1821,36157407,12678992,467904,,12211088,7586379
2022-10-26,51660,615,660,2124,36209067,12679268,467855,,12211413,7588220
2022-10-27,50121,603,768,2164,36259188,12679540,467682,,12211858,7590109
2022-10-28,49809,590,675,2096,36308997,12679766,467592,,12212174,7591894
2022-10-29,50610,733,779,2222,36359607,12680145,467542,,12212603,7593811
2022-10-30,28405,661,930,2038,36388012,12680516,467269,,12213247,7595601
2022-10-31,12441,200,234,777,36400453,12680428,467231,,12213197,7596137
2022-11-01,33098,339,199,1220,36433551,12680418,467365,,12213053,7597064
2022-11-02,44294,574,625,1903,36477845,12680655,467310,,12213345,7598663
2022-11-03,44197,540,606,1857,36522042,12680861,467239,,12213622,7600231
2022-11-04,44647,648,528,2030,36566689,12681201,467352,,12213849,7602004
2022-11-05,45213,647,753,2369,36611902,12681541,467243,,12214298,7604102
2022-11-06,26021,558,771,2098,36637923,12681753,467027,,12214726,7605899
2022-11-07,10712,242,235,877,36648635,12681700,467031,,12214669,7606532
2022-11-08,33490,486,397,1586,36682125,12681892,467117,,12214775,7607871
2022-11-09,40532,604,570,1966,36722657,12682170,467149,,12215021,7609560
2022-11-10,39181,620,548,1928,36761838,12682465,467215,,12215250,7611209
2022-11-11,43355,636,642,2209,36805193,12682777,467207,,12215570,7613139
2022-11-12,36855,638,593,2185,36842048,12683088,467244,,12215844,7615039
2022-11-13,24270,557,771,2278,36866318,12683343,467024,,12216319,7617058
2022-11-14,10968,232,205,1024,36877286,12683276,467050,,12216226,7617821
2022-11-15,33638,484,380,1696,36910924,12683388,467148,,12216240,7619202
2022-11-16,43543,799,584,2371,36954467,12683880,467357,,12216523,7621315
2022-11-17,38342,674,647,2241,36992809,12684210,467380,,12216830,7623263
2022-11-18,40631,723,530,2335,37033440,12684581,467569,,12217012,7625294
2022-11-19,39666,1004,1031,3061,37073106,12685233,467535,,12217698,7628046
2022-11-20,22425,658,719,2445,37095531,12685604,467470,,12218134,7630254
2022-11-21,8922,196,193,968,37104453,12685531,467468,,12218063,7631011
2022-11-22,26443,481,370,1513,37130896,12685642,467574,,12218068,7632201
2022-11-23,32089,685,668,2071,37162985,12685986,467588,,12218398,7633984
2022-11-24,31913,662,753,2086,37194898,12686327,467495,,12218832,7635802
2022-11-25,30754,762,827,1953,37225652,12686772,467424,,12219348,7637488
2022-11-26,30295,908,1194,2699,37255947,12687332,467129,,12220203,7639890
2022-11-27,18681,607,943,2088,37274628,12687625,466787,,12220838,7641714
2022-11-28,7542,191,282,788,37282170,12687506,466688,,12220818,7642233
2022-11-29,21029,421,454,1293,37303199,12687587,466651,,12220936,7643240
2022-11-30,27894,643,649,1841,37331093,12687902,466643,,12221259,7644796
2022-12-01,24819,594,682,1693,37355912,12688161,466551,,12221610,7646198
2022-12-02,25060,523,630,1777,37380972,12688346,466438,,12221908,7647685
2022-12-03,25562,587,781,1949,37406534,12688600,466234,,12222366,7649361
2022-12-04,15253,494,606,1703,37421787,12688751,466116,,12222635,7650764
2022-12-05,6877,167,157,746,37428664,12688617,466121,,12222496,7651256
2022-12-06,20356,419,353,1379,37449020,12688657,466181,,12222476,7652315
2022-12-07,24790,553,612,1673,37473810,12688882,466114,,12222768,7653709
2022-12-08,23164,564,520,1767,37496974,12689118,466156,,12222962,7655189
2022-12-09,23335,637,576,1633,37520309,12689413,466213,,12223200,7656538
2022-12-10,22582,509,604,1631,37542891,12689593,466115,,12223478,7657883
2022-12-11,14206,548,787,1567,37557097,12689865,465873,,12223992,7659214
2022-12-12,5507,149,156,595,37562604,12689713,465861,,12223852,7659563
2022-12-13,17800,375,371,1125,37580404,12689758,465863,,12223895,7660408
2022-12-14,21326,511,547,1455,37601730,12689963,465821,,12224142,7661610
2022-12-15,21977,531,603,1579,37623707,12690139,465747,,12224392,7662884
2022-12-16,16296,378,451,1031,37640003,12690186,465671,,12224515,7663636
2022-12-17,18703,554,510,1279,37658706,12690407,465713,,12224694,7664622
2022-12-18,12647,531,795,1307,37671353,12690647,465448,,12225199,7665669
2022-12-19,4587,131,116,450,37675940,12690433,465459,,12224974,7665825
2022-12-20,16218,499,450,1112,37692158,12690604,465500,,12225104,7666664
2022-12-21,18478,542,552,1303,37710636,12690832,465486,,12225346,7667694
2022-12-22,18608,574,591,1748,37729244,12691100,465469,,12225631,7669176
2022-12-23,15654,577,602,1716,37744898,12691310,465439,,12225871,7670588
2022-12-24,5341,224,173,675,37750239,12691209,465489,,12225720,7670971
2022-12-25,2445,153,154,480,37752684,12691046,465478,,12225568,7671180
2022-12-26,262,12,7,48,37752946,12690747,465478,,12225269,7670968
2022-12-27,2099,98,37,307,37755045,12690550,465535,,12225015,7671032
2022-12-28,8321,337,168,975,37763366,12690561,465699,,12224862,7671725
2022-12-29,13167,583,529,1601,37776533,12690795,465749,,12225046,7673025
2022-12-30,15824,667,658,1881,37792357,12691143,465755,,12225388,7674622
2022-12-31,11238,459,389,1356,37803595,12691235,465821,,12225414,7675663
2023-01-01,3910,201,219,562,37807505,12691112,465801,,12225311,7675942
2023-01-02,652,37,13,97,37808157,12690846,465824,,12225022,7675779
2023-01-03,8197,297,151,902,37816354,12690838,465964,,12224874,7676424
2023-01-04,14724,573,547,1548,37831078,12691112,465983,,12225129,7677711
2023-01-05,16120,643,535,1797,37847198,12691439,466082,,12225357,7679235
2023-01-06,18840,715,613,2048,37866038,12691840,466181,,12225659,7681011
2023-01-07,18525,701,639,2057,37884563,12692249,466238,,12226011,7682813
2023-01-08,11613,579,608,1633,37896176,12692559,466205,,12226354,7684212
2023-01-09,5299,215,196,664,37901475,12692455,466221,,12226234,7684607
2023-01-10,12163,414,317,787,37913638,12692550,466316,,12226234,7685117
2023-01-11,15549,458,370,1097,37929187,12692670,466398,,12226272,7685930
2023-01-12,14085,444,409,973,37943272,12692791,466432,,12226359,7686630
2023-01-13,14177,419,344,1041,37957449,12692935,466504,,12226431,7687431
2023-01-14,13394,471,451,1079,37970843,12693083,466518,,12226565,7688228
2023-01-15,9049,459,508,1055,37979892,12693240,466468,,12226772,7689028
2023-01-16,3747,146,131,479,37983639,12693092,466483,,12226609,7689249
2023-01-17,8855,265,179,654,37992494,12693007,466565,,12226442,7689608
2023-01-18,10268,349,273,762,38002762,12693044,466637,,12226407,7690093
2023-01-19,10594,315,318,761,38013356,12693047,466629,,12226418,7690591
2023-01-20,9839,319,273,717,38023195,12693067,466673,,12226394,7691045
2023-01-21,11313,354,403,905,38034508,12693102,466623,,12226479,7691681
2023-01-22,7571,343,405,820,38042079,12693165,466557,,12226608,7692256
2023-01-23,3383,143,131,288,38045462,12693054,466568,,12226486,7692320
2023-01-24,8291,226,166,553,38053753,12692944,466625,,12226319,7692581
2023-01-25,10312,346,299,664,38064065,12693004,466668,,12226336,7693004
2023-01-26,6728,236,206,469,38070793,12692932,466694,,12226238,7693217
2023-01-27,6913,237,197,498,38077706,12692845,466731,,12226114,7693439
2023-01-28,9355,314,339,696,38087061,12692855,466700,,12226155,7693875
2023-01-29,5973,234,341,694,38093034,12692793,466588,,12226205,7694308
2023-01-30,1901,88,80,215,38094935,12692578,466594,,12225984,7694258
2023-01-31,5885,156,152,414,38100820,12692409,466593,,12225816,7694386
2023-02-01,7304,248,250,494,38108124,12692384,466588,,12225796,7694650
2023-02-02,6488,296,242,505,38114612,12692389,466639,,12225750,7694918
2023-02-03,6551,197,194,463,38121163,12692305,466638,,12225667,7695136
2023-02-04,6731,233,307,544,38127894,12692255,466558,,12225697,7695440
2023-02-05,4178,199,291,485,38132072,12692158,466461,,12225697,7695680
2023-02-06,1834,90,98,212,38133906,12691937,466450,,12225487,7695618
2023-02-07,4967,160,182,384,38138873,12691774,466425,,12225349,7695733
2023-02-08,5771,212,206,430,38144644,12691688,466426,,12225262,7695905
2023-02-09,6124,211,244,439,38150768,12691599,466392,,12225207,7696089
2023-02-10,5092,158,208,373,38155860,12691510,466337,,12225173,7696252
2023-02-11,6056,186,261,458,38161916,12691397,466258,,12225139,7696440
2023-02-12,4085,220,342,409,38166001,12691350,466132,,12225218,7696613
2023-02-13,1483,57,87,146,38167484,12691141,466100,,12225041,7696534
2023-02-14,3949,131,179,310,38171433,12690971,466050,,12224921,7696576
2023-02-15,4542,119,191,286,38175975,12690804,465975,,12224829,7696620
2023-02-16,4917,175,284,400,38180892,12690680,465862,,12224818,7696762
2023-02-17,4984,180,211,344,38185876,12690592,465827,,12224765,7696880
2023-02-18,5119,233,295,487,38190995,12690545,465763,,12224782,7697128
2023-02-19,3355,132,244,373,38194350,12690395,465646,,12224749,7697266
2023-02-20,1424,63,54,158,38195774,12690190,465652,,12224538,7697197
2023-02-21,915,27,14,107,38196689,12689953,465660,,12224293,7697073
2023-02-22,4137,131,212,370,38200826,12689804,465572,,12224232,7697214
2023-02-23,4283,162,231,393,38205109,12689676,465496,,12224180,7697359
2023-02-24,3035,136,232,274,38208144,12689532,465395,,12224137,7697381
2023-02-25,5024,213,541,386,38213168,12689479,465065,,12224414,7697545
2023-02-26,3473,146,681,384,38216641,12689338,464526,,12224812,7697690
2023-02-27,1075,37,57,97,38217716,12689115,464500,,12224615,7697571
2023-02-28,2732,99,163,232,38220448,12688911,464434,,12224477,7697534
2023-03-01,3850,137,428,336,38224298,12688722,464136,,12224586,7697582
2023-03-02,4595,158,495,329,38228893,12688544,463788,,12224756,7697634
2023-03-03,4371,159,357,334,38233264,12688410,463587,,12224823,7697709
2023-03-04,4970,208,623,350,38238234,12688318,463169,,12225149,7697802
2023-03-05,2537,110,450,251,38240771,12688108,462827,,12225281,7697777
2023-03-06,1157,48,37,114,38241928,12687875,462835,,12225040,7697647
2023-03-07,3222,88,172,225,38245150,12687622,462746,,12224876,7697587
2023-03-08,4320,133,412,284,38249470,12687435,462465,,12224970,7697586
2023-03-09,4626,174,454,313,38254096,12687303,462179,,12225124,7697637
2023-03-10,3942,99,139,255,38258038,12687132,462135,,12224997,7697664
2023-03-11,4065,139,172,286,38262103,12687019,462098,,12224921,7697729
2023-03-12,2894,109,234,302,38264997,12686838,461963,,12224875,7697785
2023-03-13,862,29,32,106,38265859,12686608,461955,,12224653,7697665
2023-03-14,3080,100,109,257,38268939,12686416,461946,,12224470,7697673
2023-03-15,4099,138,163,313,38273038,12686280,461918,,12224362,7697746
2023-03-16,4027,176,234,277,38277065,12686112,461851,,12224261,7697741
2023-03-17,4292,168,202,311,38281357,12685960,461813,,12224147,7697770
2023-03-18,4363,144,194,298,38285720,12685810,461762,,12224048,7697810
2023-03-19,2722,128,233,256,38288442,12685695,461654,,12224041,7697850
2023-03-20,774,31,19,74,38289216,12685439,461663,,12223776,7697680
2023-03-21,2899,69,86,201,38292115,12685222,461641,,12223581,7697640
2023-03-22,3895,130,134,248,38296010,12685049,461634,,12223415,7697618
2023-03-23,3813,116,172,226,38299823,12684855,461572,,12223283,7697580
2023-03-24,3694,102,116,238,38303517,12684682,461556,,12223126,7697589
2023-03-25,4274,108,171,252,38307791,12684504,461486,,12223018,7697595
2023-03-26,2480,112,213,202,38310271,12684336,461379,,12222957,7697559
2023-03-27,915,48,32,68,38311186,12684142,461394,,12222748,7697415
2023-03-28,3109,87,79,203,38314295,12683927,461393,,12222534,7697363
2023-03-29,4173,125,137,225,38318468,12683760,461375,,12222385,7697338
2023-03-30,3838,108,164,211,38322306,12683578,461317,,12222261,7697288
2023-03-31,3987,140,109,222,38326293,12683422,461347,,12222075,7697262
2023-04-01,4196,135,147,226,38330489,12683263,461332,,12221931,7697243
2023-04-02,2185,60,123,172,38332674,12683014,461265,,12221749,7697150
2023-04-03,781,24,12,53,38333455,12682772,461274,,12221498,7696970
2023-04-04,3420,74,76,169,38336875,12682576,461270,,12221306,7696897
2023-04-05,4374,94,109,250,38341249,12682366,461251,,12221115,7696889
2023-04-06,3703,108,109,190,38344952,12682200,461247,,12220953,7696843
2023-04-07,4599,104,115,244,38349551,12682010,461233,,12220777,7696838
2023-04-08,836,23,11,54,38350387,12681779,461240,,12220539,7696674
2023-04-09,2441,81,103,161,38352828,12681622,461215,,12220407,7696634
2023-04-10,360,9,6,20,38353188,12681361,461212,,12220149,7696434
2023-04-11,2774,34,28,121,38355962,12681094,461216,,12219878,7696288
2023-04-12,6347,105,96,188,38362309,12680929,461218,,12219711,7696255
2023-04-13,6999,105,128,207,38369308,12680745,461187,,12219558,7696209
2023-04-14,6514,88,103,206,38375822,12680561,461164,,12219397,7696195
2023-04-15,6950,107,149,230,38382772,12680390,461119,,12219271,7696193
2023-04-16,3277,83,144,166,38386049,12680181,461054,,12219127,7696108
2023-04-17,864,12,13,49,38386913,12679951,461050,,12218901,7695958
2023-04-18,4786,101,77,161,38391699,12679756,461071,,12218685,7695864
2023-04-19,6568,117,99,177,38398267,12679585,461086,,12218499,7695789
2023-04-20,6391,102,153,210,38404658,12679429,461033,,12218396,7695777
2023-04-21,5774,85,76,133,38410432,12679237,461039,,12218198,7695675
2023-04-22,6392,95,91,180,38416824,12679063,461040,,12218023,7695632
2023-04-23,3301,119,147,170,38420125,12678930,461011,,12217919,7695582
2023-04-24,955,4,12,59,38421080,12678678,461001,,12217677,7695432
2023-04-25,4813,69,70,187,38425893,12678475,461000,,12217475,7695378
2023-04-26,6593,108,93,208,38432486,12678334,461014,,12217320,7695367
2023-04-27,6899,118,152,207,38439385,12678181,460975,,12217206,7695340
2023-04-28,6638,86,86,185,38446023,12678007,460972,,12217035,7695292
2023-04-29,6534,121,111,200,38452557,12677865,460978,,12216887,7695264
2023-04-30,2643,95,129,145,38455200,12677724,460943,,12216781,7695200
2023-05-01,1030,20,17,30,38456230,12677474,460940,,12216534,7694998
2023-05-02,4351,67,57,107,38460581,12677260,460944,,12216316,7694866
2023-05-03,5609,108,107,176,38466190,12677102,460938,,12216164,7694819
2023-05-04,8088,87,85,135,38474278,12676911,460937,,12215974,7694725
2023-05-05,13051,89,98,168,38487329,12676747,460923,,12215824,7694675
2023-05-06,15659,112,96,157,38502988,12676626,460937,,12215689,7694620
2023-05-07,6067,56,95,106,38509055,12676445,460893,,12215552,7694522
2023-05-08,2168,16,4,37,38511223,12676215,460900,,12215315,7694350
2023-05-09,12576,56,49,129,38523799,12676011,460901,,12215110,7694262
2023-05-10,14773,70,79,157,38538572,12675823,460888,,12214935,7694199
2023-05-11,13367,76,72,155,38551939,12675664,460891,,12214773,7694145
2023-05-12,13493,84,80,177,38565432,12675507,460892,,12214615,7694109
2023-05-13,11449,80,75,147,38576881,12675295,460892,,12214403,7694001
2023-05-14,4188,68,95,94,38581069,12675124,460861,,12214263,7693903
2023-05-15,1055,9,6,38,38582124,12674904,460858,,12214046,7693745
2023-05-16,8949,56,48,93,38591073,12674701,460859,,12213842,7693616
2023-05-17,11134,99,83,141,38602207,12674532,460869,,12213663,7693510
2023-05-18,10838,81,69,144,38613045,12674339,460879,,12213460,7693418
2023-05-19,10516,95,97,154,38623561,12674170,460871,,12213299,7693339
2023-05-20,9410,91,88,166,38632971,12673977,460871,,12213106,7693252
2023-05-21,3083,47,86,95,38636054,12673793,460830,,12212963,7693145
2023-05-22,971,14,11,30,38637025,12673559,460832,,12212727,7692960
2023-05-23,754,8,3,16,38637779,12673333,460836,,12212497,7692779
2023-05-24,8035,57,80,105,38645814,12673127,460812,,12212315,7692646
2023-05-25,9351,74,93,162,38655165,12672937,460791,,12212146,7692576
2023-05-26,8000,67,71,124,38663165,12672773,460786,,12211987,7692495
2023-05-27,8234,110,76,126,38671399,12672628,460817,,12211811,7692409
2023-05-28,2905,56,72,101,38674304,12672464,460797,,12211667,7692315
2023-05-29,972,13,11,30,38675276,12672241,460796,,12211445,7692134
2023-05-30,6075,60,50,113,38681351,12672035,460804,,12211231,7692014
2023-05-31,8175,92,94,122,38689526,12671852,460797,,12211055,7691911
2023-06-01,7404,69,92,125,38696930,12671669,460771,,12210898,7691817
2023-06-02,6342,52,49,121,38703272,12671458,460773,,12210685,7691699
2023-06-03,5494,70,63,123,38708766,12671257,460779,,12210478,7691588
2023-06-04,2054,47,78,77,38710820,12671078,460742,,12210336,7691467
2023-06-05,601,11,7,18,38711421,12670855,460743,,12210112,7691285
2023-06-06,4466,39,39,79,38715887,12670638,460740,,12209898,7691141
2023-06-07,5816,63,66,120,38721703,12670484,460732,,12209752,7691079
2023-06-08,5757,58,68,112,38727460,12670341,460718,,12209623,7691018
2023-06-09,6192,77,81,122,38733652,12670183,460711,,12209472,7690934
2023-06-10,5352,76,95,116,38739004,12670006,460686,,12209320,7690832
2023-06-11,2010,55,62,105,38741014,12669853,460674,,12209179,7690761
2023-06-12,691,11,7,38,38741705,12669654,460675,,12208979,7690618
2023-06-13,4228,54,58,104,38745933,12669477,460669,,12208808,7690526
2023-06-14,5471,72,83,119,38751404,12669301,460657,,12208644,7690432
2023-06-15,5111,72,75,121,38756515,12669114,460650,,12208464,7690329
2023-06-16,5699,70,64,121,38762214,12668956,460652,,12208304,7690252
2023-06-17,4121,63,62,114,38766335,12668792,460653,,12208139,7690168
2023-06-18,1561,41,61,98,38767896,12668620,460631,,12207989,7690081
2023-06-19,373,6,2,16,38768269,12668414,460633,,12207781,7689914
2023-06-20,3207,51,42,89,38771476,12668225,460639,,12207586,7689792
2023-06-21,3696,42,57,89,38775172,12668066,460620,,12207446,7689699
2023-06-22,3981,75,73,118,38779153,12667936,460620,,12207316,7689636
2023-06-23,4510,54,44,90,38783663,12667806,460628,,12207178,7689564
2023-06-24,3699,49,61,73,38787362,12667618,460613,,12207005,7689435
2023-06-25,1521,31,52,93,38788883,12667452,460590,,12206862,7689357
2023-06-26,511,11,9,24,38789394,12667287,460589,,12206698,7689220
2023-06-27,3121,80,45,91,38792515,12667149,460621,,12206528,7689124
2023-06-28,4075,69,60,91,38796590,12667018,460629,,12206389,7689034
2023-06-29,3984,64,72,84,38800574,12666897,460615,,12206282,7688960
2023-06-30,3836,74,61,128,38804410,12666765,460623,,12206142,7688903
2023-07-01,3223,51,88,118,38807633,12666597,460584,,12206013,7688834
2023-07-02,272,10,5,15,38807905,12666415,460588,,12205827,7688683
2023-07-03,380,7,5,26,38808285,12666254,460589,,12205665,7688567
2023-07-04,1244,18,14,49,38809529,12666074,460593,,12205481,7688441
2023-07-05,2391,56,40,70,38811920,12665940,460607,,12205333,7688350
2023-07-06,2535,38,69,85,38814455,12665763,460574,,12205189,7688247
2023-07-07,2825,53,46,72,38817280,12665640,460579,,12205061,7688167
2023-07-08,2421,64,43,94,38819701,12665500,460599,,12204901,7688081
2023-07-09,916,31,45,37,38820617,12665350,460585,,12204765,7687954
2023-07-10,289,4,2,15,38820906,12665141,460585,,12204556,7687784
2023-07-11,1793,34,20,59,38822699,12664977,460595,,12204382,7687677
2023-07-12,2321,49,52,86,38825020,12664841,460592,,12204249,7687598
2023-07-13,2288,52,68,67,38827308,12664701,460574,,12204127,7687500
2023-07-14,2030,64,49,60,38829338,12664587,460586,,12204001,7687406
2023-07-15,1945,52,56,77,38831283,12664466,460581,,12203885,7687333
2023-07-16,806,36,30,43,38832089,12664300,460587,,12203713,7687201
2023-07-17,193,5,1,11,38832282,12664137,460588,,12203549,7687066
2023-07-18,1308,42,44,56,38833590,12663979,460585,,12203394,7686952
2023-07-19,1797,55,51,57,38835387,12663856,460586,,12203270,7686862
2023-07-20,1619,77,57,61,38837006,12663759,460604,,12203155,7686760
2023-07-21,1738,54,40,50,38838744,12663635,460614,,12203021,7686650
2023-07-22,1511,38,62,76,38840255,12663506,460590,,12202916,7686567
2023-07-23,699,28,31,49,38840954,12663362,460585,,12202777,7686463
2023-07-24,235,11,2,15,38841189,12663203,460593,,12202610,7686323
2023-07-25,1085,48,25,51,38842274,12663042,460616,,12202426,7686185
2023-07-26,1347,49,49,41,38843621,12662927,460615,,12202312,7686076
2023-07-27,1287,68,47,55,38844908,12662831,460635,,12202196,7685984
2023-07-28,1449,46,47,58,38846357,12662687,460633,,12202054,7685873
2023-07-29,1308,50,49,69,38847665,12662554,460631,,12201923,7685784
2023-07-30,648,29,19,29,38848313,12662420,460640,,12201780,7685669
2023-07-31,229,6,4,15,38848542,12662268,460638,,12201630,7685542
2023-08-01,1116,47,32,35,38849658,12662149,460652,,12201497,7685430
2023-08-02,1435,73,55,56,38851093,12662028,460667,,12201361,7685324
2023-08-03,1159,61,38,47,38852252,12661915,460689,,12201226,7685216
2023-08-04,1299,46,48,60,38853551,12661786,460686,,12201100,7685118
2023-08-05,1319,49,50,49,38854870,12661668,460684,,12200984,7685019
2023-08-06,577,25,20,23,38855447,12661560,460689,,12200871,7684919
2023-08-07,245,8,4,9,38855692,12661415,460689,,12200726,7684796
2023-08-08,330,8,4,15,38856022,12661263,460690,,12200573,7684669
2023-08-09,1257,45,43,45,38857279,12661148,460691,,12200457,7684578
2023-08-10,1608,96,52,70,38858887,12661104,460733,,12200371,7684524
2023-08-11,1681,57,47,63,38860568,12661020,460743,,12200277,7684463
2023-08-12,1656,65,47,68,38862224,12660956,460761,,12200195,7684419
2023-08-13,798,29,32,32,38863022,12660854,460758,,12200096,7684333
2023-08-14,248,6,1,6,38863270,12660736,460761,,12199975,7684232
2023-08-15,1289,38,27,40,38864559,12660587,460770,,12199817,7684109
2023-08-16,1638,59,49,49,38866197,12660515,460779,,12199736,7684039
2023-08-17,1707,77,66,63,38867904,12660462,460789,,12199673,7683987
2023-08-18,1687,86,60,51,38869591,12660416,460814,,12199602,7683915
2023-08-19,1714,81,54,64,38871305,12660368,460840,,12199528,7683868
2023-08-20,839,57,44,32,38872144,12660312,460850,,12199462,7683805
2023-08-21,230,4,2,8,38872374,12660157,460850,,12199307,7683677
2023-08-22,1252,57,47,48,38873626,12660066,460859,,12199207,7683599
2023-08-23,1532,67,50,53,38875158,12659997,460876,,12199121,7683527
2023-08-24,1582,95,68,72,38876740,12659952,460903,,12199049,7683472
2023-08-25,1446,87,44,51,38878186,12659922,460945,,12198977,7683420
2023-08-26,1641,80,56,67,38879827,12659888,460967,,12198921,7683388
2023-08-27,793,29,44,49,38880620,12659815,460948,,12198867,7683349
2023-08-28,189,5,3,9,38880809,12659716,460949,,12198767,7683259
2023-08-29,927,51,31,43,38881736,12659661,460968,,12198693,7683206
2023-08-30,1379,124,69,69,38883115,12659684,461023,,12198661,7683185
2023-08-31,1464,98,90,82,38884579,12659673,461029,,12198644,7683178
2023-09-01,1488,99,82,98,38886067,12659699,461046,,12198653,7683216
2023-09-02,1275,77,62,66,38887342,12659686,461060,,12198626,7683202
2023-09-03,668,47,41,32,38888010,12659653,461066,,12198587,7683164
2023-09-04,146,2,0,9,38888156,12659586,461067,,12198519,7683115
2023-09-05,131,5,2,6,38888287,12659514,461069,,12198445,7683057
2023-09-06,980,46,39,57,38889267,12659470,461075,,12198395,7683035
2023-09-07,1208,54,38,73,38890475,12659461,461091,,12198370,7683050
2023-09-08,1049,71,41,47,38891524,12659476,461121,,12198355,7683046
2023-09-09,1188,62,41,70,38892712,12659494,461142,,12198352,7683075
2023-09-10,810,57,38,46,38893522,12659511,461161,,12198350,7683083
2023-09-11,126,5,3,8,38893648,12659494,461163,,12198331,7683070
2023-09-12,873,31,23,34,38894521,12659516,461171,,12198345,7683097
2023-09-13,1301,81,53,62,38895822,12659596,461199,,12198397,7683158
2023-09-14,1012,66,52,44,38896834,12659662,461213,,12198449,7683202
