"report_date","previous_day_total_doses_administered","previous_day_at_least_one","previous_day_fully_vaccinated","previous_day_3doses","total_doses_administered","total_individuals_at_least_one","total_individuals_partially_vaccinated","total_doses_in_fully_vaccinated_individuals","total_individuals_fully_vaccinated","total_individuals_3doses"
2021-01-01,6251,6241,2,,32198,32143,32132,22,11,
2021-01-02,4613,4601,6,,36811,36692,36679,26,13,
2021-01-03,5395,5388,3,,42206,42080,42064,32,16,
2021-01-04,5995,5993,0,,48201,48072,48057,30,15,
2021-01-05,9683,9658,20,,57884,57728,57694,68,34,
2021-01-06,12793,12328,450,,70677,70052,69572,960,480,
2021-01-07,16218,15507,697,,86895,85558,84381,2354,1177,
2021-01-08,18037,17022,1002,,104932,102580,100401,4358,2179,
2021-01-09,19500,18423,1064,,124432,121002,117759,6486,3243,
2021-01-10,11371,11331,38,,135803,132324,129044,6560,3280,
2021-01-11,11711,11661,48,,147514,143985,140657,6656,3328,
2021-01-12,14467,14160,298,,161981,158137,154511,7252,3626,
2021-01-13,15435,13813,1593,,177416,171936,166719,10434,5217,
2021-01-14,19186,16735,2436,,196602,188665,181013,15304,7652,
2021-01-15,20050,17992,2038,,216652,206646,196956,19380,9690,
2021-01-16,17116,15933,1170,,233768,222563,211703,21720,10860,
2021-01-17,11259,10015,1237,,245027,232563,220468,24190,12095,
2021-01-18,6793,6711,72,,251820,239251,227087,24328,12164,
2021-01-19,11827,9719,2094,,263647,248949,234691,28516,14258,
2021-01-20,10800,7211,3572,,274447,256137,238308,35658,17829,
2021-01-21,10971,6852,4091,,285418,262973,241053,43840,21920,
2021-01-22,9038,4320,4698,,294456,267256,240640,53232,26616,
2021-01-23,7453,3037,4388,,301909,270263,239260,62006,31003,
2021-01-24,4383,1826,2536,,306292,272071,238532,67078,33539,
2021-01-25,5320,1047,4264,,311612,273086,235284,75604,37802,
2021-01-26,9389,2866,6495,,321001,275920,231624,88592,44296,
2021-01-27,9894,2862,7004,,330895,278753,227454,102598,51299,
2021-01-28,13112,5735,7335,,344007,284455,225821,117268,58634,
2021-01-29,10691,3278,7379,,354698,287702,221690,132024,66012,
2021-01-30,9186,2726,6423,,363884,290386,217954,144864,72432,
2021-01-31,3376,1563,1768,,367260,291915,217716,148398,74199,
2021-02-01,2122,485,1609,,369382,292366,216562,151608,75804,
2021-02-02,4408,1355,2995,,373790,293683,214888,157590,78795,
2021-02-03,6236,1716,4458,,380026,295358,212112,166492,83246,
2021-02-04,9077,1707,7291,,389103,297022,206491,181062,90531,
2021-02-05,8441,1466,6902,,397544,298448,201021,194854,97427,
2021-02-06,10659,1863,8736,,408203,300256,194102,212308,106154,
2021-02-07,7574,1729,5796,,415777,301945,190007,223876,111938,
2021-02-08,8218,3095,5080,,423995,304992,187987,234010,117005,
2021-02-09,15001,3852,11081,,438996,308802,180732,256140,128070,
2021-02-10,15505,4926,10518,,454501,313676,175113,277126,138563,
2021-02-11,16362,3898,12408,,470863,317522,166582,301880,150940,
2021-02-12,17652,2096,15506,,488515,319579,153153,332852,166426,
2021-02-13,16207,2442,13750,,504722,321976,141819,360314,180157,
2021-02-14,12877,920,11925,,517599,322848,130796,384104,192052,
2021-02-15,7861,485,7328,,525460,323285,123931,398708,199354,
2021-02-16,5990,1040,4900,,531450,324282,120051,408462,204231,
2021-02-17,10165,1608,8523,,541615,325846,113120,425452,212726,
2021-02-18,13867,2953,10870,,555482,328751,105185,447132,223566,
2021-02-19,18487,6213,12207,,573969,334912,99170,471484,235742,
2021-02-20,22625,11129,11444,,596594,345978,98830,494296,247148,
2021-02-21,17232,10377,6821,,613826,356295,102368,507854,253927,
2021-02-22,13584,8758,4774,,627410,364984,106332,517304,258652,
2021-02-23,17859,11122,6666,,645269,376050,110768,530564,265282,
2021-02-24,18570,13609,4880,,663839,389603,119483,540240,270120,
2021-02-25,20806,16487,4262,,684645,406024,131690,548668,274334,
2021-02-26,24891,21829,3001,,709536,427793,150495,554596,277298,
2021-02-27,27453,23577,3835,,736989,451306,170221,562170,281085,
2021-02-28,20578,19140,1404,,757567,470392,187945,564894,282447,
2021-03-01,18221,17025,1148,,775788,487355,203807,567096,283548,
2021-03-02,24676,22270,2322,,800464,509564,223740,571648,285824,
2021-03-03,30593,27963,2577,,831057,537476,249108,576736,288368,
2021-03-04,34690,32460,2145,,865747,569870,279407,580926,290463,
2021-03-05,39992,38162,1782,,905739,607984,315773,584422,292211,
2021-03-06,44141,41938,2165,,949880,649867,355532,588670,294335,
2021-03-07,32733,31553,1176,,982613,681346,385893,590906,295453,
2021-03-08,24034,22160,1860,,1006647,703438,406179,594518,297259,
2021-03-09,33284,29836,3420,,1039931,733208,432575,601266,300633,
2021-03-10,38331,34071,4215,,1078262,767205,462405,609600,304800,
2021-03-11,43974,40702,3233,,1122236,807841,499860,615962,307981,
2021-03-12,47708,45996,1688,,1169944,853773,544154,619238,309619,
2021-03-13,57918,55046,2845,,1227862,908748,596338,624820,312410,
2021-03-14,43410,42173,1220,,1271272,950838,637276,627124,313562,
2021-03-15,32805,31107,1682,,1304077,981886,666685,630402,315201,
2021-03-16,53948,51652,2280,,1358025,1033473,716035,634876,317438,
2021-03-17,61054,58516,2495,,1419079,1091923,772040,639766,319883,
2021-03-18,61537,59081,2429,,1480616,1150932,828673,644518,322259,
2021-03-19,64463,61138,3271,,1545079,1211992,886515,650954,325477,
2021-03-20,62558,59971,2556,,1607637,1271907,943922,655970,327985,
2021-03-21,43991,42470,1535,,1651628,1314312,984829,658966,329483,
2021-03-22,30995,30031,975,,1682623,1344255,1013853,660804,330402,
2021-03-23,54611,51838,2722,,1737234,1395998,1062937,666122,333061,
2021-03-24,76423,73242,3133,,1813657,1469150,1133013,672274,336137,
2021-03-25,82905,80326,2532,,1896562,1549397,1210785,677224,338612,
2021-03-26,86999,83470,3490,,1983561,1632786,1290736,684100,342050,
2021-03-27,80840,77890,2866,,2064401,1710573,1365722,689702,344851,
2021-03-28,66984,65395,1554,,2131385,1775878,1429530,692696,346348,
2021-03-29,51730,49044,2651,,2183115,1824842,1475889,697906,348953,
2021-03-30,73572,70165,3348,,2256687,1894930,1542670,704520,352260,
2021-03-31,93146,89496,3583,,2349833,1984328,1628538,711580,355790,
2021-04-01,89310,85433,3838,,2439143,2069663,1710088,719150,359575,
2021-04-02,93074,88851,4207,,2532217,2158428,1794698,727460,363730,
2021-04-03,61004,59326,1735,,2593221,2217663,1852249,730828,365414,
2021-04-04,72325,70672,1649,,2665546,2288224,1921219,734010,367005,
2021-04-05,53725,53256,469,,2719271,2341396,1973970,734852,367426,
2021-04-06,79574,77710,1884,,2798845,2419004,2049748,738512,369256,
2021-04-07,107996,104935,3052,,2906841,2523814,2151564,744500,372250,
2021-04-08,114068,110102,4021,,3020909,2633805,2257590,752430,376215,
2021-04-09,109837,105615,4295,,3130746,2739302,2358857,760890,380445,
2021-04-10,109232,105475,3849,,3239978,2844649,2460421,768456,384228,
2021-04-11,98618,95504,3257,,3338596,2940028,2552602,774852,387426,
2021-04-12,76063,75001,1155,,3414659,3014881,2626368,777026,388513,
2021-04-13,99467,96087,3398,,3514126,3110859,2718996,783726,391863,
2021-04-14,117041,113279,3650,,3631167,3224020,2828547,790946,395473,
2021-04-15,113556,109501,3897,,3744723,3333395,2934082,798626,399313,
2021-04-16,118081,113709,4193,,3862804,3446994,3043532,806924,403462,
2021-04-17,112406,107821,4445,,3975210,3554681,3146833,815696,407848,
2021-04-18,88736,86500,2102,,4063946,3641058,3231162,819792,409896,
2021-04-19,68969,67439,1451,,4132915,3708367,3297071,822592,411296,
2021-04-20,101938,98617,3116,,4234853,3806822,3392475,828694,414347,
2021-04-21,141997,137723,4038,,4376850,3944371,3526054,836634,418317,
2021-04-22,139469,135326,3903,,4516319,4079568,3657404,844328,422164,
2021-04-23,138201,131792,6163,,4654520,4211206,3782937,856538,428269,
2021-04-24,130280,126220,3886,,4784800,4337278,3905179,864198,432099,
2021-04-25,102013,98604,3179,,4886813,4435734,4000523,870422,435211,
2021-04-26,70999,69295,1556,,4957812,4504898,4068191,873414,436707,
2021-04-27,98497,95419,2888,,5056309,4600156,4160624,879064,439532,
2021-04-28,120567,115946,4430,,5176876,4715934,4272044,887780,443890,
2021-04-29,124477,119284,5045,,5301353,4835051,4386185,897732,448866,
2021-04-30,115807,110559,5011,,5417160,4945437,4491637,907600,453800,
2021-05-01,111287,107428,3643,,5528447,5052684,4595318,914732,457366,
2021-05-02,79132,76159,2860,,5607579,5128686,4668526,920320,460160,
2021-05-03,56786,55119,1595,,5664365,5183650,4721955,923390,461695,
2021-05-04,91916,88549,3281,,5756281,5272021,4807122,929798,464899,
2021-05-05,137990,133286,4620,,5894271,5405138,4935682,938912,469456,
2021-05-06,141828,136877,4814,,6036099,5541831,5067623,948416,474208,
2021-05-07,150276,145241,4832,,6186375,5686912,5207931,957962,478981,
2021-05-08,142446,137761,4436,,6328821,5824478,5341140,966676,483338,
2021-05-09,124797,121151,3477,,6453618,5945465,5458714,973502,486751,
2021-05-10,97799,95818,1878,,6551417,6041094,5552532,977124,488562,
2021-05-11,113518,108848,4489,,6664935,6149740,5656760,985960,492980,
2021-05-12,145035,138011,6877,,6809970,6287572,5787781,999582,499791,
2021-05-13,142666,135309,7206,,6952636,6422706,5915783,1013846,506923,
2021-05-14,148849,138767,9913,,7101485,6561285,6044514,1033542,516771,
2021-05-15,159720,149681,9861,,7261205,6710779,6184222,1053114,526557,
2021-05-16,144354,136088,8060,,7405559,6846699,6312162,1069074,534537,
2021-05-17,114970,110875,3942,,7520529,6957385,6418982,1076806,538403,
2021-05-18,111315,100456,10657,,7631844,7057645,6508647,1097996,548998,
2021-05-19,149863,133461,16225,,7781707,7190954,6625805,1130298,565149,
2021-05-20,151553,131569,19771,,7933260,7322334,6737483,1169702,584851,
2021-05-21,165369,140868,24243,,8098629,7463021,6854004,1218034,609017,
2021-05-22,199418,172228,26964,,8298047,7635052,6999152,1271800,635900,
2021-05-23,139815,127447,12223,,8437862,7762321,7114260,1296122,648061,
2021-05-24,100293,93322,6826,,8538155,7855470,7200653,1309634,654817,
2021-05-25,90454,82972,7273,,8628609,7938279,7276256,1324046,662023,
2021-05-26,139768,113002,26502,,8768377,8051094,7362639,1376910,688455,
2021-05-27,152051,123034,28765,,8920428,8173971,7456820,1434302,717151,
2021-05-28,163855,132301,31248,,9084283,8306099,7557759,1496680,748340,
2021-05-29,153371,117113,36026,,9237654,8423062,7638752,1568620,784310,
2021-05-30,149711,119010,30476,,9387365,8541902,7727178,1629448,814724,
2021-05-31,99207,79812,19202,,9486572,8621544,7787682,1667724,833862,
2021-06-01,124182,90603,33245,,9610754,8711952,7844920,1734064,867032,
2021-06-02,145304,102144,42910,,9756058,8813915,7904042,1819746,909873,
2021-06-03,155349,99902,55169,,9911407,8913632,7948661,1929942,964971,
2021-06-04,181701,115521,65908,,10093108,9028954,7998163,2061582,1030791,
2021-06-05,172012,103428,68307,,10265120,9132184,8033171,2198026,1099013,
2021-06-06,163379,91856,71243,,10428499,9223862,8053676,2340372,1170186,
2021-06-07,119551,63045,56289,,10548050,9286710,8060310,2452800,1226400,
2021-06-08,161884,72442,89003,,10709934,9358963,8043640,2630646,1315323,
2021-06-09,181459,70803,110188,,10891393,9429589,8004159,2850860,1425430,
2021-06-10,185568,66418,118663,,11076961,9495804,7951802,3088004,1544002,
2021-06-11,204768,67506,136509,,11281729,9563124,7882695,3360858,1680429,
2021-06-12,199714,62667,136450,,11481443,9625609,7808822,3633574,1816787,
2021-06-13,190320,58876,130915,,11671763,9684310,7736688,3895244,1947622,
2021-06-14,137686,38692,98595,,11809449,9722806,7676694,4092224,2046112,
2021-06-15,189453,42598,146500,,11998902,9765186,7572671,4385030,2192515,
2021-06-16,206197,42424,163133,,12205099,9807414,7451869,4711090,2355545,
2021-06-17,210423,37926,171914,,12415522,9845125,7317758,5054734,2527367,
2021-06-18,217143,35348,181191,,12632665,9880283,7171817,5416932,2708466,
2021-06-19,215863,35487,179706,,12848528,9915564,7027504,5776120,2888060,
2021-06-20,186258,35557,150124,,13034786,9950923,6912847,6076152,3038076,
2021-06-21,120423,20822,99100,,13155209,9971550,6834466,6274168,3137084,
2021-06-22,204920,27503,176663,,13360129,9998859,6685221,6627276,3313638,
2021-06-23,230514,28623,201154,,13590643,10027282,6512598,7029368,3514684,
2021-06-24,227673,26664,200259,,13818316,10053750,6338917,7429666,3714833,
2021-06-25,251099,27978,222375,,14069415,10081527,6144437,7874180,3937090,
2021-06-26,261280,29997,230581,,14330695,10111299,5943768,8335062,4167531,
2021-06-27,204990,27783,176603,,14535685,10138900,5794876,8688048,4344024,
2021-06-28,199243,20953,177726,,14734928,10159655,5638030,9043250,4521625,
2021-06-29,250103,24489,224882,,14985031,10183903,5437550,9492706,4746353,
2021-06-30,275527,24169,250792,,15260558,10207869,5210853,9994032,4997016,
2021-07-01,271961,25303,246104,,15532519,10232954,4989973,10485962,5242981,
2021-07-02,144715,11586,132904,,15677234,10244366,4868583,10751566,5375783,
2021-07-03,216890,19929,196730,,15894124,10264073,4691709,11144728,5572364,
2021-07-04,196175,19416,176537,,16090299,10283303,4534521,11497564,5748782,
2021-07-05,148715,12438,136134,,16239014,10295551,4410763,11769576,5884788,
2021-07-06,220023,19987,199821,,16459037,10315322,4230859,12168926,6084463,
2021-07-07,246603,22962,223402,,16705640,10338058,4030341,12615434,6307717,
2021-07-08,231196,21349,209636,,16936836,10359201,3841983,13034436,6517218,
2021-07-09,226983,21502,205313,,17163819,10380501,3658102,13444798,6722399,
2021-07-10,209054,20534,188364,,17372873,10400831,3490205,13821252,6910626,
2021-07-11,171668,17578,153964,,17544541,10418208,3353765,14128886,7064443,
2021-07-12,123131,11444,111590,,17667672,10429463,3253567,14351792,7175896,
2021-07-13,178495,19026,159327,,17846167,10448267,3113199,14670136,7335068,
2021-07-14,180029,19299,160573,,18026196,10467351,2971873,14990956,7495478,
2021-07-15,167188,19582,147433,,18193384,10486722,2843975,15285494,7642747,
2021-07-16,169340,19895,149292,,18362724,10506415,2714529,15583772,7791886,
2021-07-17,172995,20257,152611,,18535719,10526423,2582118,15888610,7944305,
2021-07-18,133623,15927,117559,,18669342,10542166,2480450,16123432,8061716,
2021-07-19,91974,10415,81451,,18761316,10552368,2409376,16285984,8142992,
2021-07-20,133529,16944,116526,,18894845,10569072,2309730,16518684,8259342,
2021-07-21,140079,16981,123026,,19034924,10585838,2203632,16764412,8382206,
2021-07-22,125599,17636,107826,,19160523,10603250,2113395,16979710,8489855,
2021-07-23,120253,16984,103063,,19280776,10619993,2027274,17185438,8592719,
2021-07-24,126687,18329,108118,,19407463,10638119,1937445,17401348,8700674,
2021-07-25,103626,14857,88641,,19511089,10652752,1863618,17578268,8789134,
2021-07-26,66680,9884,56704,,19577769,10662418,1816761,17691314,8845657,
2021-07-27,92370,15314,76893,,19670139,10677471,1755138,17844666,8922333,
2021-07-28,93932,16458,77401,,19764071,10693694,1694151,17999086,8999543,
2021-07-29,89388,16699,72526,,19853459,10710161,1638280,18143762,9071881,
2021-07-30,84049,16098,67837,,19937508,10726031,1586501,18279060,9139530,
2021-07-31,83834,15707,67975,,20021342,10741520,1534205,18414630,9207315,
2021-08-01,61854,11311,50362,,20083196,10752605,1495119,18514972,9257486,
2021-08-02,42479,7409,34952,,20125675,10759816,1467544,18584544,9292272,
2021-08-03,33280,5948,27162,,20158955,10765531,1446307,18638448,9319224,
2021-08-04,61307,12367,48750,,20220262,10777663,1409887,18735552,9367776,
2021-08-05,59435,12534,46748,,20279697,10789989,1375629,18828720,9414360,
2021-08-06,56008,11850,43942,,20335705,10801579,1343506,18916146,9458073,
2021-08-07,62359,12128,50036,,20398064,10813446,1305555,19015782,9507891,
2021-08-08,48667,9260,39219,,20446731,10822478,1275573,19093810,9546905,
2021-08-09,30850,5932,24740,,20477581,10828196,1256738,19142916,9571458,
2021-08-10,49247,10504,38441,,20526828,10838420,1228767,19219306,9609653,
2021-08-11,48714,10763,37706,,20575542,10848936,1201793,19294286,9647143,
2021-08-12,49234,11188,37817,,20624776,10859873,1175122,19369502,9684751,
2021-08-13,49608,11720,37612,,20674384,10871352,1149200,19444304,9722152,
2021-08-14,51209,12128,38872,,20725593,10883230,1122430,19521600,9760800,
2021-08-15,41754,9846,31685,,20767347,10892874,1100561,19584626,9792313,
2021-08-16,26727,6177,20397,,20794074,10898828,1086315,19625026,9812513,
2021-08-17,40491,11051,29176,,20834565,10909629,1068166,19682926,9841463,
2021-08-18,41882,11961,29679,,20876447,10921348,1050416,19741864,9870932,
2021-08-19,45882,16528,29091,,20922329,10937625,1037825,19799600,9899800,
2021-08-20,46429,16281,29733,,20968758,10953650,1024346,19858608,9929304,
2021-08-21,47937,15138,32431,,21016695,10968528,1007020,19923016,9961508,
2021-08-22,34377,10800,23310,,21051072,10979082,994486,19969192,9984596,
2021-08-23,23218,7003,15999,,21074290,10985850,985469,20000762,10000381,
2021-08-24,37646,13372,23819,,21111936,10998968,974999,20047938,10023969,
2021-08-25,41327,14411,26308,,21153263,11013123,963083,20100080,10050040,
2021-08-26,39257,13550,24965,,21192520,11026397,951633,20149528,10074764,
2021-08-27,37658,12929,23685,,21230178,11039085,940850,20196470,10098235,
2021-08-28,40100,13414,25511,,21270278,11052220,928729,20246982,10123491,
2021-08-29,30542,10245,19940,,21300820,11062233,919015,20286436,10143218,
2021-08-30,18230,6138,11843,,21319050,11068123,913281,20309684,10154842,
2021-08-31,32704,11936,19618,,21351754,11079791,905571,20348440,10174220,
2021-09-01,36225,12937,21943,,21387979,11092495,896549,20391892,10195946,
2021-09-02,37763,15639,19660,,21425742,11107882,892503,20430758,10215379,
2021-09-03,46865,21082,22434,,21472607,11128715,891132,20475166,10237583,
2021-09-04,46867,20584,24770,,21519474,11149053,886923,20524260,10262130,
2021-09-05,33061,14199,18573,,21552535,11163008,882529,20560958,10280479,
2021-09-06,21704,9485,12029,,21574239,11172244,879968,20584552,10292276,
2021-09-07,14997,6724,8089,,21589236,11178711,878586,20600250,10300125,
2021-09-08,41134,17110,20929,,21630370,11195557,874749,20641616,10320808,
2021-09-09,41441,16971,19674,,21671811,11212251,872021,20680460,10340230,
2021-09-10,39629,15504,18993,,21711440,11227493,868514,20717958,10358979,
2021-09-11,42362,15928,23331,,21753802,11243142,861090,20764104,10382052,
2021-09-12,29952,11528,17861,,21783754,11254376,854727,20799298,10399649,
2021-09-13,16080,6405,9179,,21799834,11260547,851938,20817218,10408609,
2021-09-14,29895,11554,15285,,21829729,11271799,848180,20847238,10423619,
2021-09-15,39266,14020,19413,,21868995,11285560,842772,20885576,10442788,
2021-09-16,39332,13977,19240,,21908327,11299302,837486,20923632,10461816,
2021-09-17,38914,13605,19329,,21947241,11312664,831750,20961828,10480914,
2021-09-18,41221,14077,23521,,21988462,11326468,822285,21008366,10504183,
2021-09-19,30648,10826,18975,,22019110,11337035,814123,21045824,10522912,
2021-09-20,16728,6098,10175,,22035838,11342879,810023,21065712,10532856,
2021-09-21,31349,11210,16986,,22067187,11353824,804231,21099186,10549593,
2021-09-22,41804,14812,22923,,22108991,11368340,796099,21144482,10572241,
2021-09-23,47217,16134,26025,,22156208,11384211,786189,21196044,10598022,
2021-09-24,46288,15626,26641,,22202496,11399576,775155,21248842,10624421,
2021-09-25,48186,15250,29943,,22250682,11414573,760443,21308260,10654130,
2021-09-26,37485,12416,24477,,22288167,11426714,748361,21356706,10678353,
2021-09-27,19148,6528,12314,,22307315,11432988,742559,21380858,10690429,
2021-09-28,30944,11291,17872,,22338259,11444020,735966,21416108,10708054,
2021-09-29,37875,12470,21720,,22376134,11456219,726696,21459046,10729523,
2021-09-30,37325,11648,21366,,22413459,11467608,716959,21501298,10750649,
2021-10-01,30868,9808,18407,,22444327,11477190,708347,21537686,10768843,
2021-10-02,37128,11154,23580,,22481455,11488074,695903,21584342,10792171,
2021-10-03,27199,8161,18321,,22508654,11495994,685730,21620528,10810264,
2021-10-04,14866,4746,9801,,22523520,11500494,680657,21639674,10819837,
2021-10-05,26807,8589,15862,,22550327,11508822,673369,21670906,10835453,
2021-10-06,31652,9636,18502,,22581979,11518199,664495,21707408,10853704,
2021-10-07,30340,9393,17115,,22612319,11527341,656760,21741162,10870581,
2021-10-08,32827,10739,18845,,22645146,11537810,648641,21778338,10889169,
2021-10-09,34130,10659,21010,,22679276,11548206,638276,21819860,10909930,
2021-10-10,23402,7657,15079,,22702678,11555612,630842,21849540,10924770,
2021-10-11,12000,3839,7863,,22714678,11559201,626802,21864798,10932399,
2021-10-12,5103,1625,3262,,22719781,11560548,625150,21870796,10935398,
2021-10-13,29096,9189,18078,,22748877,11569447,616245,21906404,10953202,
2021-10-14,29006,8903,17742,,22777883,11578075,607396,21941358,10970679,
2021-10-15,29085,8822,18163,,22806968,11586634,598042,21977184,10988592,
2021-10-16,31132,8984,19865,,22838100,11595327,587149,22016356,11008178,
2021-10-17,23698,7258,15368,,22861798,11602331,579026,22046610,11023305,
2021-10-18,12305,3747,8146,,22874103,11605797,574615,22062364,11031182,
2021-10-19,21262,6623,12627,,22895365,11612138,568598,22087080,11043540,
2021-10-20,25654,7537,14911,,22921019,11619428,561211,22116434,11058217,
2021-10-21,23165,6675,13027,,22944184,11625834,554848,22141972,11070986,
2021-10-22,26107,7308,15105,,22970291,11632819,547035,22171568,11085784,
2021-10-23,28166,7602,17151,,22998457,11640159,537479,22205360,11102680,
2021-10-24,19343,5727,12595,,23017800,11645630,530599,22230062,11115031,
2021-10-25,9925,2709,6474,,23027725,11648070,526826,22242488,11121244,
2021-10-26,18899,5385,11093,,23046624,11653177,521109,22264136,11132068,
2021-10-27,22842,6075,13205,,23069466,11658997,513965,22290064,11145032,
2021-10-28,22299,5791,12641,,23091765,11664500,507104,22314792,11157396,
2021-10-29,22804,5730,13044,,23114569,11669928,499775,22340306,11170153,
2021-10-30,24099,6036,14608,,23138668,11675692,491191,22369002,11184501,
2021-10-31,16469,4593,10594,,23155137,11679991,485185,22389612,11194806,
2021-11-01,7865,2079,5053,,23163002,11681790,482198,22399184,11199592,
2021-11-02,15619,4362,7743,,23178621,11685861,478806,22414110,11207055,
2021-11-03,18618,5066,9601,,23197239,11690624,474261,22432726,11216363,
2021-11-04,19499,4872,10029,,23216738,11695220,469089,22452262,11226131,
2021-11-05,21453,4402,9515,,23238191,11699333,463962,22470742,11235371,
2021-11-06,25327,5204,12153,,23263518,11704268,456996,22494544,11247272,
2021-11-07,21441,4021,8918,,23284959,11708008,452087,22511842,11255921,
2021-11-08,11988,2110,4729,,23296947,11709823,449452,22520742,11260371,
2021-11-09,24115,3847,7644,,23321062,11713349,445645,22535408,11267704,
2021-11-10,28469,4507,8990,,23349531,11717579,441148,22552862,11276431,
2021-11-11,28751,4303,9093,,23378282,11721586,436349,22570474,11285237,
2021-11-12,26735,4162,8232,,23405017,11725457,432265,22586384,11293192,
2021-11-13,34298,5079,11401,,23439315,11730230,425934,22608592,11304296,
2021-11-14,23215,3897,8602,,23462530,11733864,421222,22625284,11312642,
2021-11-15,12699,2184,4494,,23475229,11735788,418904,22633768,11316884,
2021-11-16,26168,3928,7477,,23501397,11739459,415351,22648216,11324108,
2021-11-17,31156,4046,7809,,23532553,11743223,411578,22663290,11331645,
2021-11-18,32481,3858,7512,,23565034,11746775,407910,22677730,11338865,
2021-11-19,35458,3859,7745,,23600492,11750333,404012,22692642,11346321,
2021-11-20,40107,4381,8814,,23640599,11754434,399570,22709728,11354864,
2021-11-21,28108,3432,6942,,23668707,11757604,396046,22723116,11361558,
2021-11-22,14895,1950,3892,,23683602,11759278,394098,22730360,11365180,
2021-11-23,33042,3272,6004,,23716644,11762270,391358,22741824,11370912,
2021-11-24,42638,3752,6796,,23759282,11765718,388303,22754830,11377415,
2021-11-25,46032,3931,6565,,23805314,11769374,385666,22767416,11383708,
2021-11-26,52855,11343,6611,,23858169,11780447,390391,22780112,11390056,
2021-11-27,63502,22349,7029,,23921671,11802515,405701,22793628,11396814,
2021-11-28,51449,27739,5308,,23973120,11829962,428120,22803684,11401842,
2021-11-29,33523,18933,2879,,24006643,11848634,444163,22808942,11404471,
2021-11-30,56017,20678,5126,,24062660,11869031,459705,22818652,11409326,
2021-12-01,69535,26240,5634,,24132195,11894965,480297,22829336,11414668,
2021-12-02,71621,26486,5033,,24203816,11921153,501737,22838832,11419416,
2021-12-03,73410,25096,5164,,24277226,11945953,521663,22848580,11424290,
2021-12-04,81142,27782,6066,47274,24358368,11973442,543370,,11430072,807571
2021-12-05,62617,31926,4405,26266,24420985,12005073,570883,,11434190,833733
2021-12-06,38622,19141,2711,16754,24459607,12023925,587306,,11436619,850409
2021-12-07,60277,14850,4467,40947,24519884,12038503,597679,,11440824,891282
2021-12-08,73439,19054,4675,49707,24593323,12057280,612048,,11445232,940911
2021-12-09,74487,18271,4339,51858,24667810,12075242,625972,,11449270,992684
2021-12-10,77476,17588,4651,55228,24745286,12092549,638904,,11453645,1047831
2021-12-11,83169,20403,5823,56931,24828455,12112663,653470,,11459193,1104676
2021-12-12,60747,22696,4153,33855,24889202,12135079,672007,,11463072,1138442
2021-12-13,34925,11601,2406,20895,24924127,12146383,681192,,11465191,1159242
2021-12-14,101964,8999,3857,89065,25026091,12155071,686319,,11468752,1248187
2021-12-15,127683,12426,4505,110714,25153774,12167193,694230,,11472963,1358801
2021-12-16,139330,12451,4240,122624,25293104,12179358,702431,,11476927,1481326
2021-12-17,159157,12401,4512,142222,25452261,12191484,710311,,11481173,1623451
2021-12-18,175582,13523,4922,157092,25627843,12204713,718900,,11485813,1780448
2021-12-19,140427,18157,3927,118308,25768270,12222569,733122,,11489447,1898645
2021-12-20,106817,10304,2743,93723,25875087,12232605,740673,,11491932,1992270
2021-12-21,215358,12962,4310,198064,26090445,12245251,749318,,11495933,2190213
2021-12-22,237236,14418,5195,217738,26327681,12259370,758527,,11500843,2407833
2021-12-23,257705,11717,5081,240810,26585386,12270782,765157,,11505625,2648537
2021-12-24,223461,9444,4564,209386,26808847,12279929,770033,,11509896,2857807
2021-12-25,89717,3885,2505,83339,26898564,12283539,771408,,11512131,2941039
2021-12-26,11894,387,358,11139,26910458,12283634,771429,,11512205,2952048
2021-12-27,46937,1491,1113,44302,26957395,12284880,771800,,11513080,2996230
2021-12-28,144768,6100,4005,134603,27102163,12290686,773884,,11516802,3130702
2021-12-29,175459,9376,4577,161435,27277622,12299766,778679,,11521087,3292009
2021-12-30,200051,10131,5344,184534,27477673,12309594,783451,,11526143,3476409
2021-12-31,195193,10006,5797,179139,27672866,12319311,787651,,11531660,3655422
2022-01-01,96943,5381,3876,87361,27769809,12324383,789148,,11535235,3742634
2022-01-02,19442,941,928,17444,27789251,12325033,789152,,11535881,3759932
2022-01-03,88250,4772,4591,78806,27877501,12329495,789325,,11540170,3838585
2022-01-04,146355,5996,5313,135006,28023856,12335163,789995,,11545168,3973435
2022-01-05,177487,7624,7291,162400,28201343,12342433,790317,,11552116,4135675
2022-01-06,191515,7201,6782,177006,28392858,12349315,790725,,11558590,4312526
2022-01-07,191262,7960,6990,175499,28584120,12356931,791683,,11565248,4487852
2022-01-08,181658,8625,6632,165213,28765778,12365224,793663,,11571561,4652909
2022-01-09,131094,9865,7180,113956,28896872,12374767,796343,,11578424,4766705
2022-01-10,90556,5107,4489,80829,28987428,12379552,796951,,11582601,4847381
2022-01-11,138865,6153,6566,125440,29126293,12385358,796525,,11588833,4972631
2022-01-12,157012,8157,8052,138680,29283305,12393186,796625,,11596561,5111143
2022-01-13,162677,9210,9214,141543,29445982,12402034,796607,,11605427,5252503
2022-01-14,159865,10751,10375,136049,29605847,12412424,796978,,11615446,5388354
2022-01-15,161196,11012,11671,135879,29767043,12423065,796308,,11626757,5524040
2022-01-16,109776,9290,9673,89453,29876819,12431993,795918,,11636075,5613275
2022-01-17,65780,5935,6564,52640,29942599,12437592,795279,,11642313,5665730
2022-01-18,36103,2003,2128,31148,29978702,12439240,795143,,11644097,5696682
2022-01-19,101313,5581,6717,85954,30080015,12444421,793989,,11650432,5782409
2022-01-20,103591,6321,7004,85728,30183606,12450358,793298,,11657060,5867914
2022-01-21,102100,6229,8059,82500,30285706,12456183,791454,,11664729,5950186
2022-01-22,102566,8711,12068,78109,30388272,12464505,788090,,11676415,6028067
2022-01-23,76688,7307,13991,54790,30464960,12471469,781399,,11690070,6082635
2022-01-24,42261,3195,7935,30742,30507221,12474300,776641,,11697659,6113170
2022-01-25,62556,3755,8368,48114,30569777,12477676,772013,,11705663,6161065
2022-01-26,77881,4912,13170,55691,30647658,12482211,763750,,11718461,6216514
2022-01-27,78071,4895,13243,56047,30725729,12486734,755392,,11731342,6272324
2022-01-28,77280,4672,13674,53895,30803009,12491048,746377,,11744671,6326000
2022-01-29,84812,5526,17712,58112,30887821,12496210,734184,,11762026,6383867
2022-01-30,66500,5025,20626,40154,30954321,12500893,718569,,11782324,6423796
2022-01-31,34742,2175,9880,22348,30989063,12502749,710855,,11791894,6445955
2022-02-01,51348,3264,9663,36526,31040411,12505660,704446,,11801214,6482256
2022-02-02,57706,3844,12397,38679,31098117,12509173,695878,,11813295,6520735
2022-02-03,52575,3610,11508,34299,31150692,12512406,687968,,11824438,6554783
2022-02-04,43087,2947,10559,27283,31193779,12515043,680346,,11834697,6581872
2022-02-05,58715,3742,14470,37563,31252494,12518453,669606,,11848847,6619222
2022-02-06,49857,3639,16115,29572,31302351,12521769,657125,,11864644,6648570
2022-02-07,23232,1690,7809,13440,31325583,12523133,650993,,11872140,6661786
2022-02-08,33386,2355,7244,21970,31358969,12525158,646097,,11879061,6683523
2022-02-09,38874,2781,8914,24410,31397843,12527580,639958,,11887622,6707681
2022-02-10,37535,2764,8835,22551,31435378,12530008,633883,,11896125,6730002
2022-02-11,39447,2724,10291,23005,31474825,12532386,626307,,11906079,6752769
2022-02-12,42040,2954,11453,25316,31516865,12535006,617797,,11917209,6777861
2022-02-13,36313,2799,13141,19940,31553178,12537518,607452,,11930066,6797603
2022-02-14,16974,1175,6119,9472,31570152,12538418,602500,,11935918,6806875
2022-02-15,19348,1384,4747,11877,31589500,12539478,599127,,11940351,6818525
2022-02-16,26017,1766,7729,14947,31615517,12540947,593160,,11947787,6833271
2022-02-17,26760,1683,7521,14984,31642277,12542275,587313,,11954962,6848000
2022-02-18,23936,1354,6607,13675,31666213,12543312,582048,,11961264,6861466
2022-02-19,37832,1902,8337,26050,31704045,12544883,575608,,11969275,6887275
2022-02-20,32573,1497,7963,22804,31736618,12546080,569134,,11976946,6909875
2022-02-21,17502,913,3678,12757,31754120,12546698,566360,,11980338,6922421
2022-02-22,9103,428,1550,6955,31763223,12546836,565233,,11981603,6929165
2022-02-23,25329,1326,4792,17292,31788552,12547852,561760,,11986092,6946221
2022-02-24,24571,1401,5233,15482,31813123,12548931,557923,,11991008,6961460
2022-02-25,23100,1389,5137,14507,31836223,12550026,554168,,11995858,6975741
2022-02-26,25227,1384,5908,16555,31861450,12551100,549637,,12001463,6992070
2022-02-27,26953,1370,7367,17702,31888403,12552201,543629,,12008572,7009577
2022-02-28,10127,594,2529,6745,31898530,12552542,541686,,12010856,7016139
2022-03-01,13194,945,3150,8165,31911724,12553182,539471,,12013711,7024087
2022-03-02,15411,1163,3575,9616,31927135,12554084,537052,,12017032,7033526
2022-03-03,14296,1077,3226,8688,31941431,12554849,534895,,12019954,7041983
2022-03-04,14470,991,3442,8314,31955901,12555519,532440,,12023079,7050044
2022-03-05,18527,1276,4995,11183,31974428,12556486,528710,,12027776,7061003
2022-03-06,16512,1088,5523,9604,31990940,12557294,524269,,12033025,7070400
2022-03-07,5947,466,1861,3509,31996887,12557475,522867,,12034608,7073692
2022-03-08,7360,698,1942,4158,32004247,12557895,521616,,12036279,7077651
2022-03-09,11155,906,2736,6406,32015402,12558525,519780,,12038745,7083855
2022-03-10,12757,1044,3254,6836,32028159,12559292,517563,,12041729,7090478
2022-03-11,12887,904,3406,6864,32041046,12559907,515053,,12044854,7097126
2022-03-12,14681,1046,4181,8310,32055727,12560681,511915,,12048766,7105232
2022-03-13,14745,1091,4999,8330,32070472,12561481,508003,,12053478,7113325
2022-03-14,6331,449,2228,3498,32076803,12561659,506221,,12055438,7116609
2022-03-15,10196,791,2625,5972,32086999,12562160,504375,,12057785,7122367
2022-03-16,13060,934,3664,6953,32100059,12562806,501642,,12061164,7129090
2022-03-17,13193,1047,3958,6756,32113252,12563565,498724,,12064841,7135626
2022-03-18,11904,913,3145,6432,32125156,12564175,496482,,12067693,7141834
2022-03-19,14437,1003,4161,7901,32139593,12564898,493322,,12071576,7149516
2022-03-20,11742,990,3955,6370,32151335,12565617,490352,,12075265,7155678
2022-03-21,5057,414,1589,2814,32156392,12565772,489173,,12076599,7158289
2022-03-22,6706,552,1558,3889,32163098,12566036,488161,,12077875,7161962
2022-03-23,9968,785,2298,5194,32173066,12566505,486645,,12079860,7166915
2022-03-24,9295,724,2377,4610,32182361,12566965,484983,,12081982,7171321
2022-03-25,9220,782,2153,4747,32191581,12567484,483604,,12083880,7175856
2022-03-26,10924,935,2832,5506,32202505,12568142,481705,,12086437,7181143
2022-03-27,10224,909,3537,5301,32212729,12568791,479073,,12089718,7186233
2022-03-28,3580,320,1108,1987,32216309,12568871,478282,,12090589,7188026
2022-03-29,5342,498,1211,2692,32221651,12569084,477563,,12091521,7190496
2022-03-30,7853,749,1835,4122,32229504,12569554,476472,,12093082,7194393
2022-03-31,8648,689,1924,4413,32238152,12569954,475231,,12094723,7198584
2022-04-01,9308,802,1914,4886,32247460,12570464,474110,,12096354,7203231
2022-04-02,10440,886,2214,5570,32257900,12571063,472770,,12098293,7208584
2022-04-03,9202,880,2567,5065,32267102,12571686,471077,,12100609,7213447
2022-04-04,4200,387,1006,2406,32271302,12571812,470455,,12101357,7215650
2022-04-05,6070,600,1036,3050,32277372,12572072,470013,,12102059,7218425
2022-04-06,8374,714,1477,4381,32285746,12572495,469245,,12103250,7222579
2022-04-07,10341,733,1687,4836,32296087,12572928,468286,,12104642,7227172
2022-04-08,23990,811,1582,4835,32320077,12573461,467509,,12105952,7231791
2022-04-09,30492,969,1972,5895,32350569,12574132,466497,,12107635,7237463
2022-04-10,24860,976,2389,5331,32375429,12574849,465078,,12109771,7242592
2022-04-11,12570,385,876,2431,32387999,12574984,464583,,12110401,7244821
2022-04-12,28118,693,1017,3535,32416117,12575373,464252,,12111121,7248123
2022-04-13,37780,853,1560,4928,32453897,12575927,463541,,12112386,7252821
2022-04-14,37901,761,1615,4913,32491798,12576376,462684,,12113692,7257481
2022-04-15,43393,1230,2101,6725,32535191,12577308,461809,,12115499,7263969
2022-04-16,8092,358,650,1739,32543283,12577406,461515,,12115891,7265492
2022-04-17,21010,870,1924,4317,32564293,12577992,460454,,12117538,7269586
2022-04-18,5457,305,461,1289,32569750,12578010,460293,,12117717,7270634
2022-04-19,22650,615,773,3103,32592400,12578342,460126,,12118216,7273517
2022-04-20,40330,1063,1395,4619,32632730,12579079,459791,,12119288,7277872
2022-04-21,38753,943,1600,4682,32671483,12579726,459125,,12120601,7282320
2022-04-22,35618,1013,1431,4266,32707101,12580467,458700,,12121767,7286368
2022-04-23,34649,1006,1735,4712,32741750,12581189,457968,,12123221,7290841
2022-04-24,20814,1021,1887,3777,32762564,12581960,457099,,12124861,7294424
2022-04-25,8298,453,691,1707,32770862,12582144,456860,,12125284,7295915
2022-04-26,24614,732,945,3142,32795476,12582584,456641,,12125943,7298820
2022-04-27,33597,955,1368,3936,32829073,12583263,456220,,12127043,7302539
2022-04-28,32834,928,1413,3930,32861907,12583918,455726,,12128192,7306246
2022-04-29,32058,1099,1379,3911,32893965,12584719,455439,,12129280,7309928
2022-04-30,30280,923,1534,4024,32924245,12585345,454821,,12130524,7313716
2022-05-01,16752,769,1579,2970,32940997,12585817,454006,,12131811,7316443
2022-05-02,5933,309,524,1097,32946930,12585830,453787,,12132043,7317313
2022-05-03,20928,588,831,2347,32967858,12586113,453538,,12132575,7319421
2022-05-04,29416,799,1091,3294,32997274,12586602,453241,,12133361,7322466
2022-05-05,29094,873,1161,3124,33026368,12587163,452943,,12134220,7325346
2022-05-06,29094,1147,1283,2986,33055462,12588022,452802,,12135220,7328105
2022-05-07,28487,869,1262,3113,33083949,12588601,452404,,12136197,7330994
2022-05-08,15998,896,1309,2323,33099947,12589240,451989,,12137251,7333116
2022-05-09,5897,293,474,943,33105844,12589267,451802,,12137465,7333849
2022-05-10,21226,696,719,2120,33127070,12589645,451772,,12137873,7335709
2022-05-11,28947,837,1083,2655,33156017,12590149,451522,,12138627,7338092
2022-05-12,28239,799,1084,2512,33184256,12590651,451233,,12139418,7340363
2022-05-13,27592,878,1117,2468,33211848,12591218,450989,,12140229,7342574
2022-05-14,25690,807,1098,2609,33237538,12591710,450691,,12141019,7344929
2022-05-15,14846,751,1274,2056,33252384,12592189,450161,,12142028,7346766
2022-05-16,6381,325,532,1047,33258765,12592276,449950,,12142326,7347626
2022-05-17,19602,588,778,1742,33278367,12592548,449753,,12142795,7349119
2022-05-18,26542,878,1100,2272,33304909,12593162,449526,,12143636,7351176
2022-05-19,24438,682,1156,2160,33329347,12593577,449045,,12144532,7353119
2022-05-20,24262,801,1136,2216,33353609,12594110,448706,,12145404,7355117
2022-05-21,22400,692,1167,2346,33376009,12594493,448222,,12146271,7357221
2022-05-22,10558,551,888,1488,33386567,12594783,447880,,12146903,7358492
2022-05-23,4565,242,462,787,33391132,12594765,447658,,12147107,7359070
2022-05-24,2618,119,179,435,33393750,12594631,447596,,12147035,7359296
2022-05-25,19360,655,947,1951,33413110,12595020,447294,,12147726,7361037
2022-05-26,20640,665,949,1908,33433750,12595412,447004,,12148408,7362723
2022-05-27,21756,818,1057,2075,33455506,12595942,446762,,12149180,7364565
2022-05-28,19403,721,1165,2147,33474909,12596393,446315,,12150078,7366498
2022-05-29,12110,761,1281,1725,33487019,12596919,445788,,12151131,7368031
2022-05-30,4580,311,550,751,33491599,12596984,445546,,12151438,7368584
2022-05-31,13546,572,749,1665,33505145,12597254,445363,,12151891,7370009
2022-06-01,16609,702,970,1878,33521754,12597653,445093,,12152560,7371633
2022-06-02,14603,557,867,1675,33536357,12597898,444776,,12153122,7373067
2022-06-03,16101,697,1095,1814,33552458,12598317,444372,,12153945,7374663
2022-06-04,13321,648,1164,1843,33565779,12598707,443851,,12154856,7376304
2022-06-05,7866,587,1109,1432,33573645,12599045,443325,,12155720,7377544
2022-06-06,3293,206,444,641,33576938,12599003,443084,,12155919,7377984
2022-06-07,11218,475,726,1370,33588156,12599178,442828,,12156350,7379110
2022-06-08,14063,667,1013,1609,33602219,12599585,442477,,12157108,7380500
2022-06-09,13372,662,923,1674,33615591,12599959,442211,,12157748,7381942
2022-06-10,13851,685,1068,1697,33629442,12600358,441820,,12158538,7383409
2022-06-11,12982,616,1030,1844,33642424,12600688,441404,,12159284,7385030
2022-06-12,8096,643,1236,1503,33650520,12601074,440807,,12160267,7386327
2022-06-13,3187,284,422,710,33653707,12601092,440664,,12160428,7386828
2022-06-14,10127,511,666,1264,33663834,12601314,440503,,12160811,7387854
2022-06-15,13506,471,832,1620,33677340,12601490,440140,,12161350,7389237
2022-06-16,12541,494,856,1616,33689881,12601679,439773,,12161906,7390606
2022-06-17,11690,480,818,1652,33701571,12601873,439428,,12162445,7392023
2022-06-18,11450,436,874,1860,33713021,12602038,438987,,12163051,7393659
2022-06-19,7002,483,898,1419,33720023,12602270,438571,,12163699,7394865
2022-06-20,2286,147,301,643,33722309,12602193,438411,,12163782,7395338
2022-06-21,9541,357,615,1384,33731850,12602263,438148,,12164115,7396474
2022-06-22,13607,406,724,1703,33745457,12602397,437823,,12164574,7397952
2022-06-23,13703,401,775,1683,33759160,12602531,437446,,12165085,7399421
2022-06-24,15363,435,811,1673,33774523,12602706,437066,,12165640,7400879
2022-06-25,14468,425,851,1713,33788991,12602870,436629,,12166241,7402383
2022-06-26,8156,432,885,1278,33797147,12603040,436169,,12166871,7403444
2022-06-27,3212,171,364,594,33800359,12602962,435972,,12166990,7403831
2022-06-28,9619,369,557,1226,33809978,12603046,435780,,12167266,7404825
2022-06-29,13312,414,729,1631,33823290,12603170,435463,,12167707,7406216
2022-06-30,12228,482,847,1576,33835518,12603368,435096,,12168272,7407559
2022-07-01,13038,548,971,1949,33848556,12603658,434668,,12168990,7409302
2022-07-02,1612,110,115,363,33850168,12603492,434661,,12168831,7409433
2022-07-03,5159,260,493,960,33855327,12603495,434419,,12169076,7410177
2022-07-04,2757,132,279,614,33858084,12603380,434271,,12169109,7410594
2022-07-05,11142,372,599,1573,33869226,12603455,434036,,12169419,7411919
2022-07-06,15956,545,857,2009,33885182,12603705,433718,,12169987,7413686
2022-07-07,15662,520,832,1924,33900844,12603937,433405,,12170532,7415357
2022-07-08,17883,555,870,2244,33918727,12604187,433089,,12171098,7417352
2022-07-09,14139,450,597,1843,33932866,12604361,432941,,12171420,7418959
2022-07-10,8746,475,754,1502,33941612,12604588,432661,,12171927,7420255
2022-07-11,4092,199,331,870,33945704,12604522,432526,,12171996,7420905
2022-07-12,12105,412,523,1654,33957809,12604635,432410,,12172225,7422305
2022-07-13,16719,564,772,2143,33974528,12604903,432196,,12172707,7424205
2022-07-14,16859,485,675,2023,33991387,12605082,431995,,12173087,7425988
2022-07-15,28891,598,822,2184,34020278,12605380,431770,,12173610,7427931
2022-07-16,30296,586,771,2327,34050574,12605652,431576,,12174076,7430006
2022-07-17,22928,537,636,1888,34073502,12605952,431474,,12174478,7431700
2022-07-18,11396,188,254,857,34084898,12605872,431403,,12174469,7432335
2022-07-19,28953,593,591,2135,34113851,12606190,431402,,12174788,7434238
2022-07-20,37636,840,923,2591,34151487,12606751,431314,,12175437,7436592
2022-07-21,36354,732,810,2807,34187841,12607196,431229,,12175967,7439159
2022-07-22,35797,824,891,2683,34223638,12607733,431156,,12176577,7441605
2022-07-23,35146,820,912,2832,34258784,12608238,431056,,12177182,7444181
2022-07-24,21735,599,804,1775,34280519,12608574,430848,,12177726,7445731
2022-07-25,11934,308,311,1080,34292453,12608598,430840,,12177758,7446581
2022-07-26,26089,619,603,2211,34318542,12608934,430855,,12178079,7448550
2022-07-27,32467,809,847,2649,34351009,12609484,430815,,12178669,7450988
2022-07-28,31536,724,884,2605,34382545,12609911,430651,,12179260,7453342
2022-07-29,29992,1791,875,2645,34412537,12611410,431563,,12179847,7455737
2022-07-30,25829,2526,747,2435,34438366,12613655,433340,,12180315,7457938
2022-07-31,14302,1068,541,1559,34452668,12614454,433863,,12180591,7459269
2022-08-01,5913,337,223,681,34458581,12614532,433975,,12180557,7459727
2022-08-02,4476,305,135,602,34463057,12614567,434141,,12180426,7460107
2022-08-03,22936,2636,737,2239,34485993,12616927,436036,,12180891,7462110
2022-08-04,22230,2482,679,2131,34508223,12619082,437833,,12181249,7463978
2022-08-05,21792,2756,744,2067,34530015,12621557,439837,,12181720,7465817
2022-08-06,19644,2877,657,1991,34549659,12624123,442051,,12182072,7467550
2022-08-07,12704,2236,620,1421,34562363,12626084,443661,,12182423,7468753
2022-08-08,4766,570,188,603,34567129,12626366,444036,,12182330,7469119
2022-08-09,14009,1466,558,1591,34581138,12627545,444938,,12182607,7470469
2022-08-10,19129,2365,718,1991,34600267,12629637,446583,,12183054,7472232
2022-08-11,17074,2040,718,1854,34617341,12631401,447903,,12183498,7473853
2022-08-12,16981,2048,734,1852,34634322,12633160,449216,,12183944,7475476
2022-08-13,15951,2223,763,1807,34650273,12635101,450674,,12184427,7477044
2022-08-14,9524,1621,618,1083,34659797,12636433,451673,,12184760,7477891
2022-08-15,3870,388,270,477,34663667,12636568,451788,,12184780,7478159
2022-08-16,10804,1073,514,1356,34674471,12637342,452345,,12184997,7479265
2022-08-17,16096,1833,739,1782,34690567,12638888,453438,,12185450,7480811
2022-08-18,14930,1641,748,1693,34705497,12640204,454327,,12185877,7482232
2022-08-19,15314,1846,749,1550,34720811,12641773,455420,,12186353,7483548
2022-08-20,14283,1641,740,1545,34735094,12643123,456315,,12186808,7484855
2022-08-21,9901,1532,660,1163,34744995,12644390,457183,,12187207,7485801
2022-08-22,4163,481,271,561,34749158,12644568,457390,,12187178,7486103
2022-08-23,11132,1248,554,1493,34760290,12645509,458080,,12187429,7487344
2022-08-24,14757,1808,870,2185,34775047,12647046,459018,,12188028,7489298
2022-08-25,14028,1718,780,2121,34789075,12648476,459949,,12188527,7491174
2022-08-26,13926,1689,815,2090,34803001,12649870,460816,,12189054,7493015
2022-08-27,12413,1485,876,1998,34815414,12651030,461419,,12189611,7494747
2022-08-28,7923,1258,621,1397,34823337,12652028,462054,,12189974,7495925
2022-08-29,3397,502,286,682,34826734,12652250,462265,,12189985,7496374
2022-08-30,9905,1169,649,1855,34836639,12653063,462779,,12190284,7497928
2022-08-31,13510,1627,946,2312,34850149,12654400,463456,,12190944,7499997
2022-09-01,12905,1721,912,2140,34863054,12655825,464260,,12191565,7501891
2022-09-02,15042,1615,991,4917,34878096,12657165,464876,,12192289,7506582
2022-09-03,14713,1524,922,5513,34892809,12658407,465475,,12192932,7511861
2022-09-04,8664,1010,675,3235,34901473,12659153,465801,,12193352,7514876
2022-09-05,3554,321,229,1386,34905027,12659209,465890,,12193319,7516040
2022-09-06,2464,158,114,1128,34907491,12659113,465931,,12193182,7516959
2022-09-07,10924,1018,587,3491,34918415,12659833,466358,,12193475,7520199
2022-09-08,10867,1021,525,2790,34929282,12660526,466851,,12193675,7522713
2022-09-09,9580,1012,488,2501,34938862,12661251,467370,,12193881,7524979
2022-09-10,10633,1264,551,3165,34949495,12662239,468076,,12194163,7527911
2022-09-11,9408,982,667,3735,34958903,12662973,468385,,12194588,7531437
2022-09-12,3124,294,204,1079,34962027,12662985,468469,,12194516,7532279
2022-09-13,6014,542,281,1132,34968041,12663242,468721,,12194521,7533169
2022-09-14,14481,797,434,1845,34982522,12663721,469080,,12194641,7534748
2022-09-15,15752,779,408,1532,34998274,12664180,469446,,12194734,7536009
2022-09-16,17755,766,447,1690,35016029,12664687,469759,,12194928,7537479
2022-09-17,17612,722,456,1666,35033641,12665105,470021,,12195084,7538891
2022-09-18,11212,775,451,1686,35044853,12665622,470343,,12195279,7540356
2022-09-19,4978,404,288,670,35049831,12665757,470455,,12195302,7540814
2022-09-20,13768,443,332,944,35063599,12665885,470564,,12195321,7541495
2022-09-21,23036,646,409,1496,35086635,12666223,470796,,12195427,7542737
2022-09-22,22909,636,398,1378,35109544,12666552,471028,,12195524,7543854
2022-09-23,22942,725,600,1418,35132486,12666978,471148,,12195830,7545018
2022-09-24,21689,737,690,1498,35154175,12667421,471191,,12196230,7546280
2022-09-25,11318,595,702,1355,35165493,12667739,471078,,12196661,7547403
2022-09-26,4561,192,218,594,35170054,12667641,471046,,12196595,7547754
2022-09-27,37649,498,365,1497,35207703,12667872,471175,,12196697,7549026
2022-09-28,50965,731,671,1900,35258668,12668334,471234,,12197100,7550700
2022-09-29,47998,637,740,1836,35306666,12668654,471123,,12197531,7552262
2022-09-30,47270,678,806,2002,35353936,12669006,470993,,12198013,7553983
2022-10-01,34445,526,633,1545,35388381,12669226,470884,,12198342,7555263
2022-10-02,24245,736,1028,1711,35412626,12669669,470589,,12199080,7556723
2022-10-03,10866,238,230,611,35423492,12669616,470593,,12199023,7557096
2022-10-04,32192,478,459,1169,35455684,12669775,470608,,12199167,7557989
2022-10-05,40427,625,740,1561,35496111,12670085,470487,,12199598,7559289
2022-10-06,38690,610,653,1569,35534801,12670392,470442,,12199950,7560598
2022-10-07,42234,661,852,1741,35577035,12670709,470243,,12200466,7562041
2022-10-08,37389,783,1145,2120,35614424,12671162,469875,,12201287,7563887
2022-10-09,18813,549,727,1556,35633237,12671436,469694,,12201742,7565208
2022-10-10,6864,170,370,567,35640101,12671308,469491,,12201817,7565515
2022-10-11,4992,124,111,318,35645093,12671138,469499,,12201639,7565595
2022-10-12,35110,579,685,1427,35680203,12671385,469391,,12201994,7566734
2022-10-13,36755,645,858,1619,35716958,12671670,469175,,12202495,7568049
2022-10-14,36973,621,752,1542,35753931,12671962,469041,,12202921,7569312
2022-10-15,35450,715,1013,1626,35789381,12672388,468740,,12203648,7570691
2022-10-16,20662,654,1024,1593,35810043,12672774,468364,,12204410,7572055
2022-10-17,7353,206,477,539,35817396,12672698,468091,,12204607,7572355
2022-10-18,36420,457,500,1397,35853816,12672839,468043,,12204796,7573483
2022-10-19,49896,619,729,1982,35903712,12673160,467930,,12205230,7575217
2022-10-20,51280,624,649,2048,35954992,12673474,467902,,12205572,7577004
2022-10-21,52842,697,618,1935,36007834,12673846,467977,,12205869,7578671
2022-10-22,50861,751,904,2309,36058695,12674271,467819,,12206452,7580709
2022-10-23,30633,578,783,2118,36089328,12674537,467608,,12206929,7582566
2022-10-24,14132,232,271,978,36103460,12674472,467564,,12206908,7583291
2022-10-25,41358,473,489,1818,36144818,12674600,467545,,12207055,7584817
2022-10-26,51645,617,660,2124,36196463,12674887,467498,,12207389,7586665
2022-10-27,50106,607,768,2162,36246569,12675173,467329,,12207844,7588561
2022-10-28,49792,590,675,2094,36296361,12675411,467239,,12208172,7590352
2022-10-29,50587,734,778,2219,36346948,12675799,467191,,12208608,7592273
2022-10-30,28392,661,930,2037,36375340,12676182,466918,,12209264,7594070
2022-10-31,12437,199,234,777,36387777,12676107,466880,,12209227,7594616
2022-11-01,33085,339,198,1220,36420862,12676105,467015,,12209090,7595546
2022-11-02,44276,575,623,1903,36465138,12676357,466963,,12209394,7597158
2022-11-03,44181,540,605,1855,36509319,12676575,466894,,12209681,7598734
2022-11-04,44633,650,528,2027,36553952,12676924,467009,,12209915,7600509
2022-11-05,45198,649,753,2370,36599150,12677275,466902,,12210373,7602615
2022-11-06,26016,559,771,2097,36625166,12677498,466687,,12210811,7604420
2022-11-07,10710,243,235,876,36635876,12677466,466692,,12210774,7605068
2022-11-08,33474,487,395,1585,36669350,12677670,466781,,12210889,7606414
2022-11-09,40527,604,570,1964,36709877,12677964,466813,,12211151,7608115
2022-11-10,39167,622,547,1928,36749044,12678273,466883,,12211390,7609773
2022-11-11,43334,633,641,2209,36792378,12678593,466874,,12211719,7611711
2022-11-12,36842,638,591,2183,36829220,12678912,466913,,12211999,7613616
2022-11-13,24266,559,770,2276,36853486,12679185,466696,,12212489,7615648
2022-11-14,10966,233,204,1024,36864452,12679130,466724,,12212406,7616420
2022-11-15,33606,484,380,1691,36898058,12679254,466824,,12212430,7617806
2022-11-16,43531,798,583,2370,36941589,12679759,467033,,12212726,7619930
2022-11-17,38341,673,646,2241,36979930,12680104,467056,,12213048,7621891
2022-11-18,40619,727,531,2330,37020549,12680492,467248,,12213244,7623925
2022-11-19,39647,1007,1030,3062,37060196,12681159,467221,,12213938,7626686
2022-11-20,22418,661,718,2440,37082614,12681549,467160,,12214389,7628900
2022-11-21,8920,197,192,969,37091534,12681485,467160,,12214325,7629665
2022-11-22,26438,480,368,1512,37117972,12681616,467268,,12214348,7630872
2022-11-23,32075,686,669,2069,37150047,12681979,467283,,12214696,7632667
2022-11-24,31896,663,750,2083,37181943,12682335,467194,,12215141,7634494
2022-11-25,30751,764,828,1950,37212694,12682794,467124,,12215670,7636188
2022-11-26,30278,907,1191,2696,37242972,12683370,466831,,12216539,7638602
2022-11-27,18675,608,944,2087,37261647,12683681,466490,,12217191,7640438
2022-11-28,7537,191,280,786,37269184,12683583,466394,,12217189,7640971
2022-11-29,21016,421,452,1291,37290200,12683684,466359,,12217325,7641990
2022-11-30,27888,644,649,1841,37318088,12684020,466352,,12217668,7643564
2022-12-01,24801,593,681,1693,37342889,12684292,466261,,12218031,7644977
2022-12-02,25051,525,630,1771,37367940,12684499,466150,,12218349,7646473
2022-12-03,25553,587,780,1944,37393493,12684771,465947,,12218824,7648161
2022-12-04,15246,495,606,1701,37408739,12684943,465831,,12219112,7649576
2022-12-05,6877,168,156,746,37415616,12684824,465838,,12218986,7650079
2022-12-06,20341,421,351,1376,37435957,12684888,465903,,12218985,7651152
2022-12-07,24776,553,607,1670,37460733,12685134,465843,,12219291,7652559
2022-12-08,23161,564,522,1761,37483894,12685392,465883,,12219509,7654051
2022-12-09,23322,635,574,1632,37507216,12685711,465941,,12219770,7655416
2022-12-10,22568,511,600,1627,37529784,12685919,465849,,12220070,7656779
2022-12-11,14201,548,786,1566,37543985,12686208,465608,,12220600,7658122
2022-12-12,5506,149,156,595,37549491,12686075,465596,,12220479,7658481
2022-12-13,17793,376,369,1124,37567284,12686140,465601,,12220539,7659341
2022-12-14,21318,511,547,1454,37588602,12686369,465559,,12220810,7660559
2022-12-15,21962,531,602,1579,37610564,12686575,465486,,12221089,7661857
2022-12-16,16284,379,450,1030,37626848,12686637,465412,,12221225,7662619
2022-12-17,18696,557,507,1275,37645544,12686884,465460,,12221424,7663617
2022-12-18,12637,529,794,1306,37658181,12687144,465194,,12221950,7664682
2022-12-19,4585,131,116,449,37662766,12686959,465205,,12221754,7664858
2022-12-20,16203,501,449,1106,37678969,12687154,465250,,12221904,7665705
2022-12-21,18468,545,552,1299,37697437,12687411,465239,,12222172,7666753
2022-12-22,18594,575,589,1745,37716031,12687698,465225,,12222473,7668247
2022-12-23,15639,580,598,1712,37731670,12687938,465202,,12222736,7669675
2022-12-24,5336,224,171,672,37737006,12687869,465254,,12222615,7670085
2022-12-25,2443,153,153,480,37739449,12687727,465245,,12222482,7670310
2022-12-26,262,12,7,48,37739711,12687453,465245,,12222208,7670114
2022-12-27,2094,98,36,306,37741805,12687276,465304,,12221972,7670190
2022-12-28,8317,337,167,975,37750122,12687313,465469,,12221844,7670902
2022-12-29,13159,584,524,1601,37763281,12687589,465525,,12222064,7672237
2022-12-30,15818,666,658,1882,37779099,12687961,465530,,12222431,7673856
2022-12-31,11230,462,386,1354,37790329,12688088,465602,,12222486,7674920
2023-01-01,3907,201,219,563,37794236,12687990,465584,,12222406,7675218
2023-01-02,651,36,14,97,37794887,12687753,465605,,12222148,7675077
2023-01-03,8194,297,151,900,37803081,12687778,465745,,12222033,7675747
2023-01-04,14719,576,547,1544,37817800,12688077,465768,,12222309,7677047
2023-01-05,16115,651,534,1795,37833915,12688438,465877,,12222561,7678591
2023-01-06,18827,717,609,2044,37852742,12688880,465982,,12222898,7680395
2023-01-07,18522,702,638,2055,37871264,12689312,466041,,12223271,7682216
2023-01-08,11611,583,609,1630,37882875,12689651,466012,,12223639,7683631
2023-01-09,5299,215,196,664,37888174,12689572,466029,,12223543,7684045
2023-01-10,12157,416,316,784,37900331,12689697,466127,,12223570,7684575
2023-01-11,15541,458,370,1094,37915872,12689846,466212,,12223634,7685405
2023-01-12,14062,445,408,973,37929934,12689994,466248,,12223746,7686121
2023-01-13,14167,423,345,1040,37944101,12690172,466324,,12223848,7686944
2023-01-14,13381,474,452,1078,37957482,12690364,466341,,12224023,7687773
2023-01-15,9046,465,507,1052,37966528,12690576,466298,,12224278,7688613
2023-01-16,3745,148,130,479,37970273,12690466,466316,,12224150,7688861
2023-01-17,8849,269,179,651,37979122,12690414,466403,,12224011,7689239
2023-01-18,10262,349,272,761,37989384,12690484,466477,,12224007,7689748
2023-01-19,10587,318,318,760,37999971,12690523,466473,,12224050,7690269
2023-01-20,9826,317,272,717,38009797,12690569,466516,,12224053,7690743
2023-01-21,11304,358,398,904,38021101,12690652,466476,,12224176,7691415
2023-01-22,7567,345,404,816,38028668,12690752,466415,,12224337,7692010
2023-01-23,3380,143,131,288,38032048,12690681,466427,,12224254,7692108
2023-01-24,8282,227,166,549,38040330,12690622,466486,,12224136,7692407
2023-01-25,10306,348,297,661,38050636,12690716,466533,,12224183,7692852
2023-01-26,6721,236,203,469,38057357,12690678,466564,,12224114,7693087
2023-01-27,6908,240,197,492,38064265,12690635,466604,,12224031,7693335
2023-01-28,9344,313,339,694,38073609,12690678,466574,,12224104,7693793
2023-01-29,5964,235,341,690,38079573,12690655,466463,,12224192,7694251
2023-01-30,1899,88,79,215,38081472,12690484,466470,,12224014,7694238
2023-01-31,5879,157,150,413,38087351,12690359,466475,,12223884,7694398
2023-02-01,7300,250,248,491,38094651,12690379,466475,,12223904,7694689
2023-02-02,6482,296,239,501,38101133,12690445,466530,,12223915,7695000
2023-02-03,6547,196,192,463,38107680,12690410,466532,,12223878,7695257
2023-02-04,6728,232,306,542,38114408,12690426,466453,,12223973,7695616
2023-02-05,4176,198,291,484,38118584,12690379,466358,,12224021,7695897
2023-02-06,1834,91,98,211,38120418,12690219,466349,,12223870,7695880
2023-02-07,4964,162,181,383,38125382,12690121,466328,,12223793,7696039
2023-02-08,5769,213,206,429,38131151,12690096,466334,,12223762,7696255
2023-02-09,6124,212,244,438,38137275,12690091,466302,,12223789,7696507
2023-02-10,5086,159,207,371,38142361,12690077,466252,,12223825,7696723
2023-02-11,6051,185,259,458,38148412,12690033,466174,,12223859,7696973
2023-02-12,4082,219,342,409,38152494,12690035,466048,,12223987,7697184
2023-02-13,1482,57,87,146,38153976,12689889,466017,,12223872,7697160
2023-02-14,3943,131,179,309,38157919,12689781,465968,,12223813,7697256
2023-02-15,4539,119,191,286,38162458,12689684,465896,,12223788,7697352
2023-02-16,4912,174,285,400,38167370,12689632,465783,,12223849,7697551
2023-02-17,4982,181,210,342,38172352,12689610,465753,,12223857,7697717
2023-02-18,5113,232,294,487,38177465,12689622,465689,,12223933,7698009
2023-02-19,3352,133,243,373,38180817,12689542,465576,,12223966,7698203
2023-02-20,1419,64,54,157,38182236,12689406,465584,,12223822,7698188
2023-02-21,912,25,14,107,38183148,12689236,465593,,12223643,7698118
2023-02-22,4134,131,212,370,38187282,12689167,465507,,12223660,7698322
2023-02-23,4279,163,231,390,38191561,12689095,465432,,12223663,7698505
2023-02-24,3029,138,229,272,38194590,12689032,465337,,12223695,7698594
2023-02-25,5021,214,540,385,38199611,12689033,465010,,12224023,7698800
2023-02-26,3472,146,681,384,38203083,12688965,464473,,12224492,7699000
2023-02-27,1074,37,57,97,38204157,12688804,464450,,12224354,7698932
2023-02-28,2728,99,163,232,38206885,12688660,464384,,12224276,7698944
2023-03-01,3848,138,428,333,38210733,12688550,464092,,12224458,7699050
2023-03-02,4587,158,494,328,38215320,12688462,463750,,12224712,7699170
2023-03-03,4367,160,357,333,38219687,12688399,463551,,12224848,7699299
2023-03-04,4966,207,623,350,38224653,12688390,463133,,12225257,7699457
2023-03-05,2532,110,449,251,38227185,12688271,462793,,12225478,7699505
2023-03-06,1156,48,37,114,38228341,12688112,462802,,12225310,7699438
2023-03-07,3216,87,172,223,38231557,12687939,462714,,12225225,7699443
2023-03-08,4314,133,412,283,38235871,12687839,462434,,12225405,7699516
2023-03-09,4610,172,453,312,38240481,12687784,462148,,12225636,7699636
2023-03-10,3940,101,138,254,38244421,12687683,462109,,12225574,7699714
2023-03-11,4062,140,171,285,38248483,12687633,462075,,12225558,7699827
2023-03-12,2882,109,234,301,38251365,12687526,461945,,12225581,7699935
2023-03-13,862,32,32,105,38252227,12687367,461943,,12225424,7699873
2023-03-14,3078,102,109,256,38255305,12687254,461936,,12225318,7699943
2023-03-15,4098,141,163,310,38259403,12687196,461914,,12225282,7700075
2023-03-16,4017,175,234,277,38263420,12687119,461851,,12225268,7700140
2023-03-17,4290,170,202,308,38267710,12687044,461815,,12225229,7700227
2023-03-18,4356,145,194,296,38272066,12686968,461766,,12225202,7700323
2023-03-19,2721,129,233,255,38274787,12686925,461662,,12225263,7700419
2023-03-20,774,31,19,74,38275561,12686739,461674,,12225065,7700303
2023-03-21,2891,69,84,199,38278452,12686596,461655,,12224941,7700318
2023-03-22,3891,130,131,249,38282343,12686515,461651,,12224864,7700379
2023-03-23,3806,119,171,224,38286149,12686418,461594,,12224824,7700416
2023-03-24,3688,102,115,237,38289837,12686329,461580,,12224749,7700486
2023-03-25,4269,108,171,249,38294106,12686232,461512,,12224720,7700558
2023-03-26,2471,114,212,200,38296577,12686163,461411,,12224752,7700596
2023-03-27,915,48,32,68,38297492,12686048,461427,,12224621,7700521
2023-03-28,3102,86,78,202,38300594,12685929,461429,,12224500,7700542
2023-03-29,4165,128,136,221,38304759,12685841,461418,,12224423,7700572
2023-03-30,3838,109,164,210,38308597,12685756,461363,,12224393,7700603
2023-03-31,3978,141,109,220,38312575,12685695,461394,,12224301,7700647
2023-04-01,4185,136,146,225,38316760,12685643,461383,,12224260,7700708
2023-04-02,2180,58,122,173,38318940,12685479,461316,,12224163,7700686
2023-04-03,779,25,12,53,38319719,12685318,461328,,12223990,7700576
2023-04-04,3403,74,73,168,38323122,12685207,461328,,12223879,7700573
2023-04-05,4355,95,107,247,38327477,12685109,461314,,12223795,7700654
2023-04-06,3694,108,108,188,38331171,12685039,461313,,12223726,7700678
2023-04-07,4595,105,115,242,38335766,12684948,461300,,12223648,7700753
2023-04-08,833,22,11,54,38336599,12684802,461307,,12223495,7700665
2023-04-09,2435,83,103,159,38339034,12684741,461286,,12223455,7700698
2023-04-10,360,9,6,20,38339394,12684589,461283,,12223306,7700586
2023-04-11,2771,35,28,120,38342165,12684417,461290,,12223127,7700519
2023-04-12,6330,104,95,187,38348495,12684366,461297,,12223069,7700572
2023-04-13,6989,105,128,207,38355484,12684296,461271,,12223025,7700622
2023-04-14,6507,89,102,205,38361991,12684217,461255,,12222962,7700681
2023-04-15,6942,108,149,228,38368933,12684161,461213,,12222948,7700767
2023-04-16,3267,86,144,164,38372200,12684077,461154,,12222923,7700782
2023-04-17,863,12,13,49,38373063,12683947,461152,,12222795,7700705
2023-04-18,4771,100,77,160,38377834,12683892,461174,,12222718,7700728
2023-04-19,6556,118,98,176,38384390,12683856,461193,,12222663,7700766
2023-04-20,6297,100,150,208,38390687,12683807,461142,,12222665,7700841
2023-04-21,5750,85,72,132,38396437,12683731,461153,,12222578,7700832
2023-04-22,6379,92,91,180,38402816,12683681,461152,,12222529,7700894
2023-04-23,3285,119,147,171,38406101,12683676,461124,,12222552,7700954
2023-04-24,952,4,12,58,38407053,12683559,461115,,12222444,7700914
2023-04-25,4795,69,70,186,38411848,12683489,461114,,12222375,7700975
2023-04-26,6561,109,93,204,38418409,12683470,461130,,12222340,7701062
2023-04-27,6871,120,152,206,38425280,12683451,461097,,12222354,7701144
2023-04-28,6584,86,86,184,38431864,12683402,461096,,12222306,7701207
2023-04-29,6501,124,109,196,38438365,12683407,461110,,12222297,7701302
2023-04-30,2626,95,127,144,38440991,12683389,461078,,12222311,7701341
2023-05-01,1028,20,17,29,38442019,12683291,461079,,12222212,7701269
2023-05-02,4278,69,55,105,38446297,12683238,461091,,12222147,7701267
2023-05-03,5572,109,107,174,38451869,12683238,461092,,12222146,7701346
2023-05-04,8067,87,85,134,38459936,12683221,461094,,12222127,7701387
2023-05-05,12990,91,96,167,38472926,12683217,461089,,12222128,7701466
2023-05-06,15582,114,94,152,38488508,12683252,461109,,12222143,7701546
2023-05-07,6046,61,96,101,38494554,12683234,461072,,12222162,7701578
2023-05-08,2162,15,4,37,38496716,12683179,461083,,12222096,7701552
2023-05-09,12453,58,50,123,38509169,12683159,461089,,12222070,7701612
2023-05-10,14590,74,78,153,38523759,12683153,461084,,12222069,7701691
2023-05-11,13110,78,71,153,38536869,12683191,461091,,12222100,7701807
2023-05-12,13185,87,76,172,38550054,12683248,461101,,12222147,7701950
2023-05-13,11283,84,76,142,38561337,12683281,461109,,12222172,7702046
2023-05-14,4146,78,89,89,38565483,12683326,461098,,12222228,7702106
2023-05-15,1047,11,7,36,38566530,12683316,461102,,12222214,7702127
2023-05-16,8679,62,48,89,38575209,12683372,461116,,12222256,7702210
2023-05-17,10636,103,79,134,38585845,12683475,461140,,12222335,7702344
2023-05-18,9767,90,69,137,38595612,12683565,461161,,12222404,7702481
