"report_date","previous_day_total_doses_administered","previous_day_at_least_one","previous_day_fully_vaccinated","previous_day_3doses","total_doses_administered","total_individuals_at_least_one","total_individuals_partially_vaccinated","total_doses_in_fully_vaccinated_individuals","total_individuals_fully_vaccinated","total_individuals_3doses"
2021-01-01,6251,6241,2,,32193,32138,32127,22,11,
2021-01-02,4613,4601,6,,36806,36687,36674,26,13,
2021-01-03,5393,5386,3,,42199,42073,42057,32,16,
2021-01-04,5994,5992,0,,48193,48064,48049,30,15,
2021-01-05,9682,9657,20,,57875,57719,57685,68,34,
2021-01-06,12792,12327,450,,70667,70042,69562,960,480,
2021-01-07,16216,15505,697,,86883,85546,84369,2354,1177,
2021-01-08,18037,17022,1002,,104920,102568,100389,4358,2179,
2021-01-09,19500,18423,1064,,124420,120990,117747,6486,3243,
2021-01-10,11370,11330,38,,135790,132311,129031,6560,3280,
2021-01-11,11711,11661,48,,147501,143972,140644,6656,3328,
2021-01-12,14467,14160,298,,161968,158124,154498,7252,3626,
2021-01-13,15435,13813,1593,,177403,171923,166706,10434,5217,
2021-01-14,19182,16731,2436,,196585,188648,180996,15304,7652,
2021-01-15,20047,17990,2038,,216632,206627,196937,19380,9690,
2021-01-16,17115,15932,1170,,233747,222543,211683,21720,10860,
2021-01-17,11255,10012,1236,,245002,232540,220446,24188,12094,
2021-01-18,6792,6710,72,,251794,239227,227064,24326,12163,
2021-01-19,11826,9718,2094,,263620,248924,234667,28514,14257,
2021-01-20,10800,7211,3572,,274420,256112,238284,35656,17828,
2021-01-21,10970,6852,4091,,285390,262948,241029,43838,21919,
2021-01-22,9037,4320,4698,,294427,267231,240616,53230,26615,
2021-01-23,7448,3032,4388,,301875,270233,239231,62004,31002,
2021-01-24,4381,1825,2536,,306256,272040,238502,67076,33538,
2021-01-25,5318,1046,4263,,311574,273054,235254,75600,37800,
2021-01-26,9385,2862,6495,,320959,275884,231590,88588,44294,
2021-01-27,9893,2861,7004,,330852,278716,227419,102594,51297,
2021-01-28,13107,5732,7333,,343959,284415,225785,117260,58630,
2021-01-29,10684,3271,7379,,354643,287655,221647,132016,66008,
2021-01-30,9185,2726,6422,,363828,290339,217912,144854,72427,
2021-01-31,3373,1561,1767,,367201,291866,217673,148386,74193,
2021-02-01,2121,484,1609,,369322,292316,216518,151596,75798,
2021-02-02,4405,1352,2995,,373727,293630,214841,157578,78789,
2021-02-03,6232,1712,4458,,379959,295301,212061,166480,83240,
2021-02-04,9076,1707,7290,,389035,296965,206441,181048,90524,
2021-02-05,8440,1466,6903,,397475,298391,200970,194842,97421,
2021-02-06,10657,1862,8736,,408132,300198,194050,212296,106148,
2021-02-07,7569,1725,5796,,415701,301883,189951,223864,111932,
2021-02-08,8217,3095,5080,,423918,304930,187931,233998,116999,
2021-02-09,14998,3851,11081,,438916,308739,180675,256128,128064,
2021-02-10,15503,4924,10518,,454419,313611,175054,277114,138557,
2021-02-11,16360,3897,12407,,470779,317456,166523,301866,150933,
2021-02-12,17649,2094,15505,,488428,319511,153093,332836,166418,
2021-02-13,16201,2439,13747,,504629,321905,141759,360292,180146,
2021-02-14,12877,920,11925,,517506,322777,130736,384082,192041,
2021-02-15,7859,483,7328,,525365,323212,123869,398686,199343,
2021-02-16,5990,1040,4900,,531355,324209,119989,408440,204220,
2021-02-17,10161,1605,8522,,541516,325770,113056,425428,212714,
2021-02-18,13866,2952,10870,,555382,328674,105120,447108,223554,
2021-02-19,18486,6212,12207,,573868,334834,99104,471460,235730,
2021-02-20,22622,11129,11441,,596490,345900,98767,494266,247133,
2021-02-21,17232,10377,6821,,613722,356217,102305,507824,253912,
2021-02-22,13581,8755,4775,,627303,364902,106265,517274,258637,
2021-02-23,17856,11119,6666,,645159,375965,110698,530534,265267,
2021-02-24,18567,13607,4879,,663726,389516,119412,540208,270104,
2021-02-25,20801,16485,4259,,684527,405935,131620,548630,274315,
2021-02-26,24883,21826,2996,,709410,427701,150427,554548,277274,
2021-02-27,27450,23574,3835,,736860,451211,170150,562122,281061,
2021-02-28,20578,19139,1405,,757438,470296,187872,564848,282424,
2021-03-01,18218,17023,1148,,775656,487257,203732,567050,283525,
2021-03-02,24671,22268,2319,,800327,509464,223666,571596,285798,
2021-03-03,30588,27959,2576,,830915,537372,249031,576682,288341,
2021-03-04,34682,32454,2143,,865597,569760,279326,580868,290434,
2021-03-05,39982,38152,1782,,905579,607864,315682,584364,292182,
2021-03-06,44137,41935,2164,,949716,649744,355439,588610,294305,
2021-03-07,32728,31550,1174,,982444,681220,385799,590842,295421,
2021-03-08,24034,22160,1860,,1006478,703312,406085,594454,297227,
2021-03-09,33279,29832,3419,,1039757,733078,432478,601200,300600,
2021-03-10,38323,34064,4214,,1078080,767068,462302,609532,304766,
2021-03-11,43965,40694,3232,,1122045,807696,499750,615892,307946,
2021-03-12,47694,45982,1688,,1169739,853614,544030,619168,309584,
2021-03-13,57900,55029,2844,,1227639,908572,596198,624748,312374,
2021-03-14,43400,42165,1218,,1271039,950654,637130,627048,313524,
2021-03-15,32798,31101,1682,,1303837,981696,666533,630326,315163,
2021-03-16,53940,51646,2278,,1357777,1033277,715879,634796,317398,
2021-03-17,61051,58515,2493,,1418828,1091726,771885,639682,319841,
2021-03-18,61525,59071,2429,,1480353,1150725,828508,644434,322217,
2021-03-19,64452,61130,3268,,1544805,1211777,886345,650864,325432,
2021-03-20,62553,59967,2555,,1607358,1271688,943749,655878,327939,
2021-03-21,43989,42468,1535,,1651347,1314091,984654,658874,329437,
2021-03-22,30990,30027,974,,1682337,1344030,1013675,660710,330355,
2021-03-23,54601,51829,2722,,1736938,1395764,1062750,666028,333014,
2021-03-24,76413,73232,3133,,1813351,1468906,1132816,672180,336090,
2021-03-25,82900,80321,2532,,1896251,1549148,1210583,677130,338565,
2021-03-26,86988,83459,3490,,1983239,1632526,1290523,684006,342003,
2021-03-27,80835,77887,2864,,2064074,1710310,1365508,689604,344802,
2021-03-28,66981,65395,1553,,2131055,1775615,1429317,692596,346298,
2021-03-29,51727,49041,2651,,2182782,1824576,1475673,697806,348903,
2021-03-30,73562,70156,3348,,2256344,1894655,1542445,704420,352210,
2021-03-31,93141,89495,3579,,2349485,1984052,1628316,711472,355736,
2021-04-01,89299,85426,3834,,2438784,2069380,1709863,719034,359517,
2021-04-02,93069,88846,4207,,2531853,2158140,1794468,727344,363672,
2021-04-03,60991,59318,1731,,2592844,2217367,1852015,730704,365352,
2021-04-04,72323,70673,1646,,2665167,2287929,1920989,733880,366940,
2021-04-05,53725,53256,469,,2718892,2341101,1973740,734722,367361,
2021-04-06,79571,77708,1883,,2798463,2418708,2049517,738382,369191,
2021-04-07,107993,104933,3052,,2906456,2523516,2151331,744370,372185,
2021-04-08,114059,110096,4020,,3020515,2633501,2257352,752298,376149,
2021-04-09,109828,105611,4291,,3130343,2738994,2358619,760750,380375,
2021-04-10,109221,105470,3845,,3239564,2844336,2460182,768308,384154,
2021-04-11,98612,95500,3256,,3338176,2939711,2552360,774702,387351,
2021-04-12,76060,74999,1154,,3414236,3014562,2626125,776874,388437,
2021-04-13,99458,96083,3395,,3513694,3110536,2718752,783568,391784,
2021-04-14,117034,113274,3648,,3630728,3223692,2828300,790784,395392,
2021-04-15,113551,109498,3895,,3744279,3333064,2933834,798460,399230,
2021-04-16,118087,113718,4190,,3862366,3446672,3043296,806752,403376,
2021-04-17,112401,107818,4444,,3974767,3554356,3146595,815522,407761,
2021-04-18,88731,86499,2100,,4063498,3640732,3230925,819614,409807,
2021-04-19,68959,67433,1447,,4132457,3708035,3296832,822406,411203,
2021-04-20,101906,98588,3114,,4234363,3806461,3392209,828504,414252,
2021-04-21,141980,137716,4030,,4376343,3944003,3525789,836428,418214,
2021-04-22,139458,135321,3900,,4515801,4079195,3657137,844116,422058,
2021-04-23,138188,131786,6156,,4653989,4210827,3782671,856312,428156,
2021-04-24,130270,126218,3881,,4784259,4336897,3904916,863962,431981,
2021-04-25,102005,98601,3175,,4886264,4435350,4000261,870178,435089,
2021-04-26,70997,69295,1555,,4957261,4504514,4067930,873168,436584,
2021-04-27,98485,95412,2884,,5055746,4599765,4160360,878810,439405,
2021-04-28,120559,115944,4424,,5176305,4715541,4271784,887514,443757,
2021-04-29,124470,119278,5045,,5300775,4834652,4385919,897466,448733,
2021-04-30,115797,110554,5008,,5416572,4945033,4491369,907328,453664,
2021-05-01,111275,107422,3638,,5527847,5052274,4595049,914450,457225,
2021-05-02,79130,76157,2860,,5606977,5128274,4668255,920038,460019,
2021-05-03,56784,55117,1595,,5663761,5183236,4721682,923108,461554,
2021-05-04,91914,88547,3281,,5755675,5271605,4806847,929516,464758,
2021-05-05,137979,133280,4615,,5893654,5404716,4935406,938620,469310,
2021-05-06,141826,136874,4815,,6035480,5541406,5067343,948126,474063,
2021-05-07,150261,145232,4830,,6185741,5686478,5207644,957668,478834,
2021-05-08,142441,137759,4434,,6328182,5824042,5340853,966378,483189,
2021-05-09,124788,121145,3476,,6452970,5945023,5458422,973202,486601,
2021-05-10,97792,95817,1875,,6550762,6040651,5552242,976818,488409,
2021-05-11,113510,108845,4486,,6664272,6149294,5656470,985648,492824,
2021-05-12,145026,138006,6874,,6809298,6287121,5787489,999264,499632,
2021-05-13,142650,135302,7201,,6951948,6422248,5915489,1013518,506759,
2021-05-14,148856,138762,9926,,7100804,6560822,6044202,1033240,516620,
2021-05-15,159710,149674,9859,,7260514,6710309,6183905,1052808,526404,
2021-05-16,144343,136079,8060,,7404857,6846220,6311836,1068768,534384,
2021-05-17,114962,110867,3942,,7519819,6956898,6418648,1076500,538250,
2021-05-18,111303,100447,10655,,7631122,7057149,6508306,1097686,548843,
2021-05-19,149858,133456,16225,,7780980,7190453,6625459,1129988,564994,
2021-05-20,151540,131560,19768,,7932520,7321824,6737131,1169386,584693,
2021-05-21,165356,140860,24240,,8097876,7462503,6853647,1217712,608856,
2021-05-22,199407,172223,26959,,8297283,7634529,6998795,1271468,635734,
2021-05-23,139809,127442,12222,,8437092,7761793,7113899,1295788,647894,
2021-05-24,100282,93312,6825,,8537374,7854932,7200283,1309298,654649,
2021-05-25,90444,82966,7270,,8627818,7937735,7275883,1323704,661852,
2021-05-26,139753,112991,26499,,8767571,8050539,7362258,1376562,688281,
2021-05-27,152045,123027,28765,,8919616,8173409,7456432,1433954,716977,
2021-05-28,163842,132291,31246,,9083458,8305527,7557363,1496328,748164,
2021-05-29,153358,117105,36021,,9236816,8422482,7638353,1568258,784129,
2021-05-30,149704,119005,30474,,9386520,8541317,7726776,1629082,814541,
2021-05-31,99197,79804,19202,,9485717,8620951,7787272,1667358,833679,
2021-06-01,124171,90596,33241,,9609888,8711352,7844507,1733690,866845,
2021-06-02,145283,102128,42907,,9755171,8813299,7903616,1819366,909683,
2021-06-03,155336,99893,55165,,9910507,8913007,7948230,1929554,964777,
2021-06-04,181689,115516,65903,,10092196,9028324,7997732,2061184,1030592,
2021-06-05,171993,103416,68301,,10264189,9131542,8032734,2197616,1098808,
2021-06-06,163366,91847,71239,,10427555,9223211,8053234,2339954,1169977,
2021-06-07,119550,63042,56291,,10547105,9286056,8059863,2452386,1226193,
2021-06-08,161878,72439,89001,,10708983,9358306,8043192,2630228,1315114,
2021-06-09,181446,70794,110187,,10890429,9428923,8003703,2850440,1425220,
2021-06-10,185562,66415,118661,,11075991,9495135,7951345,3087580,1543790,
2021-06-11,204760,67501,136506,,11280751,9562450,7882236,3360428,1680214,
2021-06-12,199702,62657,136448,,11480453,9624925,7808355,3633140,1816570,
2021-06-13,190306,58866,130914,,11670759,9683616,7736212,3894808,1947404,
2021-06-14,137675,38687,98593,,11808434,9722107,7676215,4091784,2045892,
2021-06-15,189188,42588,146250,,11997622,9764477,7572432,4384090,2192045,
2021-06-16,206107,42421,163046,,12203729,9806702,7451714,4709976,2354988,
2021-06-17,210393,37926,171888,,12414122,9844413,7317629,5053568,2526784,
2021-06-18,217127,35344,181180,,12631249,9879567,7171695,5415744,2707872,
2021-06-19,215846,35482,179694,,12847095,9914843,7027389,5774908,2887454,
2021-06-20,186248,35552,150120,,13033343,9950197,6912731,6074932,3037466,
2021-06-21,120420,20822,99099,,13153763,9970824,6834351,6272946,3136473,
2021-06-22,204908,27496,176659,,13358671,9998126,6685103,6626046,3313023,
2021-06-23,230500,28616,201148,,13589171,10026542,6512479,7028126,3514063,
2021-06-24,227663,26663,200251,,13816834,10053009,6338805,7428408,3714204,
2021-06-25,251083,27966,222373,,14067917,10080774,6144315,7872918,3936459,
2021-06-26,261269,29996,230570,,14329186,10110545,5943656,8333778,4166889,
2021-06-27,204982,27779,176600,,14534168,10138142,5794763,8686758,4343379,
2021-06-28,199233,20950,177724,,14733401,10158894,5637916,9041956,4520978,
2021-06-29,250093,24486,224880,,14983494,10183139,5437435,9491408,4745704,
2021-06-30,275514,24165,250783,,15259008,10207101,5210743,9992716,4996358,
2021-07-01,271952,25298,246101,,15530960,10232181,4989861,10484640,5242320,
2021-07-02,144707,11579,132904,,15675667,10243586,4868464,10750244,5375122,
2021-07-03,216878,19921,196725,,15892545,10263285,4691587,11143396,5571698,
2021-07-04,196150,19404,176525,,16088695,10282503,4534399,11496208,5748104,
2021-07-05,148712,12437,136132,,16237407,10294750,4410642,11768216,5884108,
2021-07-06,220010,19982,199813,,16457417,10314516,4230741,12167550,6083775,
2021-07-07,246595,22962,223394,,16704012,10337252,4030231,12614042,6307021,
2021-07-08,231184,21343,209632,,16935196,10358389,3841871,13033036,6516518,
2021-07-09,226973,21499,205307,,17162169,10379686,3657993,13443386,6721693,
2021-07-10,209049,20533,188363,,17371218,10400015,3490096,13819838,6909919,
2021-07-11,171653,17567,153961,,17542871,10417381,3353648,14127466,7063733,
2021-07-12,123125,11444,111584,,17665996,10428636,3253456,14350360,7175180,
2021-07-13,178469,19016,159311,,17844465,10447430,3113094,14668672,7334336,
2021-07-14,180017,19295,160566,,18024482,10466510,2971771,14989478,7494739,
2021-07-15,167174,19580,147422,,18191656,10485879,2843882,15283994,7641997,
2021-07-16,169325,19888,149284,,18360981,10505565,2714437,15582256,7791128,
2021-07-17,172982,20255,152601,,18533963,10525571,2582034,15887074,7943537,
2021-07-18,133618,15924,117558,,18667581,10541311,2480364,16121894,8060947,
2021-07-19,91965,10411,81447,,18759546,10551509,2409290,16284438,8142219,
2021-07-20,133520,16941,116521,,18893066,10568210,2309646,16517128,8258564,
2021-07-21,140073,16979,123023,,19033139,10584974,2203549,16762850,8381425,
2021-07-22,125583,17634,107815,,19158722,10602384,2113321,16978126,8489063,
2021-07-23,120241,16979,103056,,19278963,10619122,2027202,17183840,8591920,
2021-07-24,126673,18326,108110,,19405636,10637245,1937378,17399734,8699867,
2021-07-25,103619,14855,88636,,19509255,10651876,1863554,17576644,8788322,
2021-07-26,66674,9880,56703,,19575929,10661538,1816694,17689688,8844844,
2021-07-27,92357,15314,76882,,19668286,10676591,1755082,17843018,8921509,
2021-07-28,93920,16450,77394,,19762206,10692806,1694094,17997424,8998712,
2021-07-29,89378,16696,72520,,19851584,10709270,1638226,18142088,9071044,
2021-07-30,84040,16093,67834,,19935624,10725135,1586445,18277380,9138690,
2021-07-31,83823,15700,67970,,20019447,10740617,1534147,18412940,9206470,
2021-08-01,61849,11308,50360,,20081296,10751699,1495060,18513278,9256639,
2021-08-02,42468,7403,34947,,20123764,10758904,1467484,18582840,9291420,
2021-08-03,33270,5945,27155,,20157034,10764616,1446251,18636730,9318365,
2021-08-04,61299,12365,48744,,20218333,10776746,1409835,18733822,9366911,
2021-08-05,59426,12527,46746,,20277759,10789065,1375572,18826986,9413493,
2021-08-06,56000,11847,43937,,20333759,10800652,1343451,18914402,9457201,
2021-08-07,62350,12124,50030,,20396109,10812515,1305502,19014026,9507013,
2021-08-08,48648,9250,39211,,20444757,10821537,1275518,19092038,9546019,
2021-08-09,30844,5930,24739,,20475601,10827253,1256682,19141142,9570571,
2021-08-10,49232,10497,38436,,20524833,10837470,1228709,19217522,9608761,
2021-08-11,48700,10757,37700,,20573533,10847980,1201735,19292490,9646245,
2021-08-12,49217,11180,37811,,20622750,10858909,1175062,19367694,9683847,
2021-08-13,49597,11718,37605,,20672347,10870386,1149145,19442482,9721241,
2021-08-14,51193,12122,38862,,20723540,10882258,1122379,19519758,9759879,
2021-08-15,41742,9840,31681,,20765282,10891896,1100508,19582776,9791388,
2021-08-16,26719,6173,20391,,20792001,10897846,1086264,19623164,9811582,
2021-08-17,40482,11048,29171,,20832483,10908644,1068117,19681054,9840527,
2021-08-18,41875,11959,29675,,20874358,10920361,1050369,19739984,9869992,
2021-08-19,45867,16517,29088,,20920225,10936627,1037770,19797714,9898857,
2021-08-20,46410,16272,29724,,20966635,10952643,1024291,19856704,9928352,
2021-08-21,47931,15136,32426,,21014566,10967519,1006968,19921102,9960551,
2021-08-22,34374,10800,23307,,21048940,10978073,994437,19967272,9983636,
2021-08-23,23214,7002,15996,,21072154,10984840,985422,19998836,9999418,
2021-08-24,37632,13362,23815,,21109786,10997948,974946,20046004,10023002,
2021-08-25,41311,14401,26303,,21151097,11012093,963025,20098136,10049068,
2021-08-26,39251,13549,24960,,21190348,11025366,951579,20147574,10073787,
2021-08-27,37650,12924,23682,,21227998,11038049,940794,20194510,10097255,
2021-08-28,40086,13407,25504,,21268084,11051177,928673,20245008,10122504,
2021-08-29,30525,10236,19934,,21298609,11061181,918956,20284450,10142225,
2021-08-30,18228,6137,11842,,21316837,11067070,913222,20307696,10153848,
2021-08-31,32696,11932,19615,,21349533,11078734,905511,20346446,10173223,
2021-09-01,36215,12933,21937,,21385748,11091434,896491,20389886,10194943,
2021-09-02,37752,15636,19655,,21423500,11106818,892447,20428742,10214371,
2021-09-03,46844,21070,22426,,21470344,11127640,891072,20473136,10236568,
2021-09-04,46859,20580,24768,,21517203,11147974,886861,20522226,10261113,
2021-09-05,33053,14198,18568,,21550256,11161928,882471,20558914,10279457,
2021-09-06,21695,9481,12026,,21571951,11171160,879909,20582502,10291251,
2021-09-07,14979,6715,8079,,21586930,11177618,878528,20598180,10299090,
2021-09-08,41124,17104,20926,,21628054,11194458,874688,20639540,10319770,
2021-09-09,41430,16966,19669,,21669484,11211147,871960,20678374,10339187,
2021-09-10,39618,15499,18986,,21709102,11226384,868455,20715858,10357929,
2021-09-11,42351,15927,23324,,21751453,11242032,861037,20761990,10380995,
2021-09-12,29949,11528,17859,,21781402,11253266,854676,20797180,10398590,
2021-09-13,16070,6398,9176,,21797472,11259430,851883,20815094,10407547,
2021-09-14,29889,11552,15283,,21827361,11270680,848125,20845110,10422555,
2021-09-15,39262,14019,19411,,21866623,11284440,842718,20883444,10441722,
2021-09-16,39329,13975,19239,,21905952,11298180,837431,20921498,10460749,
2021-09-17,38906,13602,19326,,21944858,11311539,831695,20959688,10479844,
2021-09-18,41203,14074,23507,,21986061,11325340,822241,21006198,10503099,
2021-09-19,30642,10823,18974,,22016703,11335904,814077,21043654,10521827,
2021-09-20,16727,6099,10173,,22033430,11341749,809980,21063538,10531769,
2021-09-21,31342,11208,16981,,22064772,11352692,804191,21097002,10548501,
2021-09-22,41794,14813,22915,,22106566,11367209,796068,21142282,10571141,
2021-09-23,47208,16132,26019,,22153774,11383078,786162,21193832,10596916,
2021-09-24,46285,15626,26639,,22200059,11398443,775130,21246626,10623313,
2021-09-25,48171,15247,29933,,22248230,11413437,760425,21306024,10653012,
2021-09-26,37480,12415,24474,,22285710,11425577,748345,21354464,10677232,
2021-09-27,19146,6527,12313,,22304856,11431850,742543,21378614,10689307,
2021-09-28,30934,11288,17865,,22335790,11442879,735954,21413850,10706925,
2021-09-29,37863,12468,21712,,22373653,11455076,726690,21456772,10728386,
2021-09-30,37319,11648,21360,,22410972,11466465,716959,21499012,10749506,
2021-10-01,30858,9806,18401,,22441830,11476045,708351,21535388,10767694,
2021-10-02,37117,11151,23575,,22478947,11486926,695909,21582034,10791017,
2021-10-03,27198,8161,18321,,22506145,11494846,685736,21618220,10809110,
2021-10-04,14864,4744,9801,,22521009,11499344,680661,21637366,10818683,
2021-10-05,26800,8587,15857,,22547809,11507670,673376,21668588,10834294,
2021-10-06,31645,9634,18497,,22579454,11517045,664505,21705080,10852540,
2021-10-07,30334,9390,17113,,22609788,11526184,656769,21738830,10869415,
2021-10-08,32818,10737,18840,,22642606,11536651,648653,21775996,10887998,
2021-10-09,34118,10652,21005,,22676724,11547040,638286,21817508,10908754,
2021-10-10,23394,7655,15075,,22700118,11554444,630854,21847180,10923590,
2021-10-11,11998,3838,7862,,22712116,11558032,626814,21862436,10931218,
2021-10-12,5096,1624,3257,,22717212,11559378,625166,21868424,10934212,
2021-10-13,29091,9188,18075,,22746303,11568276,616263,21904026,10952013,
2021-10-14,29000,8900,17739,,22775303,11576901,607414,21938974,10969487,
2021-10-15,29075,8820,18157,,22804378,11585458,598064,21974788,10987394,
2021-10-16,31127,8982,19865,,22835505,11594149,587169,22013960,11006980,
2021-10-17,23693,7255,15367,,22859198,11601150,579044,22044212,11022106,
2021-10-18,12303,3747,8145,,22871501,11604616,574634,22059964,11029982,
2021-10-19,21251,6620,12621,,22892752,11610954,568620,22084668,11042334,
2021-10-20,25638,7537,14903,,22918390,11618244,561241,22114006,11057003,
2021-10-21,23155,6674,13022,,22941545,11624649,554882,22139534,11069767,
2021-10-22,26102,7306,15103,,22967647,11631632,547069,22169126,11084563,
2021-10-23,28162,7600,17147,,22995809,11638970,537515,22202910,11101455,
2021-10-24,19340,5727,12594,,23015149,11644441,530636,22227610,11113805,
2021-10-25,9922,2710,6473,,23025071,11646882,526865,22240034,11120017,
2021-10-26,18891,5385,11089,,23043962,11651989,521152,22261674,11130837,
2021-10-27,22833,6072,13201,,23066795,11657806,514009,22287594,11143797,
2021-10-28,22293,5791,12636,,23089088,11663309,507153,22312312,11156156,
2021-10-29,22796,5728,13040,,23111884,11668735,499826,22337818,11168909,
2021-10-30,24085,6033,14598,,23135969,11674496,491249,22366494,11183247,
2021-10-31,16465,4593,10590,,23152434,11678795,485247,22387096,11193548,
2021-11-01,7864,2079,5053,,23160298,11680594,482260,22396668,11198334,
2021-11-02,15614,4362,7738,,23175912,11684665,478873,22411584,11205792,
2021-11-03,18610,5065,9599,,23194522,11689427,474329,22430196,11215098,
2021-11-04,19489,4869,10022,,23214011,11694020,469161,22449718,11224859,
2021-11-05,21444,4397,9512,,23235455,11698128,464032,22468192,11234096,
2021-11-06,25319,5201,12149,,23260774,11703060,457067,22491986,11245993,
2021-11-07,21436,4021,8914,,23282210,11706801,452162,22509278,11254639,
2021-11-08,11989,2110,4730,,23294199,11708616,449526,22518180,11259090,
2021-11-09,24105,3846,7638,,23318304,11712141,445724,22532834,11266417,
2021-11-10,28458,4504,8984,,23346762,11716368,441230,22550276,11275138,
2021-11-11,28739,4300,9086,,23375501,11720372,436435,22567874,11283937,
2021-11-12,26725,4162,8221,,23402226,11724243,432362,22583762,11291881,
2021-11-13,34293,5076,11400,,23436519,11729013,426029,22605968,11302984,
2021-11-14,23209,3898,8597,,23459728,11732648,421323,22622650,11311325,
2021-11-15,12695,2185,4490,,23472423,11734573,419010,22631126,11315563,
2021-11-16,26162,3927,7473,,23498585,11738243,415460,22645566,11322783,
2021-11-17,31146,4047,7799,,23529731,11742008,411698,22660620,11330310,
2021-11-18,32471,3855,7507,,23562202,11745557,408032,22675050,11337525,
2021-11-19,35447,3858,7741,,23597649,11749114,404137,22689954,11344977,
2021-11-20,40100,4380,8808,,23637749,11753214,399700,22707028,11353514,
2021-11-21,28104,3432,6941,,23665853,11756384,396177,22720414,11360207,
2021-11-22,14889,1949,3889,,23680742,11758057,394231,22727652,11363826,
2021-11-23,33042,3272,6002,,23713784,11761049,391493,22739112,11369556,
2021-11-24,42630,3751,6793,,23756414,11764496,388440,22752112,11376056,
2021-11-25,46022,3931,6559,,23802436,11768152,385809,22764686,11382343,
2021-11-26,52819,11342,6608,,23855255,11779224,390536,22777376,11388688,
2021-11-27,63497,22349,7026,,23918752,11801292,405849,22790886,11395443,
2021-11-28,51447,27738,5308,,23970199,11828738,428267,22800942,11400471,
2021-11-29,33518,18933,2876,,24003717,11847410,444313,22806194,11403097,
2021-11-30,56002,20671,5122,,24059719,11867800,459852,22815896,11407948,
2021-12-01,69523,26237,5627,,24129242,11893731,480448,22826566,11413283,
2021-12-02,71611,26486,5028,,24200853,11919919,501893,22836052,11418026,
2021-12-03,73392,25096,5157,,24274245,11944719,521826,22845786,11422893,
2021-12-04,81132,27783,6058,47271,24355377,11972209,543542,,11428667,807413
2021-12-05,62613,31926,4401,26266,24417990,12003840,571059,,11432781,833575
2021-12-06,38620,19141,2709,16754,24456610,12022692,587484,,11435208,850251
2021-12-07,60266,14849,4459,40945,24516876,12037269,597864,,11439405,891122
2021-12-08,73435,19054,4675,49703,24590311,12056046,612233,,11443813,940747
2021-12-09,74473,18271,4332,51851,24664784,12074008,626164,,11447844,992513
2021-12-10,77460,17587,4643,55222,24742244,12091314,639103,,11452211,1047654
2021-12-11,83157,20402,5818,56925,24825401,12111427,653673,,11457754,1104493
2021-12-12,60740,22696,4150,33852,24886141,12133843,672213,,11461630,1138256
2021-12-13,34922,11600,2406,20893,24921063,12145146,681397,,11463749,1159054
2021-12-14,101953,8999,3855,89056,25023016,12153835,686526,,11467309,1247990
2021-12-15,127667,12427,4501,110704,25150683,12165958,694442,,11471516,1358594
2021-12-16,139318,12452,4238,122615,25290001,12178124,702646,,11475478,1481110
2021-12-17,159149,12400,4510,142217,25449150,12190249,710527,,11479722,1623230
2021-12-18,175562,13523,4917,157079,25624712,12203478,719121,,11484357,1780214
2021-12-19,140414,18156,3928,118297,25765126,12221333,733341,,11487992,1898400
2021-12-20,106810,10305,2743,93717,25871936,12231370,740893,,11490477,1992019
2021-12-21,215210,12960,4310,197918,26087146,12244014,749536,,11494478,2189816
2021-12-22,237194,14418,5191,217700,26324340,12258133,758749,,11499384,2407398
2021-12-23,257409,11713,5080,240521,26581749,12269542,765376,,11504166,2647813
2021-12-24,223376,9443,4558,209313,26805125,12278688,770257,,11508431,2857010
2021-12-25,89692,3885,2501,83318,26894817,12282298,771636,,11510662,2940221
2021-12-26,11894,387,357,11140,26906711,12282393,771658,,11510735,2951231
2021-12-27,46931,1493,1114,44294,26953642,12283641,772030,,11511611,2995405
2021-12-28,144755,6100,3999,134597,27098397,12289447,774120,,11515327,3129871
2021-12-29,175449,9374,4573,161431,27273846,12298525,778917,,11519608,3291174
2021-12-30,200033,10128,5341,184522,27473879,12308350,783689,,11524661,3475562
2021-12-31,195180,10006,5793,179130,27669059,12318067,787893,,11530174,3654566
2022-01-01,96937,5379,3875,87358,27765996,12323137,789389,,11533748,3741775
2022-01-02,19440,940,926,17444,27785436,12323786,789394,,11534392,3759073
2022-01-03,88245,4772,4591,78801,27873681,12328248,789567,,11538681,3837721
2022-01-04,146349,5996,5312,135001,28020030,12333916,790238,,11543678,3972566
2022-01-05,177458,7619,7290,162377,28197488,12341181,790556,,11550625,4134783
2022-01-06,191499,7202,6781,176991,28388987,12348064,790966,,11557098,4311619
2022-01-07,191216,7954,6986,175465,28580203,12355674,791922,,11563752,4486911
2022-01-08,181635,8621,6630,165197,28761838,12363963,793900,,11570063,4651952
2022-01-09,131086,9863,7176,113954,28892924,12373504,796582,,11576922,4765746
2022-01-10,90553,5107,4489,80826,28983477,12378289,797190,,11581099,4846419
2022-01-11,138850,6151,6562,125431,29122327,12384093,796766,,11587327,4971660
2022-01-12,156996,8156,8047,138669,29279323,12391920,796870,,11595050,5110161
2022-01-13,162654,9205,9211,141529,29441977,12400763,796850,,11603913,5251507
2022-01-14,159841,10750,10372,136028,29601818,12411152,797223,,11613929,5387337
2022-01-15,161184,11010,11670,135870,29763002,12421791,796552,,11625239,5523014
2022-01-16,109769,9286,9671,89453,29872771,12430715,796160,,11634555,5612249
2022-01-17,65775,5935,6563,52637,29938546,12436314,795522,,11640792,5664701
2022-01-18,36095,2003,2126,31143,29974641,12437962,795388,,11642574,5695648
2022-01-19,101306,5579,6716,85949,30075947,12443141,794233,,11648908,5781370
2022-01-20,103582,6322,7002,85722,30179529,12449079,793545,,11655534,5866869
2022-01-21,102090,6232,8054,82490,30281619,12454907,791709,,11663198,5949131
2022-01-22,102561,8711,12068,78105,30384180,12463229,788345,,11674884,6027008
2022-01-23,76675,7305,13986,54784,30460855,12470191,781657,,11688534,6081570
2022-01-24,42258,3194,7935,30740,30503113,12473021,776898,,11696123,6112103
2022-01-25,62555,3756,8365,48115,30565668,12476399,772274,,11704125,6160000
2022-01-26,77874,4912,13167,55687,30643542,12480934,764014,,11716920,6215445
2022-01-27,78062,4894,13244,56039,30721604,12485456,755654,,11729802,6271247
2022-01-28,77271,4671,13672,53889,30798875,12489769,746640,,11743129,6324917
2022-01-29,84805,5529,17708,58106,30883680,12494934,734454,,11760480,6382778
2022-01-30,66493,5025,20622,40151,30950173,12499617,718843,,11780774,6422704
2022-01-31,34739,2175,9879,22346,30984912,12501473,711130,,11790343,6444861
2022-02-01,51342,3266,9660,36521,31036254,12504386,704726,,11799660,6481157
2022-02-02,57702,3844,12395,38677,31093956,12507900,696160,,11811740,6519635
2022-02-03,52574,3610,11508,34298,31146530,12511133,688250,,11822883,6553682
2022-02-04,43082,2948,10557,27280,31189612,12513771,680631,,11833140,6580768
2022-02-05,58708,3740,14469,37559,31248320,12517179,669890,,11847289,6618114
2022-02-06,49854,3639,16114,29571,31298174,12520495,657410,,11863085,6647461
2022-02-07,23227,1690,7807,13438,31321401,12521859,651280,,11870579,6660675
2022-02-08,33376,2354,7240,21966,31354777,12523883,646387,,11877496,6682408
2022-02-09,38868,2781,8912,24406,31393645,12526305,640250,,11886055,6706562
2022-02-10,37532,2764,8833,22550,31431177,12528733,634177,,11894556,6728882
2022-02-11,39437,2722,10287,23001,31470614,12531109,626603,,11904506,6751645
2022-02-12,42034,2953,11452,25312,31512648,12533728,618093,,11915635,6776733
2022-02-13,36311,2800,13139,19939,31548959,12536241,607751,,11928490,6796474
2022-02-14,16970,1175,6118,9469,31565929,12537141,602800,,11934341,6805743
2022-02-15,19344,1384,4745,11875,31585273,12538202,599429,,11938773,6817391
2022-02-16,26016,1766,7730,14945,31611289,12539671,593461,,11946210,6832135
2022-02-17,26754,1681,7518,14984,31638043,12540997,587615,,11953382,6846864
2022-02-18,23933,1353,6605,13674,31661976,12542033,582351,,11959682,6860329
2022-02-19,37830,1902,8335,26050,31699806,12543604,575913,,11967691,6886138
2022-02-20,32567,1495,7960,22803,31732373,12544799,569440,,11975359,6908737
2022-02-21,17500,913,3677,12756,31749873,12545417,566667,,11978750,6921282
2022-02-22,9100,428,1550,6953,31758973,12545556,565540,,11980016,6928025
2022-02-23,25327,1326,4790,17292,31784300,12546572,562069,,11984503,6945081
2022-02-24,24566,1400,5233,15478,31808866,12547651,558232,,11989419,6960316
2022-02-25,23096,1389,5136,14505,31831962,12548746,554478,,11994268,6974595
2022-02-26,25225,1384,5908,16554,31857187,12549820,549947,,11999873,6990923
2022-02-27,26950,1370,7365,17701,31884137,12550921,543941,,12006980,7008429
2022-02-28,10127,594,2529,6745,31894264,12551262,541998,,12009264,7014991
2022-03-01,13187,943,3148,8163,31907451,12551900,539783,,12012117,7022937
2022-03-02,15408,1163,3575,9615,31922859,12552802,537364,,12015438,7032375
2022-03-03,14292,1077,3224,8686,31937151,12553567,535209,,12018358,7040830
2022-03-04,14467,990,3442,8314,31951618,12554236,532753,,12021483,7048891
2022-03-05,18527,1277,4995,11182,31970145,12555204,529024,,12026180,7059849
2022-03-06,16508,1087,5522,9602,31986653,12556011,524583,,12031428,7069244
2022-03-07,5946,466,1860,3509,31992599,12556192,523182,,12033010,7072536
2022-03-08,7355,698,1937,4158,31999954,12556612,521936,,12034676,7076495
2022-03-09,11152,906,2735,6404,32011106,12557242,520101,,12037141,7082697
2022-03-10,12753,1044,3251,6835,32023859,12558009,517887,,12040122,7089319
2022-03-11,12884,904,3406,6864,32036743,12558624,515377,,12043247,7095967
2022-03-12,14678,1045,4179,8310,32051421,12559397,512240,,12047157,7104073
2022-03-13,14742,1090,4997,8330,32066163,12560196,508329,,12051867,7112166
2022-03-14,6329,448,2228,3497,32072492,12560373,506546,,12053827,7115449
2022-03-15,10196,791,2625,5972,32082688,12560874,504700,,12056174,7121207
2022-03-16,13054,933,3661,6950,32095742,12561519,501969,,12059550,7127927
2022-03-17,13188,1047,3957,6756,32108930,12562279,499052,,12063227,7134464
2022-03-18,11902,911,3145,6432,32120832,12562887,496808,,12066079,7140672
2022-03-19,14434,1002,4161,7899,32135266,12563609,493647,,12069962,7148352
2022-03-20,11738,989,3955,6368,32147004,12564327,490676,,12073651,7154512
2022-03-21,5056,414,1589,2813,32152060,12564482,489497,,12074985,7157122
2022-03-22,6703,552,1556,3888,32158763,12564747,488488,,12076259,7160794
2022-03-23,9965,785,2296,5193,32168728,12565217,486974,,12078243,7165746
2022-03-24,9293,724,2377,4609,32178021,12565677,485312,,12080365,7170151
2022-03-25,9217,782,2151,4746,32187238,12566196,483935,,12082261,7174685
2022-03-26,10922,934,2833,5504,32198160,12566853,482034,,12084819,7179970
2022-03-27,10221,909,3537,5298,32208381,12567502,479402,,12088100,7185057
2022-03-28,3578,319,1107,1987,32211959,12567581,478611,,12088970,7186850
2022-03-29,5336,498,1209,2688,32217295,12567794,477894,,12089900,7189316
2022-03-30,7848,747,1833,4121,32225143,12568263,476803,,12091460,7193213
2022-03-31,8645,689,1924,4412,32233788,12568663,475562,,12093101,7197403
2022-04-01,9299,802,1911,4884,32243087,12569173,474444,,12094729,7202048
2022-04-02,10430,885,2208,5570,32253517,12569771,473109,,12096662,7207401
2022-04-03,9198,880,2567,5063,32262715,12570396,471416,,12098980,7212264
2022-04-04,4196,387,1005,2406,32266911,12570522,470795,,12099727,7214467
2022-04-05,6067,599,1036,3050,32272978,12570780,470352,,12100428,7217242
2022-04-06,8369,715,1477,4376,32281347,12571204,469585,,12101619,7221391
2022-04-07,10333,733,1686,4833,32291680,12571637,468627,,12103010,7225981
2022-04-08,23989,811,1581,4836,32315669,12572170,467851,,12104319,7230601
2022-04-09,30487,969,1972,5894,32346156,12572841,466839,,12106002,7236272
2022-04-10,24853,976,2388,5331,32371009,12573560,465421,,12108139,7241403
2022-04-11,12568,385,874,2432,32383577,12573696,464928,,12108768,7243634
2022-04-12,28110,692,1017,3535,32411687,12574085,464596,,12109489,7246937
2022-04-13,37777,853,1560,4928,32449464,12574639,463885,,12110754,7251635
2022-04-14,37893,762,1613,4910,32487357,12575090,463031,,12112059,7256293
2022-04-15,43393,1230,2101,6726,32530750,12576022,462156,,12113866,7262782
2022-04-16,8088,358,650,1736,32538838,12576120,461862,,12114258,7264302
2022-04-17,21006,870,1924,4315,32559844,12576706,460801,,12115905,7268394
2022-04-18,5457,305,462,1288,32565301,12576724,460639,,12116085,7269441
2022-04-19,22647,615,773,3100,32587948,12577057,460472,,12116585,7272322
2022-04-20,40326,1063,1395,4617,32628274,12577794,460137,,12117657,7276675
2022-04-21,38749,941,1602,4679,32667023,12578439,459467,,12118972,7281120
2022-04-22,35615,1013,1428,4266,32702638,12579180,459045,,12120135,7285168
2022-04-23,34643,1006,1734,4712,32737281,12579903,458314,,12121589,7289642
2022-04-24,20809,1021,1885,3777,32758090,12580674,457447,,12123227,7293225
2022-04-25,8299,453,691,1707,32766389,12580858,457208,,12123650,7294716
2022-04-26,24608,732,945,3141,32790997,12581298,456989,,12124309,7297620
2022-04-27,33593,955,1368,3935,32824590,12581977,456568,,12125409,7301338
2022-04-28,32830,927,1412,3929,32857420,12582631,456074,,12126557,7305044
2022-04-29,32055,1098,1378,3910,32889475,12583432,455787,,12127645,7308726
2022-04-30,30275,923,1537,4020,32919750,12584058,455166,,12128892,7312510
2022-05-01,16750,768,1579,2970,32936500,12584529,454350,,12130179,7315237
2022-05-02,5933,309,524,1097,32942433,12584542,454131,,12130411,7316107
2022-05-03,20922,588,829,2346,32963355,12584825,453884,,12130941,7318214
2022-05-04,29414,800,1091,3293,32992769,12585315,453588,,12131727,7321258
2022-05-05,29092,872,1161,3125,33021861,12585875,453289,,12132586,7324139
2022-05-06,29086,1147,1280,2984,33050947,12586735,453151,,12133584,7326897
2022-05-07,28483,868,1260,3112,33079430,12587313,452754,,12134559,7329785
2022-05-08,15996,896,1309,2322,33095426,12587952,452339,,12135613,7331906
2022-05-09,5896,292,474,943,33101322,12587978,452151,,12135827,7332639
2022-05-10,21221,696,718,2119,33122543,12588357,452122,,12136235,7334499
2022-05-11,28945,837,1081,2655,33151488,12588861,451874,,12136987,7336882
2022-05-12,28233,800,1083,2510,33179721,12589364,451587,,12137777,7339151
2022-05-13,27591,878,1117,2468,33207312,12589932,451344,,12138588,7341362
2022-05-14,25688,808,1096,2609,33233000,12590424,451049,,12139375,7343716
2022-05-15,14845,751,1274,2055,33247845,12590903,450519,,12140384,7345552
2022-05-16,6381,325,532,1047,33254226,12590991,450308,,12140683,7346413
2022-05-17,19597,586,777,1742,33273823,12591263,450110,,12141153,7347907
2022-05-18,26539,876,1099,2272,33300362,12591875,449882,,12141993,7349964
2022-05-19,24433,682,1155,2159,33324795,12592290,449402,,12142888,7351906
2022-05-20,24260,801,1136,2215,33349055,12592824,449063,,12143761,7353904
2022-05-21,22396,692,1167,2345,33371451,12593207,448579,,12144628,7356007
2022-05-22,10556,551,889,1486,33382007,12593497,448236,,12145261,7357276
2022-05-23,4564,241,462,787,33386571,12593479,448013,,12145466,7357855
2022-05-24,2616,119,178,434,33389187,12593345,447952,,12145393,7358080
2022-05-25,19357,655,947,1952,33408544,12593734,447650,,12146084,7359822
2022-05-26,20638,663,949,1908,33429182,12594124,447358,,12146766,7361508
2022-05-27,21754,816,1057,2075,33450936,12594653,447114,,12147539,7363351
2022-05-28,19400,721,1164,2146,33470336,12595104,446668,,12148436,7365283
2022-05-29,12107,761,1280,1725,33482443,12595630,446142,,12149488,7366816
2022-05-30,4580,311,550,751,33487023,12595695,445900,,12149795,7367369
2022-05-31,13545,572,749,1666,33500568,12595965,445717,,12150248,7368795
2022-06-01,16607,702,970,1877,33517175,12596363,445447,,12150916,7370418
2022-06-02,14599,556,866,1674,33531774,12596607,445130,,12151477,7371851
2022-06-03,16099,697,1095,1813,33547873,12597027,444726,,12152301,7373446
2022-06-04,13318,648,1164,1843,33561191,12597417,444205,,12153212,7375087
2022-06-05,7866,587,1109,1432,33569057,12597755,443679,,12154076,7376327
2022-06-06,3293,206,444,641,33572350,12597713,443438,,12154275,7376767
2022-06-07,11213,474,725,1370,33583563,12597888,443182,,12154706,7377893
2022-06-08,14061,667,1013,1608,33597624,12598296,442831,,12155465,7379283
2022-06-09,13368,662,922,1673,33610992,12598670,442566,,12156104,7380724
2022-06-10,13847,685,1066,1695,33624839,12599069,442177,,12156892,7382189
2022-06-11,12980,616,1032,1864,33637819,12599400,441759,,12157641,7383830
2022-06-12,8094,644,1236,1500,33645913,12599787,441163,,12158624,7385124
2022-06-13,3187,284,422,710,33649100,12599805,441020,,12158785,7385625
2022-06-14,10127,511,666,1264,33659227,12600027,440859,,12159168,7386651
2022-06-15,13502,471,830,1620,33672729,12600204,440498,,12159706,7388035
2022-06-16,12537,494,856,1616,33685266,12600393,440131,,12160262,7389404
2022-06-17,11687,480,816,1652,33696953,12600588,439788,,12160800,7390822
2022-06-18,11446,436,874,1860,33708399,12600753,439347,,12161406,7392458
2022-06-19,6999,482,896,1420,33715398,12600986,438932,,12162054,7393667
2022-06-20,2286,147,301,643,33717684,12600909,438772,,12162137,7394140
2022-06-21,9539,358,614,1382,33727223,12600980,438511,,12162469,7395274
2022-06-22,13606,406,724,1702,33740829,12601114,438186,,12162928,7396751
2022-06-23,13700,401,775,1681,33754529,12601249,437809,,12163440,7398219
2022-06-24,15362,435,811,1672,33769891,12601424,437429,,12163995,7399676
2022-06-25,14467,425,851,1713,33784358,12601589,436992,,12164597,7401181
2022-06-26,8156,432,885,1280,33792514,12601760,436532,,12165228,7402245
2022-06-27,3212,171,364,594,33795726,12601683,436335,,12165348,7402633
2022-06-28,9615,370,556,1223,33805341,12601768,436145,,12165623,7403624
2022-06-29,13307,413,728,1628,33818648,12601891,435828,,12166063,7405012
2022-06-30,12228,483,846,1578,33830876,12602090,435463,,12166627,7406357
2022-07-01,13035,548,970,1947,33843911,12602382,435036,,12167346,7408099
2022-07-02,1610,110,115,363,33845521,12602216,435029,,12167187,7408230
2022-07-03,5158,261,493,958,33850679,12602221,434788,,12167433,7408973
2022-07-04,2756,131,279,614,33853435,12602105,434639,,12167466,7409390
2022-07-05,11141,372,599,1572,33864576,12602180,434404,,12167776,7410714
2022-07-06,15955,545,857,2008,33880531,12602431,434086,,12168345,7412481
2022-07-07,15659,520,832,1923,33896190,12602664,433773,,12168891,7414152
2022-07-08,17881,554,870,2244,33914071,12602913,433456,,12169457,7416147
2022-07-09,14136,450,597,1841,33928207,12603089,433308,,12169781,7417754
2022-07-10,8742,475,752,1501,33936949,12603316,433030,,12170286,7419049
2022-07-11,4093,199,331,870,33941042,12603250,432895,,12170355,7419699
2022-07-12,12104,412,523,1654,33953146,12603363,432779,,12170584,7421099
2022-07-13,16715,562,771,2141,33969861,12603630,432564,,12171066,7422998
2022-07-14,16858,486,674,2023,33986719,12603811,432365,,12171446,7424782
2022-07-15,28889,599,822,2181,34015608,12604110,432141,,12171969,7426722
2022-07-16,30289,585,772,2324,34045897,12604382,431945,,12172437,7428795
2022-07-17,22923,538,636,1884,34068820,12604683,431844,,12172839,7430485
2022-07-18,11392,187,255,854,34080212,12604602,431771,,12172831,7431117
2022-07-19,28946,592,590,2133,34109158,12604919,431770,,12173149,7433018
2022-07-20,37631,841,923,2589,34146789,12605482,431683,,12173799,7435371
2022-07-21,36350,732,810,2805,34183139,12605927,431598,,12174329,7437936
2022-07-22,35795,826,890,2682,34218934,12606466,431528,,12174938,7440381
2022-07-23,35139,820,913,2826,34254073,12606974,431427,,12175547,7442952
2022-07-24,21731,602,805,1772,34275804,12607313,431221,,12176092,7444499
2022-07-25,11932,308,311,1080,34287736,12607339,431213,,12176126,7445351
2022-07-26,26085,621,602,2209,34313821,12607677,431231,,12176446,7447318
2022-07-27,32463,810,845,2647,34346284,12608230,431194,,12177036,7449755
2022-07-28,31534,725,884,2605,34377818,12608661,431031,,12177630,7452112
2022-07-29,29987,1791,876,2640,34407805,12610161,431942,,12178219,7454503
2022-07-30,25824,2525,745,2433,34433629,12612410,433720,,12178690,7456707
2022-07-31,14298,1068,541,1559,34447927,12613210,434243,,12178967,7458039
2022-08-01,5911,336,223,681,34453838,12613288,434354,,12178934,7458497
2022-08-02,4474,305,135,601,34458312,12613323,434520,,12178803,7458876
2022-08-03,22931,2636,737,2235,34481243,12615683,436415,,12179268,7460875
2022-08-04,22225,2480,677,2129,34503468,12617837,438212,,12179625,7462742
2022-08-05,21790,2756,743,2065,34525258,12620313,440217,,12180096,7464580
2022-08-06,19642,2877,658,1990,34544900,12622879,442430,,12180449,7466312
2022-08-07,12699,2235,620,1418,34557599,12624841,444039,,12180802,7467514
2022-08-08,4766,570,188,603,34562365,12625126,444414,,12180712,7467883
2022-08-09,14006,1466,557,1589,34576371,12626305,445317,,12180988,7469231
2022-08-10,19126,2364,717,1990,34595497,12628396,446962,,12181434,7470993
2022-08-11,17074,2041,718,1853,34612571,12630164,448283,,12181881,7472616
2022-08-12,16979,2048,734,1850,34629550,12631924,449596,,12182328,7474238
2022-08-13,15948,2223,762,1806,34645498,12633866,451055,,12182811,7475806
2022-08-14,9524,1621,618,1082,34655022,12635199,452054,,12183145,7476653
2022-08-15,3869,388,269,477,34658891,12635335,452170,,12183165,7476922
2022-08-16,10802,1073,514,1355,34669693,12636109,452727,,12183382,7478027
2022-08-17,16094,1834,738,1779,34685787,12637657,453822,,12183835,7479571
2022-08-18,14927,1640,748,1691,34700714,12638974,454710,,12184264,7480992
2022-08-19,15308,1847,748,1545,34716022,12640546,455805,,12184741,7482305
2022-08-20,14279,1640,739,1543,34730301,12641895,456700,,12185195,7483610
2022-08-21,9899,1532,659,1163,34740200,12643164,457569,,12185595,7484558
2022-08-22,4163,481,271,561,34744363,12643347,457776,,12185571,7484864
2022-08-23,11130,1248,554,1493,34755493,12644290,458467,,12185823,7486106
2022-08-24,14753,1808,869,2185,34770246,12645829,459406,,12186423,7488062
2022-08-25,14026,1718,780,2120,34784272,12647260,460337,,12186923,7489938
2022-08-26,13925,1688,815,2090,34798197,12648654,461203,,12187451,7491780
2022-08-27,12411,1484,876,1997,34810608,12649813,461805,,12188008,7493511
2022-08-28,7922,1258,620,1397,34818530,12650812,462441,,12188371,7494690
2022-08-29,3394,504,283,681,34821924,12651041,462657,,12188384,7495143
2022-08-30,9904,1169,649,1855,34831828,12651854,463171,,12188683,7496697
2022-08-31,13509,1627,946,2312,34845337,12653193,463848,,12189345,7498768
2022-09-01,12903,1721,912,2138,34858240,12654618,464652,,12189966,7500660
2022-09-02,15041,1615,991,4919,34873281,12655958,465268,,12190690,7505353
2022-09-03,14709,1525,920,5512,34887990,12657202,465870,,12191332,7510632
2022-09-04,8662,1010,675,3234,34896652,12657954,466197,,12191757,7513649
2022-09-05,3551,321,229,1384,34900203,12658011,466286,,12191725,7514811
2022-09-06,2462,157,113,1128,34902665,12657916,466327,,12191589,7515732
2022-09-07,10924,1018,587,3491,34913589,12658637,466754,,12191883,7518973
2022-09-08,10865,1021,524,2790,34924454,12659332,467248,,12192084,7521489
2022-09-09,9580,1012,488,2501,34934034,12660058,467767,,12192291,7523756
2022-09-10,10630,1264,551,3164,34944664,12661049,468473,,12192576,7526690
2022-09-11,9404,982,667,3734,34954068,12661785,468782,,12193003,7530216
2022-09-12,3124,294,204,1079,34957192,12661798,468866,,12192932,7531058
2022-09-13,6012,542,281,1132,34963204,12662057,469118,,12192939,7531950
2022-09-14,14478,797,433,1843,34977682,12662540,469478,,12193062,7533530
2022-09-15,15745,780,408,1533,34993427,12663001,469845,,12193156,7534793
2022-09-16,17751,766,446,1690,35011178,12663511,470159,,12193352,7536265
2022-09-17,17609,722,456,1665,35028787,12663931,470421,,12193510,7537677
2022-09-18,11210,777,451,1684,35039997,12664452,470745,,12193707,7539142
2022-09-19,4977,403,288,670,35044974,12664589,470856,,12193733,7539601
2022-09-20,13755,438,329,941,35058729,12664713,470963,,12193750,7540280
2022-09-21,23028,646,407,1495,35081757,12665056,471197,,12193859,7541525
2022-09-22,22904,637,398,1378,35104661,12665390,471430,,12193960,7542645
2022-09-23,22936,726,599,1417,35127597,12665820,471552,,12194268,7543811
2022-09-24,21682,736,690,1498,35149279,12666263,471594,,12194669,7545074
2022-09-25,11317,595,702,1355,35160596,12666584,471482,,12195102,7546198
2022-09-26,4561,192,218,594,35165157,12666492,471450,,12195042,7546552
2022-09-27,37649,498,365,1498,35202806,12666725,471579,,12195146,7547827
2022-09-28,50958,730,669,1902,35253764,12667188,471639,,12195549,7549505
2022-09-29,47992,637,739,1836,35301756,12667513,471530,,12195983,7551071
2022-09-30,47267,679,806,2001,35349023,12667871,471401,,12196470,7552796
2022-10-01,34439,527,633,1545,35383462,12668094,471293,,12196801,7554078
2022-10-02,24239,736,1028,1710,35407701,12668542,470998,,12197544,7555542
2022-10-03,10863,238,230,611,35418564,12668493,471002,,12197491,7555918
2022-10-04,32181,478,458,1168,35450745,12668656,471018,,12197638,7556814
2022-10-05,40420,625,740,1558,35491165,12668972,470898,,12198074,7558115
2022-10-06,38682,609,652,1568,35529847,12669281,470853,,12198428,7559426
2022-10-07,42231,660,852,1742,35572078,12669599,470653,,12198946,7560871
2022-10-08,37386,784,1145,2121,35609464,12670058,470286,,12199772,7562723
2022-10-09,18811,549,727,1557,35628275,12670334,470105,,12200229,7564047
2022-10-10,6862,170,370,567,35635137,12670210,469903,,12200307,7564357
2022-10-11,4986,124,111,318,35640123,12670043,469911,,12200132,7564438
2022-10-12,35102,579,685,1426,35675225,12670295,469803,,12200492,7565581
2022-10-13,36749,644,857,1621,35711974,12670580,469587,,12200993,7566900
2022-10-14,36962,621,752,1540,35748936,12670875,469453,,12201422,7568164
2022-10-15,35446,716,1013,1625,35784382,12671310,469153,,12202157,7569550
2022-10-16,20662,654,1024,1593,35805044,12671699,468777,,12202922,7570915
2022-10-17,7349,206,477,538,35812393,12671626,468505,,12203121,7571214
2022-10-18,36414,457,500,1397,35848807,12671769,468457,,12203312,7572344
2022-10-19,49880,619,729,1984,35898687,12672091,468344,,12203747,7574081
2022-10-20,51269,623,648,2048,35949956,12672407,468316,,12204091,7575871
2022-10-21,52835,698,618,1938,36002791,12672785,468393,,12204392,7577545
2022-10-22,50853,751,905,2309,36053644,12673213,468234,,12204979,7579584
2022-10-23,30628,578,783,2119,36084272,12673482,468023,,12205459,7581444
2022-10-24,14130,231,270,978,36098402,12673421,467979,,12205442,7582172
2022-10-25,41347,475,488,1816,36139749,12673558,467963,,12205595,7583700
2022-10-26,51622,619,660,2122,36191371,12673850,467918,,12205932,7585549
2022-10-27,50092,609,767,2163,36241463,12674141,467753,,12206388,7587447
2022-10-28,49778,590,675,2094,36291241,12674382,467664,,12206718,7589240
2022-10-29,50583,736,778,2218,36341824,12674779,467618,,12207161,7591167
2022-10-30,28388,664,930,2034,36370212,12675167,467348,,12207819,7592963
2022-10-31,12436,199,234,777,36382648,12675096,467310,,12207786,7593513
2022-11-01,33078,340,197,1220,36415726,12675100,467447,,12207653,7594447
2022-11-02,44272,576,622,1904,36459998,12675356,467397,,12207959,7596063
2022-11-03,44172,540,605,1856,36504170,12675580,467329,,12208251,7597644
2022-11-04,44624,652,528,2024,36548794,12675939,467446,,12208493,7599423
2022-11-05,45194,648,755,2369,36593988,12676295,467336,,12208959,7601533
2022-11-06,26012,560,771,2096,36620000,12676521,467122,,12209399,7603339
2022-11-07,10710,243,235,876,36630710,12676499,467127,,12209372,7603995
2022-11-08,33467,487,395,1584,36664177,12676710,467216,,12209494,7605345
2022-11-09,40523,605,570,1966,36704700,12677009,467249,,12209760,7607051
2022-11-10,39163,625,547,1927,36743863,12677325,467322,,12210003,7608711
2022-11-11,43330,638,641,2205,36787193,12677658,467318,,12210340,7610651
2022-11-12,36835,640,592,2185,36824028,12677983,467358,,12210625,7612562
2022-11-13,24260,559,770,2276,36848288,12678258,467141,,12211117,7614595
2022-11-14,10964,233,204,1023,36859252,12678208,467169,,12211039,7615371
2022-11-15,33583,484,379,1691,36892835,12678340,467270,,12211070,7616764
2022-11-16,43518,799,582,2370,36936353,12678856,467481,,12211375,7618897
2022-11-17,38316,674,646,2241,36974669,12679206,467505,,12211701,7620861
2022-11-18,40602,726,530,2327,37015271,12679600,467697,,12211903,7622898
2022-11-19,39641,1015,1031,3078,37054912,12680284,467677,,12212607,7625683
2022-11-20,22411,661,718,2440,37077323,12680682,467617,,12213065,7627904
2022-11-21,8918,197,192,970,37086241,12680628,467617,,12213011,7628679
2022-11-22,26430,479,368,1512,37112671,12680772,467724,,12213048,7629897
2022-11-23,32055,686,668,2068,37144726,12681140,467740,,12213400,7631695
2022-11-24,31893,663,750,2083,37176619,12681504,467651,,12213853,7633528
2022-11-25,30748,764,829,1950,37207367,12681974,467580,,12214394,7635230
2022-11-26,30271,907,1191,2696,37237638,12682560,467288,,12215272,7637651
2022-11-27,18672,611,944,2087,37256310,12682884,466950,,12215934,7639492
2022-11-28,7536,191,280,786,37263846,12682791,466854,,12215937,7640029
2022-11-29,21014,421,452,1291,37284860,12682898,466819,,12216079,7641051
2022-11-30,27883,647,648,1839,37312743,12683247,466816,,12216431,7642632
2022-12-01,24797,593,682,1691,37337540,12683533,466724,,12216809,7644055
2022-12-02,25044,524,630,1771,37362584,12683747,466612,,12217135,7645558
2022-12-03,25543,587,780,1943,37388127,12684025,466409,,12217616,7647251
2022-12-04,15246,499,606,1699,37403373,12684211,466298,,12217913,7648673
2022-12-05,6879,168,156,746,37410252,12684102,466305,,12217797,7649181
2022-12-06,20333,421,351,1376,37430585,12684180,466371,,12217809,7650265
2022-12-07,24757,553,608,1668,37455342,12684438,466311,,12218127,7651678
2022-12-08,23153,564,523,1760,37478495,12684705,466350,,12218355,7653177
2022-12-09,23318,636,575,1631,37501813,12685036,466408,,12218628,7654552
2022-12-10,22566,511,600,1627,37524379,12685254,466317,,12218937,7655923
2022-12-11,14198,549,785,1566,37538577,12685557,466079,,12219478,7657275
2022-12-12,5506,150,157,593,37544083,12685437,466067,,12219370,7657641
2022-12-13,17788,378,367,1125,37561871,12685515,466077,,12219438,7658509
2022-12-14,21310,511,547,1451,37583181,12685760,466035,,12219725,7659735
2022-12-15,21957,531,602,1578,37605138,12685980,465963,,12220017,7661043
2022-12-16,16281,379,450,1030,37621419,12686052,465889,,12220163,7661815
2022-12-17,18692,559,506,1273,37640111,12686318,465940,,12220378,7662825
2022-12-18,12635,529,794,1305,37652746,12686589,465674,,12220915,7663899
2022-12-19,4585,133,115,448,37657331,12686418,465688,,12220730,7664084
2022-12-20,16201,501,448,1105,37673532,12686627,465735,,12220892,7664941
2022-12-21,18465,547,551,1299,37691997,12686897,465728,,12221169,7665998
2022-12-22,18587,576,589,1743,37710584,12687203,465715,,12221488,7667504
2022-12-23,15636,580,598,1712,37726220,12687457,465692,,12221765,7668943
2022-12-24,5331,223,171,671,37731551,12687394,465743,,12221651,7669358
2022-12-25,2441,153,152,480,37733992,12687260,465736,,12221524,7669590
2022-12-26,262,12,7,48,37734254,12687003,465737,,12221266,7669405
2022-12-27,2091,99,36,305,37736345,12686845,465797,,12221048,7669494
2022-12-28,8316,336,167,976,37744661,12686895,465962,,12220933,7670217
2022-12-29,13158,584,524,1600,37757819,12687194,466018,,12221176,7671570
2022-12-30,15812,671,657,1877,37773631,12687585,466029,,12221556,7673196
2022-12-31,11229,462,387,1353,37784860,12687733,466100,,12221633,7674273
2023-01-01,3906,202,219,562,37788766,12687656,466083,,12221573,7674588
2023-01-02,651,37,14,96,37789417,12687435,466106,,12221329,7674457
2023-01-03,8190,298,151,898,37797607,12687475,466247,,12221228,7675139
2023-01-04,14714,575,547,1544,37812321,12687794,466269,,12221525,7676460
2023-01-05,16111,654,533,1795,37828432,12688181,466386,,12221795,7678022
2023-01-06,18819,718,609,2044,37847251,12688649,466492,,12222157,7679846
2023-01-07,18520,707,638,2054,37865771,12689105,466556,,12222549,7681683
2023-01-08,11609,582,608,1630,37877380,12689458,466527,,12222931,7683109
2023-01-09,5298,216,196,664,37882678,12689412,466545,,12222867,7683549
2023-01-10,12156,419,315,781,37894834,12689567,466649,,12222918,7684094
2023-01-11,15538,460,370,1092,37910372,12689758,466737,,12223021,7684953
2023-01-12,14060,447,407,973,37924432,12689932,466776,,12223156,7685687
2023-01-13,14163,424,345,1039,37938595,12690146,466853,,12223293,7686535
2023-01-14,13375,478,452,1077,37951970,12690381,466876,,12223505,7687392
2023-01-15,9043,466,507,1049,37961013,12690628,466834,,12223794,7688255
2023-01-16,3745,148,130,479,37964758,12690543,466852,,12223691,7688523
2023-01-17,8849,270,179,651,37973607,12690528,466942,,12223586,7688930
2023-01-18,10239,351,273,757,37983846,12690638,467020,,12223618,7689465
2023-01-19,10580,318,318,760,37994426,12690717,467016,,12223701,7690019
2023-01-20,9824,319,272,716,38004250,12690800,467061,,12223739,7690519
2023-01-21,11302,358,398,904,38015552,12690932,467021,,12223911,7691229
2023-01-22,7567,345,404,816,38023119,12691066,466960,,12224106,7691851
2023-01-23,3379,144,131,288,38026498,12691026,466973,,12224053,7691977
2023-01-24,8278,227,165,549,38034776,12690998,467033,,12223965,7692301
2023-01-25,10304,349,296,661,38045080,12691122,467085,,12224037,7692765
2023-01-26,6721,236,203,469,38051801,12691127,467118,,12224009,7693037
2023-01-27,6905,241,197,491,38058706,12691123,467161,,12223962,7693318
2023-01-28,9337,312,339,693,38068043,12691202,467130,,12224072,7693807
2023-01-29,5960,235,341,689,38074003,12691206,467019,,12224187,7694289
2023-01-30,1899,88,79,215,38075902,12691072,467026,,12224046,7694305
2023-01-31,5876,156,150,413,38081778,12690973,467030,,12223943,7694488
2023-02-01,7295,250,249,489,38089073,12691017,467030,,12223987,7694797
2023-02-02,6465,295,239,499,38095538,12691114,467084,,12224030,7695131
2023-02-03,6540,197,191,462,38102078,12691102,467088,,12224014,7695407
2023-02-04,6719,231,305,541,38108797,12691139,467009,,12224130,7695783
2023-02-05,4175,198,291,484,38112972,12691115,466915,,12224200,7696082
2023-02-06,1834,91,98,211,38114806,12690982,466906,,12224076,7696088
2023-02-07,4960,162,181,383,38119766,12690902,466885,,12224017,7696263
2023-02-08,5766,213,206,429,38125532,12690905,466891,,12224014,7696503
2023-02-09,6115,214,243,438,38131647,12690915,466862,,12224053,7696766
2023-02-10,5081,159,207,370,38136728,12690906,466812,,12224094,7696986
2023-02-11,6050,185,259,458,38142778,12690873,466734,,12224139,7697246
2023-02-12,4082,219,344,408,38146860,12690885,466606,,12224279,7697466
2023-02-13,1481,56,87,146,38148341,12690753,466574,,12224179,7697456
2023-02-14,3943,132,179,308,38152284,12690657,466526,,12224131,7697560
2023-02-15,4538,119,191,286,38156822,12690572,466454,,12224118,7697667
2023-02-16,4912,174,285,400,38161734,12690529,466341,,12224188,7697873
2023-02-17,4981,180,210,342,38166715,12690515,466310,,12224205,7698046
2023-02-18,5112,230,295,488,38171827,12690536,466243,,12224293,7698349
2023-02-19,3349,133,243,373,38175176,12690468,466131,,12224337,7698553
2023-02-20,1419,64,54,157,38176595,12690343,466139,,12224204,7698548
2023-02-21,912,25,14,107,38177507,12690192,466148,,12224044,7698495
2023-02-22,4133,130,213,370,38181640,12690139,466060,,12224079,7698714
2023-02-23,4274,163,231,390,38185914,12690076,465985,,12224091,7698904
2023-02-24,3028,138,229,273,38188942,12690029,465890,,12224139,7699009
2023-02-25,5019,215,540,384,38193961,12690046,465564,,12224482,7699229
2023-02-26,3472,146,681,384,38197433,12689995,465027,,12224968,7699442
2023-02-27,1074,37,57,97,38198507,12689850,465004,,12224846,7699387
2023-02-28,2722,98,163,232,38201229,12689720,464937,,12224783,7699413
2023-03-01,3845,138,428,333,38205074,12689629,464646,,12224983,7699535
2023-03-02,4586,159,495,327,38209660,12689563,464306,,12225257,7699672
2023-03-03,4364,160,357,333,38214024,12689518,464107,,12225411,7699819
2023-03-04,4963,207,623,350,38218987,12689530,463689,,12225841,7699997
2023-03-05,2532,110,449,251,38221519,12689444,463349,,12226095,7700077
2023-03-06,1156,48,37,114,38222675,12689309,463358,,12225951,7700030
2023-03-07,3213,90,171,221,38225888,12689175,463274,,12225901,7700060
2023-03-08,4311,133,412,283,38230199,12689113,462994,,12226119,7700166
2023-03-09,4607,170,451,312,38234806,12689091,462709,,12226382,7700314
2023-03-10,3939,101,138,255,38238745,12689017,462670,,12226347,7700415
2023-03-11,4054,141,169,285,38242799,12688997,462639,,12226358,7700555
2023-03-12,2882,109,234,301,38245681,12688916,462509,,12226407,7700689
2023-03-13,862,32,32,105,38246543,12688792,462507,,12226285,7700658
2023-03-14,3057,100,109,256,38249600,12688714,462498,,12226216,7700759
2023-03-15,4095,140,163,309,38253695,12688697,462475,,12226222,7700926
2023-03-16,4018,174,234,277,38257713,12688661,462412,,12226249,7701029
2023-03-17,4276,170,202,307,38261989,12688636,462377,,12226259,7701163
2023-03-18,4352,145,194,296,38266341,12688606,462328,,12226278,7701301
2023-03-19,2718,129,233,255,38269059,12688599,462224,,12226375,7701431
2023-03-20,774,32,19,73,38269833,12688457,462237,,12226220,7701348
2023-03-21,2889,69,84,199,38272722,12688355,462218,,12226137,7701399
2023-03-22,3884,130,131,248,38276606,12688318,462215,,12226103,7701496
2023-03-23,3800,118,171,224,38280406,12688272,462157,,12226115,7701578
2023-03-24,3681,103,115,236,38284087,12688228,462144,,12226084,7701680
2023-03-25,4260,107,171,246,38288347,12688187,462076,,12226111,7701797
2023-03-26,2470,114,211,200,38290817,12688157,461977,,12226180,7701868
2023-03-27,910,48,32,67,38291727,12688077,461993,,12226084,7701822
2023-03-28,3088,86,78,201,38294815,12688012,461997,,12226015,7701891
2023-03-29,4147,128,136,221,38298962,12687996,461987,,12226009,7701981
2023-03-30,3836,109,164,210,38302798,12687981,461932,,12226049,7702077
2023-03-31,3973,143,109,218,38306771,12687987,461965,,12226022,7702175
2023-04-01,4179,137,146,224,38310950,12688001,461955,,12226046,7702290
2023-04-02,2178,58,121,172,38313128,12687918,461891,,12226027,7702336
2023-04-03,769,25,12,52,38313897,12687820,461903,,12225917,7702281
2023-04-04,3391,73,73,167,38317288,12687770,461903,,12225867,7702332
2023-04-05,4328,96,107,244,38321616,12687754,461892,,12225862,7702478
2023-04-06,3678,111,107,184,38325294,12687767,461896,,12225871,7702569
2023-04-07,4578,109,115,238,38329872,12687766,461889,,12225877,7702710
2023-04-08,832,22,11,54,38330704,12687698,461898,,12225800,7702692
2023-04-09,2410,86,103,154,38333114,12687719,461881,,12225838,7702790
2023-04-10,354,9,6,20,38333468,12687655,461883,,12225772,7702748
2023-04-11,2749,37,28,117,38336217,12687581,461892,,12225689,7702765
2023-04-12,6232,104,94,185,38342449,12687617,461902,,12225715,7702893
2023-04-13,6906,108,125,206,38349355,12687652,461884,,12225768,7703029
2023-04-14,6426,94,102,200,38355781,12687691,461876,,12225815,7703182
2023-04-15,6831,109,145,218,38362612,12687745,461840,,12225905,7703351
2023-04-16,3239,99,139,160,38365851,12687796,461800,,12225996,7703469
2023-04-17,848,12,12,48,38366699,12687779,461800,,12225979,7703491
2023-04-18,4703,103,76,159,38371402,12687876,461827,,12226049,7703644
2023-04-19,6418,127,96,167,38377820,12688003,461858,,12226145,7703811
2023-04-20,6003,105,146,197,38383823,12688108,461817,,12226291,7704008
