"report_date","previous_day_total_doses_administered","previous_day_at_least_one","previous_day_fully_vaccinated","previous_day_3doses","total_doses_administered","total_individuals_at_least_one","total_individuals_partially_vaccinated","total_doses_in_fully_vaccinated_individuals","total_individuals_fully_vaccinated","total_individuals_3doses"
2021-01-01,6251,6241,2,,32194,32139,32128,22,11,
2021-01-02,4613,4601,6,,36807,36688,36675,26,13,
2021-01-03,5394,5387,3,,42201,42075,42059,32,16,
2021-01-04,5994,5992,0,,48195,48066,48051,30,15,
2021-01-05,9682,9657,20,,57877,57721,57687,68,34,
2021-01-06,12792,12327,450,,70669,70044,69564,960,480,
2021-01-07,16216,15505,697,,86885,85548,84371,2354,1177,
2021-01-08,18037,17022,1002,,104922,102570,100391,4358,2179,
2021-01-09,19500,18423,1064,,124422,120992,117749,6486,3243,
2021-01-10,11370,11330,38,,135792,132313,129033,6560,3280,
2021-01-11,11711,11661,48,,147503,143974,140646,6656,3328,
2021-01-12,14467,14160,298,,161970,158126,154500,7252,3626,
2021-01-13,15435,13813,1593,,177405,171925,166708,10434,5217,
2021-01-14,19182,16731,2436,,196587,188650,180998,15304,7652,
2021-01-15,20047,17990,2038,,216634,206629,196939,19380,9690,
2021-01-16,17115,15932,1170,,233749,222545,211685,21720,10860,
2021-01-17,11256,10012,1237,,245005,232542,220447,24190,12095,
2021-01-18,6793,6711,72,,251798,239230,227066,24328,12164,
2021-01-19,11826,9718,2094,,263624,248927,234669,28516,14258,
2021-01-20,10800,7211,3572,,274424,256115,238286,35658,17829,
2021-01-21,10970,6852,4091,,285394,262951,241031,43840,21920,
2021-01-22,9038,4320,4698,,294432,267234,240618,53232,26616,
2021-01-23,7449,3033,4388,,301881,270237,239234,62006,31003,
2021-01-24,4381,1825,2536,,306262,272044,238505,67078,33539,
2021-01-25,5318,1046,4263,,311580,273058,235257,75602,37801,
2021-01-26,9385,2862,6495,,320965,275888,231593,88590,44295,
2021-01-27,9893,2861,7004,,330858,278720,227422,102596,51298,
2021-01-28,13108,5732,7334,,343966,284419,225787,117264,58632,
2021-01-29,10685,3272,7379,,354651,287660,221650,132020,66010,
2021-01-30,9185,2726,6422,,363836,290344,217915,144858,72429,
2021-01-31,3374,1562,1767,,367210,291872,217677,148390,74195,
2021-02-01,2121,484,1609,,369331,292322,216522,151600,75800,
2021-02-02,4407,1354,2995,,373738,293638,214847,157582,78791,
2021-02-03,6232,1712,4458,,379970,295309,212067,166484,83242,
2021-02-04,9076,1707,7290,,389046,296973,206447,181052,90526,
2021-02-05,8441,1467,6903,,397487,298400,200977,194846,97423,
2021-02-06,10657,1862,8736,,408144,300207,194057,212300,106150,
2021-02-07,7570,1726,5796,,415714,301893,189959,223868,111934,
2021-02-08,8219,3096,5080,,423933,304941,187940,234002,117001,
2021-02-09,14998,3851,11081,,438931,308750,180684,256132,128066,
2021-02-10,15503,4924,10518,,454434,313622,175063,277118,138559,
2021-02-11,16360,3897,12407,,470794,317467,166532,301870,150935,
2021-02-12,17649,2094,15505,,488443,319522,153102,332840,166420,
2021-02-13,16204,2441,13748,,504647,321918,141769,360298,180149,
2021-02-14,12877,920,11925,,517524,322790,130746,384088,192044,
2021-02-15,7860,484,7328,,525384,323226,123880,398692,199346,
2021-02-16,5990,1040,4900,,531374,324223,120000,408446,204223,
2021-02-17,10163,1607,8522,,541537,325786,113069,425434,212717,
2021-02-18,13866,2952,10870,,555403,328690,105133,447114,223557,
2021-02-19,18487,6213,12207,,573890,334851,99118,471466,235733,
2021-02-20,22623,11130,11441,,596513,345918,98782,494272,247136,
2021-02-21,17232,10377,6821,,613745,356235,102320,507830,253915,
2021-02-22,13581,8756,4774,,627326,364921,106282,517278,258639,
2021-02-23,17856,11119,6666,,645182,375984,110715,530538,265269,
2021-02-24,18568,13608,4879,,663750,389536,119430,540212,270106,
2021-02-25,20802,16485,4260,,684552,405955,131637,548636,274318,
2021-02-26,24883,21826,2996,,709435,427721,150444,554554,277277,
2021-02-27,27450,23574,3835,,736885,451231,170167,562128,281064,
2021-02-28,20578,19140,1404,,757463,470317,187891,564852,282426,
2021-03-01,18220,17025,1148,,775683,487280,203753,567054,283527,
2021-03-02,24672,22268,2320,,800355,509487,223686,571602,285801,
2021-03-03,30591,27962,2576,,830946,537398,249054,576688,288344,
2021-03-04,34684,32455,2144,,865630,569787,279349,580876,290438,
2021-03-05,39986,38156,1782,,905616,607895,315709,584372,292186,
2021-03-06,44139,41936,2165,,949755,649776,355466,588620,294310,
2021-03-07,32731,31553,1174,,982486,681255,385829,590852,295426,
2021-03-08,24034,22160,1860,,1006520,703347,406115,594464,297232,
2021-03-09,33279,29832,3419,,1039799,733113,432508,601210,300605,
2021-03-10,38325,34065,4215,,1078124,767104,462332,609544,304772,
2021-03-11,43966,40695,3232,,1122090,807733,499781,615904,307952,
2021-03-12,47699,45987,1688,,1169789,853656,544066,619180,309590,
2021-03-13,57902,55031,2844,,1227691,908616,596236,624760,312380,
2021-03-14,43403,42167,1219,,1271094,950700,637169,627062,313531,
2021-03-15,32800,31103,1682,,1303894,981744,666574,630340,315170,
2021-03-16,53944,51650,2278,,1357838,1033329,715924,634810,317405,
2021-03-17,61052,58515,2494,,1418890,1091778,771929,639698,319849,
2021-03-18,61528,59074,2429,,1480418,1150780,828555,644450,322225,
2021-03-19,64453,61130,3269,,1544871,1211832,886391,650882,325441,
2021-03-20,62554,59968,2555,,1607425,1271744,943796,655896,327948,
2021-03-21,43990,42469,1535,,1651415,1314148,984702,658892,329446,
2021-03-22,30992,30028,975,,1682407,1344088,1013723,660730,330365,
2021-03-23,54606,51834,2722,,1737013,1395827,1062803,666048,333024,
2021-03-24,76418,73237,3133,,1813431,1468974,1132874,672200,336100,
2021-03-25,82902,80323,2532,,1896333,1549218,1210643,677150,338575,
2021-03-26,86991,83462,3490,,1983324,1632599,1290586,684026,342013,
2021-03-27,80835,77887,2864,,2064159,1710383,1365571,689624,344812,
2021-03-28,66983,65395,1554,,2131142,1775688,1429379,692618,346309,
2021-03-29,51727,49041,2651,,2182869,1824649,1475735,697828,348914,
2021-03-30,73565,70158,3348,,2256434,1894730,1542509,704442,352221,
2021-03-31,93141,89493,3581,,2349575,1984125,1628376,711498,355749,
2021-04-01,89300,85427,3834,,2438875,2069454,1709924,719060,359530,
2021-04-02,93072,88849,4207,,2531947,2158217,1794532,727370,363685,
2021-04-03,60992,59318,1732,,2592939,2217444,1852078,730732,365366,
2021-04-04,72323,70670,1649,,2665262,2288003,1921046,733914,366957,
2021-04-05,53724,53256,468,,2718986,2341175,1973798,734754,367377,
2021-04-06,79570,77707,1883,,2798556,2418780,2049574,738412,369206,
2021-04-07,107993,104934,3050,,2906549,2523589,2151391,744396,372198,
2021-04-08,114059,110096,4020,,3020608,2633574,2257412,752324,376162,
2021-04-09,109831,105614,4291,,3130439,2739070,2358682,760776,380388,
2021-04-10,109225,105471,3846,,3239664,2844413,2460245,768336,384168,
2021-04-11,98614,95501,3257,,3338278,2939789,2552423,774732,387366,
2021-04-12,76060,74999,1154,,3414338,3014640,2626188,776904,388452,
2021-04-13,99461,96084,3397,,3513799,3110615,2718814,783602,391801,
2021-04-14,117034,113274,3648,,3630833,3223771,2828362,790818,395409,
2021-04-15,113553,109500,3895,,3744386,3333145,2933898,798494,399247,
2021-04-16,118087,113717,4191,,3862473,3446752,3043358,806788,403394,
2021-04-17,112402,107818,4445,,3974875,3554436,3146656,815560,407780,
2021-04-18,88733,86498,2102,,4063608,3640811,3230983,819656,409828,
2021-04-19,68961,67434,1448,,4132569,3708115,3296890,822450,411225,
2021-04-20,101914,98593,3116,,4234483,3806546,3392270,828552,414276,
2021-04-21,141985,137718,4033,,4376468,3944090,3525849,836482,418241,
2021-04-22,139460,135322,3901,,4515928,4079283,3657197,844172,422086,
2021-04-23,138195,131789,6160,,4654123,4210918,3782730,856376,428188,
2021-04-24,130272,126218,3881,,4784395,4336988,3904975,864026,432013,
2021-04-25,102006,98601,3176,,4886401,4435441,4000319,870244,435122,
2021-04-26,70997,69295,1555,,4957398,4504605,4067988,873234,436617,
2021-04-27,98490,95415,2885,,5055888,4599859,4160420,878878,439439,
2021-04-28,120561,115944,4426,,5176449,4715635,4271842,887586,443793,
2021-04-29,124469,119278,5044,,5300918,4834746,4385978,897536,448768,
2021-04-30,115802,110557,5009,,5416720,4945130,4491430,907400,453700,
2021-05-01,111275,107422,3638,,5527995,5052371,4595110,914522,457261,
2021-05-02,79131,76158,2860,,5607126,5128372,4668317,920110,460055,
2021-05-03,56785,55118,1595,,5663911,5183335,4721745,923180,461590,
2021-05-04,91915,88547,3282,,5755826,5271704,4806909,929590,464795,
2021-05-05,137984,133282,4617,,5893810,5404817,4935468,938698,469349,
2021-05-06,141824,136874,4813,,6035634,5541507,5067407,948200,474100,
2021-05-07,150265,145234,4829,,6185899,5686581,5207711,957740,478870,
2021-05-08,142443,137760,4435,,6328342,5824146,5340920,966452,483226,
2021-05-09,124788,121144,3476,,6453130,5945126,5458488,973276,486638,
2021-05-10,97794,95819,1875,,6550924,6040756,5552310,976892,488446,
2021-05-11,113510,108845,4486,,6664434,6149399,5656538,985722,492861,
2021-05-12,145028,138006,6876,,6809462,6287226,5787555,999342,499671,
2021-05-13,142656,135306,7202,,6952118,6422357,5915558,1013598,506799,
2021-05-14,148857,138766,9922,,7100975,6560935,6044279,1033312,516656,
2021-05-15,159711,149674,9859,,7260686,6710422,6183982,1052880,526440,
2021-05-16,144347,136083,8060,,7405033,6846337,6311917,1068840,534420,
2021-05-17,114963,110868,3942,,7519996,6957016,6418730,1076572,538286,
2021-05-18,111309,100451,10656,,7631305,7057271,6508391,1097760,548880,
2021-05-19,149860,133458,16225,,7781165,7190577,6625546,1130062,565031,
2021-05-20,151545,131565,19768,,7932710,7321953,6737223,1169460,584730,
2021-05-21,165364,140865,24242,,8098074,7462637,6853742,1217790,608895,
2021-05-22,199411,172226,26960,,8297485,7634666,6998892,1271548,635774,
2021-05-23,139809,127442,12222,,8437294,7761930,7113996,1295868,647934,
2021-05-24,100284,93314,6825,,8537578,7855071,7200382,1309378,654689,
2021-05-25,90446,82966,7271,,8628024,7937874,7275981,1323786,661893,
2021-05-26,139758,112996,26499,,8767782,8050683,7362361,1376644,688322,
2021-05-27,152046,123028,28765,,8919828,8173554,7456536,1434036,717018,
2021-05-28,163845,132294,31246,,9083673,8305675,7557470,1496410,748205,
2021-05-29,153361,117107,36022,,9237034,8422632,7638461,1568342,784171,
2021-05-30,149708,119007,30476,,9386742,8541469,7726884,1629170,814585,
2021-05-31,99198,79805,19202,,9485940,8621104,7787381,1667446,833723,
2021-06-01,124172,90597,33241,,9610112,8711506,7844617,1733778,866889,
2021-06-02,145291,102131,42910,,9755403,8813456,7903726,1819460,909730,
2021-06-03,155339,99894,55167,,9910742,8913165,7948339,1929652,964826,
2021-06-04,181691,115518,65903,,10092433,9028484,7997843,2061282,1030641,
2021-06-05,171996,103416,68304,,10264429,9131702,8032842,2197720,1098860,
2021-06-06,163370,91850,71240,,10427799,9223374,8053344,2340060,1170030,
2021-06-07,119550,63042,56291,,10547349,9286219,8059973,2452492,1226246,
2021-06-08,161878,72439,89001,,10709227,9358469,8043302,2630334,1315167,
2021-06-09,181449,70795,110188,,10890676,9429087,8003813,2850548,1425274,
2021-06-10,185563,66415,118662,,11076239,9495299,7951454,3087690,1543845,
2021-06-11,204760,67501,136506,,11280999,9562614,7882345,3360538,1680269,
2021-06-12,199703,62658,136448,,11480702,9625090,7808465,3633250,1816625,
2021-06-13,190311,58870,130914,,11671013,9683785,7736326,3894918,1947459,
2021-06-14,137680,38688,98593,,11808693,9722277,7676330,4091894,2045947,
2021-06-15,189261,42590,146318,,11997954,9764649,7572481,4384336,2192168,
2021-06-16,206118,42420,163058,,12204072,9806873,7451750,4710246,2355123,
2021-06-17,210394,37923,171891,,12414466,9844581,7317659,5053844,2526922,
2021-06-18,217127,35343,181181,,12631593,9879734,7171723,5416022,2708011,
2021-06-19,215853,35485,179698,,12847446,9915013,7027416,5775194,2887597,
2021-06-20,186250,35553,150121,,13033696,9950368,6912758,6075220,3037610,
2021-06-21,120420,20821,99100,,13154116,9970994,6834376,6273236,3136618,
2021-06-22,204911,27498,176659,,13359027,9998298,6685130,6626336,3313168,
2021-06-23,230502,28616,201150,,13589529,10026714,6512504,7028420,3514210,
2021-06-24,227664,26663,200252,,13817193,10053181,6338829,7428704,3714352,
2021-06-25,251083,27966,222373,,14068276,10080946,6144339,7873214,3936607,
2021-06-26,261274,29995,230577,,14329550,10110716,5943672,8334088,4167044,
2021-06-27,204986,27781,176602,,14534536,10138315,5794779,8687072,4343536,
2021-06-28,199234,20951,177724,,14733770,10159068,5637933,9042270,4521135,
2021-06-29,250096,24487,224881,,14983866,10183314,5437452,9491724,4745862,
2021-06-30,275517,24166,250785,,15259383,10207277,5210759,9993036,4996518,
2021-07-01,271955,25301,246101,,15531338,10232360,4989880,10484960,5242480,
2021-07-02,144709,11581,132904,,15676047,10243767,4868485,10750564,5375282,
2021-07-03,216881,19922,196727,,15892928,10263467,4691607,11143720,5571860,
2021-07-04,196153,19404,176528,,16089081,10282685,4534416,11496538,5748269,
2021-07-05,148714,12438,136133,,16237795,10294933,4410659,11768548,5884274,
2021-07-06,220012,19984,199813,,16457807,10314701,4230760,12167882,6083941,
2021-07-07,246599,22963,223397,,16704406,10337438,4030248,12614380,6307190,
2021-07-08,231188,21345,209634,,16935594,10358577,3841888,13033378,6516689,
2021-07-09,226975,21500,205308,,17162569,10379875,3658010,13443730,6721865,
2021-07-10,209050,20534,188363,,17371619,10400205,3490114,13820182,6910091,
2021-07-11,171659,17573,153961,,17543278,10417577,3353672,14127810,7063905,
2021-07-12,123127,11444,111586,,17666405,10428832,3253478,14350708,7175354,
2021-07-13,178474,19015,159317,,17844879,10447625,3113109,14669032,7334516,
2021-07-14,180020,19296,160568,,18024899,10466706,2971785,14989842,7494921,
2021-07-15,167174,19579,147423,,18192073,10486074,2843894,15284360,7642180,
2021-07-16,169330,19893,149284,,18361403,10505765,2714454,15582622,7791311,
2021-07-17,172986,20256,152603,,18534389,10525772,2582050,15887444,7943722,
2021-07-18,133619,15924,117558,,18668008,10541512,2480380,16122264,8061132,
2021-07-19,91968,10412,81449,,18759976,10551711,2409305,16284812,8142406,
2021-07-20,133523,16943,116521,,18893499,10568414,2309663,16517502,8258751,
2021-07-21,140074,16979,123024,,19033573,10585178,2203565,16763226,8381613,
2021-07-22,125589,17635,107818,,19159162,10602589,2113335,16978508,8489254,
2021-07-23,120243,16980,103057,,19279405,10619328,2027216,17184224,8592112,
2021-07-24,126676,18328,108111,,19406081,10637453,1937393,17400120,8700060,
2021-07-25,103620,14855,88636,,19509701,10652084,1863569,17577030,8788515,
2021-07-26,66676,9881,56704,,19576377,10661747,1816709,17690076,8845038,
2021-07-27,92359,15314,76883,,19668736,10676800,1755096,17843408,8921704,
2021-07-28,93926,16455,77397,,19762662,10693020,1694110,17997820,8998910,
2021-07-29,89379,16695,72522,,19852041,10709483,1638239,18142488,9071244,
2021-07-30,84042,16095,67834,,19936083,10725350,1586460,18277780,9138890,
2021-07-31,83827,15703,67971,,20019910,10740835,1534164,18413342,9206671,
2021-08-01,61849,11308,50360,,20081759,10751917,1495077,18513680,9256840,
2021-08-02,42470,7404,34948,,20124229,10759123,1467501,18583244,9291622,
2021-08-03,33274,5947,27157,,20157503,10764837,1446268,18637138,9318569,
2021-08-04,61301,12366,48745,,20218804,10776968,1409852,18734232,9367116,
2021-08-05,59429,12529,46747,,20278233,10789289,1375590,18827398,9413699,
2021-08-06,56003,11847,43940,,20334236,10800876,1343466,18914820,9457410,
2021-08-07,62350,12124,50030,,20396586,10812739,1305517,19014444,9507222,
2021-08-08,48653,9252,39214,,20445239,10821763,1275532,19092462,9546231,
2021-08-09,30845,5931,24739,,20476084,10827480,1256697,19141566,9570783,
2021-08-10,49234,10497,38437,,20525318,10837697,1228723,19217948,9608974,
2021-08-11,48703,10757,37702,,20574021,10848207,1201747,19292920,9646460,
2021-08-12,49224,11184,37813,,20623245,10859140,1175076,19368128,9684064,
2021-08-13,49601,11719,37607,,20672846,10870618,1149158,19442920,9721460,
2021-08-14,51196,12123,38864,,20724042,10882491,1122391,19520200,9760100,
2021-08-15,41744,9840,31682,,20765786,10892129,1100519,19583220,9791610,
2021-08-16,26720,6173,20392,,20792506,10898079,1086274,19623610,9811805,
2021-08-17,40486,11050,29173,,20832992,10908879,1068127,19681504,9840752,
2021-08-18,41877,11960,29676,,20874869,10920597,1050379,19740436,9870218,
2021-08-19,45868,16518,29088,,20920737,10936864,1037781,19798166,9899083,
2021-08-20,46413,16272,29727,,20967150,10952880,1024299,19857162,9928581,
2021-08-21,47936,15138,32430,,21015086,10967758,1006974,19921568,9960784,
2021-08-22,34376,10800,23309,,21049462,10978312,994441,19967742,9983871,
2021-08-23,23214,7002,15996,,21072676,10985079,985426,19999306,9999653,
2021-08-24,37636,13365,23816,,21110312,10998190,974952,20046476,10023238,
2021-08-25,41315,14403,26305,,21151627,11012337,963031,20098612,10049306,
2021-08-26,39253,13549,24962,,21190880,11025610,951583,20148054,10074027,
2021-08-27,37652,12926,23682,,21228532,11038295,940800,20194990,10097495,
2021-08-28,40093,13410,25508,,21268625,11051426,928678,20245496,10122748,
2021-08-29,30530,10239,19935,,21299155,11061433,918963,20284940,10142470,
2021-08-30,18228,6137,11842,,21317383,11067322,913229,20308186,10154093,
2021-08-31,32698,11933,19615,,21350081,11078987,905519,20346936,10173468,
2021-09-01,36219,12935,21939,,21386300,11091689,896499,20390380,10195190,
2021-09-02,37753,15637,19655,,21424053,11107074,892456,20429236,10214618,
2021-09-03,46848,21071,22429,,21470901,11127897,891079,20473636,10236818,
2021-09-04,46859,20581,24767,,21517760,11148232,886870,20522724,10261362,
2021-09-05,33056,14199,18569,,21550816,11162187,882480,20559414,10279707,
2021-09-06,21696,9482,12026,,21572512,11171420,879919,20583002,10291501,
2021-09-07,14982,6716,8081,,21587494,11177879,878537,20598684,10299342,
2021-09-08,41125,17104,20926,,21628619,11194719,874697,20640044,10320022,
2021-09-09,41435,16969,19671,,21670054,11211411,871970,20678882,10339441,
2021-09-10,39623,15502,18989,,21709677,11226651,868465,20716372,10358186,
2021-09-11,42355,15926,23328,,21752032,11242298,861042,20762512,10381256,
2021-09-12,29950,11528,17860,,21781982,11253532,854680,20797704,10398852,
2021-09-13,16072,6399,9177,,21798054,11259697,851887,20815620,10407810,
2021-09-14,29892,11553,15285,,21827946,11270948,848128,20845640,10422820,
2021-09-15,39263,14020,19411,,21867209,11284709,842722,20883974,10441987,
2021-09-16,39330,13976,19239,,21906539,11298450,837436,20922028,10461014,
2021-09-17,38906,13602,19326,,21945445,11311809,831700,20960218,10480109,
2021-09-18,41207,14076,23509,,21986652,11325612,822246,21006732,10503366,
2021-09-19,30644,10824,18975,,22017296,11336177,814082,21044190,10522095,
2021-09-20,16727,6099,10173,,22034023,11342022,809985,21064074,10532037,
2021-09-21,31344,11210,16981,,22065367,11352967,804198,21097538,10548769,
2021-09-22,41794,14813,22915,,22107161,11367484,796075,21142818,10571409,
2021-09-23,47209,16132,26020,,22154370,11383353,786168,21194370,10597185,
2021-09-24,46285,15626,26639,,22200655,11398718,775136,21247164,10623582,
2021-09-25,48176,15247,29938,,22248831,11413712,760426,21306572,10653286,
2021-09-26,37482,12415,24475,,22286313,11425852,748345,21355014,10677507,
2021-09-27,19146,6527,12313,,22305459,11432125,742543,21379164,10689582,
2021-09-28,30935,11289,17865,,22336394,11443155,735955,21414400,10707200,
2021-09-29,37867,12469,21715,,22374261,11455353,726689,21457328,10728664,
2021-09-30,37322,11648,21363,,22411583,11466742,716955,21499574,10749787,
2021-10-01,30860,9806,18402,,22442443,11476322,708346,21535952,10767976,
2021-10-02,37118,11151,23576,,22479561,11487203,695903,21582600,10791300,
2021-10-03,27198,8161,18321,,22506759,11495123,685730,21618786,10809393,
2021-10-04,14864,4744,9801,,22521623,11499621,680655,21637932,10818966,
2021-10-05,26801,8588,15857,,22548424,11507948,673371,21669154,10834577,
2021-10-06,31647,9635,18498,,22580071,11517324,664500,21705648,10852824,
2021-10-07,30335,9390,17114,,22610406,11526463,656763,21739400,10869700,
2021-10-08,32821,10738,18841,,22643227,11536931,648647,21776568,10888284,
2021-10-09,34121,10654,21007,,22677348,11547322,638280,21818084,10909042,
2021-10-10,23397,7655,15078,,22700745,11554726,630845,21847762,10923881,
2021-10-11,11999,3839,7862,,22712744,11558315,626806,21863018,10931509,
2021-10-12,5099,1625,3259,,22717843,11559662,625157,21869010,10934505,
2021-10-13,29092,9188,18076,,22746935,11568560,616253,21904614,10952307,
2021-10-14,29002,8902,17739,,22775937,11577187,607406,21939562,10969781,
2021-10-15,29076,8820,18158,,22805013,11585744,598055,21975378,10987689,
2021-10-16,31128,8983,19865,,22836141,11594436,587161,22014550,11007275,
2021-10-17,23693,7255,15367,,22859834,11601437,579036,22044802,11022401,
2021-10-18,12303,3747,8145,,22872137,11604903,574626,22060554,11030277,
2021-10-19,21251,6619,12621,,22893388,11611240,568611,22085258,11042629,
2021-10-20,25641,7536,14905,,22919029,11618529,561229,22114600,11057300,
2021-10-21,23158,6674,13023,,22942187,11624934,554869,22140130,11070065,
2021-10-22,26104,7307,15103,,22968291,11631918,547057,22169722,11084861,
2021-10-23,28162,7600,17147,,22996453,11639256,537503,22203506,11101753,
2021-10-24,19340,5727,12594,,23015793,11644727,530624,22228206,11114103,
2021-10-25,9923,2710,6473,,23025716,11647168,526853,22240630,11120315,
2021-10-26,18891,5385,11089,,23044607,11652275,521140,22262270,11131135,
2021-10-27,22835,6073,13202,,23067442,11658093,513997,22288192,11144096,
2021-10-28,22293,5791,12636,,23089735,11663596,507141,22312910,11156455,
2021-10-29,22800,5730,13040,,23112535,11669024,499816,22338416,11169208,
2021-10-30,24086,6033,14599,,23136621,11674785,491238,22367094,11183547,
2021-10-31,16466,4593,10591,,23153087,11679084,485235,22387698,11193849,
2021-11-01,7864,2079,5053,,23160951,11680883,482248,22397270,11198635,
2021-11-02,15614,4362,7738,,23176565,11684954,478861,22412186,11206093,
2021-11-03,18611,5065,9600,,23195176,11689716,474316,22430800,11215400,
2021-11-04,19491,4869,10024,,23214667,11694309,469146,22450326,11225163,
2021-11-05,21446,4399,9512,,23236113,11698419,464019,22468800,11234400,
2021-11-06,25324,5203,12150,,23261437,11703353,457055,22492596,11246298,
2021-11-07,21437,4021,8914,,23282874,11707094,452150,22509888,11254944,
2021-11-08,11989,2110,4730,,23294863,11708909,449514,22518790,11259395,
2021-11-09,24108,3846,7641,,23318971,11712434,445709,22533450,11266725,
2021-11-10,28461,4504,8985,,23347432,11716661,441214,22550894,11275447,
2021-11-11,28742,4301,9088,,23376174,11720666,436418,22568496,11284248,
2021-11-12,26726,4162,8223,,23402900,11724537,432343,22584388,11292194,
2021-11-13,34296,5078,11402,,23437196,11729309,426010,22606598,11303299,
2021-11-14,23209,3898,8597,,23460405,11732944,421304,22623280,11311640,
2021-11-15,12698,2185,4491,,23473103,11734869,418990,22631758,11315879,
2021-11-16,26163,3927,7474,,23499266,11738539,415439,22646200,11323100,
2021-11-17,31147,4046,7799,,23530413,11742303,411676,22661254,11330627,
2021-11-18,32473,3857,7507,,23562886,11745854,408012,22675684,11337842,
2021-11-19,35449,3858,7742,,23598335,11749411,404116,22690590,11345295,
2021-11-20,40099,4380,8808,,23638434,11753511,399679,22707664,11353832,
2021-11-21,28106,3432,6941,,23666540,11756681,396156,22721050,11360525,
2021-11-22,14889,1949,3889,,23681429,11758354,394210,22728288,11364144,
2021-11-23,33042,3272,6002,,23714471,11761346,391472,22739748,11369874,
2021-11-24,42633,3751,6793,,23757104,11764793,388419,22752748,11376374,
2021-11-25,46023,3932,6559,,23803127,11768450,385789,22765322,11382661,
2021-11-26,52834,11342,6608,,23855961,11779522,390516,22778012,11389006,
2021-11-27,63499,22349,7027,,23919460,11801590,405828,22791524,11395762,
2021-11-28,51447,27738,5308,,23970907,11829036,428246,22801580,11400790,
2021-11-29,33520,18933,2877,,24004427,11847708,444291,22806834,11403417,
2021-11-30,56009,20677,5122,,24060436,11868104,459836,22816536,11408268,
2021-12-01,69526,26238,5629,,24129962,11894036,480431,22827210,11413605,
2021-12-02,71614,26486,5029,,24201576,11920224,501875,22836698,11418349,
2021-12-03,73399,25097,5159,,24274975,11945025,521807,22846436,11423218,
2021-12-04,81134,27783,6058,47273,24356109,11972515,543523,,11428992,807462
2021-12-05,62613,31926,4401,26266,24418722,12004146,571040,,11433106,833624
2021-12-06,38621,19141,2710,16754,24457343,12022998,587464,,11435534,850300
2021-12-07,60268,14849,4461,40945,24517611,12037575,597842,,11439733,891171
2021-12-08,73436,19054,4675,49704,24591047,12056352,612211,,11444141,940797
2021-12-09,74474,18271,4332,51852,24665521,12074314,626142,,11448172,992564
2021-12-10,77462,17587,4644,55223,24742983,12091620,639080,,11452540,1047706
2021-12-11,83161,20402,5818,56929,24826144,12111733,653650,,11458083,1104549
2021-12-12,60743,22696,4152,33852,24886887,12134149,672188,,11461961,1138312
2021-12-13,34922,11600,2406,20893,24921809,12145452,681372,,11464080,1159110
2021-12-14,101955,8999,3855,89058,25023764,12154141,686501,,11467640,1248048
2021-12-15,127677,12427,4503,110710,25151441,12166264,694415,,11471849,1358658
2021-12-16,139323,12451,4237,122621,25290764,12178429,702619,,11475810,1481180
2021-12-17,159152,12400,4511,142219,25449916,12190554,710499,,11480055,1623302
2021-12-18,175567,13523,4918,157083,25625483,12203783,719092,,11484691,1780290
2021-12-19,140418,18156,3928,118300,25765901,12221638,733312,,11488326,1898479
2021-12-20,106811,10304,2743,93718,25872712,12231674,740863,,11490811,1992099
2021-12-21,215253,12961,4313,197957,26087965,12244319,749504,,11494815,2189935
2021-12-22,237203,14418,5192,217708,26325168,12258438,758716,,11499722,2407525
2021-12-23,257475,11715,5081,240584,26582643,12269849,765344,,11504505,2648003
2021-12-24,223387,9444,4560,209321,26806030,12278996,770224,,11508772,2857208
2021-12-25,89697,3885,2502,83322,26895727,12282606,771602,,11511004,2940423
2021-12-26,11894,387,357,11140,26907621,12282701,771624,,11511077,2951433
2021-12-27,46932,1492,1114,44295,26954553,12283948,771995,,11511953,2995608
2021-12-28,144755,6100,3999,134597,27099308,12289754,774085,,11515669,3130074
2021-12-29,175453,9374,4576,161432,27274761,12298832,778879,,11519953,3291378
2021-12-30,200035,10128,5341,184524,27474796,12308657,783651,,11525006,3475768
2021-12-31,195184,10007,5796,179130,27669980,12318375,787853,,11530522,3654772
2022-01-01,96937,5379,3875,87358,27766917,12323445,789349,,11534096,3741981
2022-01-02,19442,941,928,17444,27786359,12324095,789353,,11534742,3759279
2022-01-03,88248,4772,4591,78804,27874607,12328557,789526,,11539031,3837930
2022-01-04,146349,5996,5312,135001,28020956,12334225,790197,,11544028,3972775
2022-01-05,177465,7620,7293,162380,28198421,12341491,790513,,11550978,4134995
2022-01-06,191504,7201,6782,176996,28389925,12348373,790921,,11557452,4311836
2022-01-07,191222,7956,6987,175468,28581147,12355985,791878,,11564107,4487131
2022-01-08,181641,8624,6630,165200,28762788,12364277,793859,,11570418,4652175
2022-01-09,131088,9864,7177,113954,28893876,12373819,796541,,11577278,4765969
2022-01-10,90554,5108,4489,80826,28984430,12378605,797150,,11581455,4846642
2022-01-11,138851,6151,6561,125433,29123281,12384409,796727,,11587682,4971885
2022-01-12,156999,8157,8048,138671,29280280,12392237,796831,,11595406,5110388
2022-01-13,162661,9207,9211,141533,29442941,12401082,796813,,11604269,5251738
2022-01-14,159848,10751,10373,136033,29602789,12411472,797186,,11614286,5387573
2022-01-15,161188,11011,11670,135873,29763977,12422112,796516,,11625596,5523253
2022-01-16,109769,9286,9671,89453,29873746,12431036,796124,,11634912,5612488
2022-01-17,65776,5935,6563,52638,29939522,12436635,795486,,11641149,5664941
2022-01-18,36098,2004,2126,31145,29975620,12438284,795353,,11642931,5695890
2022-01-19,101306,5580,6717,85948,30076926,12443464,794198,,11649266,5781611
2022-01-20,103583,6321,7003,85723,30180509,12449401,793508,,11655893,5867111
2022-01-21,102097,6230,8057,82498,30282606,12455227,791667,,11663560,5949381
2022-01-22,102563,8711,12068,78106,30385169,12463549,788303,,11675246,6027259
2022-01-23,76679,7306,13988,54785,30461848,12470512,781614,,11688898,6081822
2022-01-24,42258,3194,7935,30740,30504106,12473342,776855,,11696487,6112355
2022-01-25,62556,3756,8366,48115,30566662,12476719,772230,,11704489,6160251
2022-01-26,77877,4912,13170,55687,30644539,12481254,763967,,11717287,6215696
2022-01-27,78062,4894,13244,56039,30722601,12485776,755607,,11730169,6271498
2022-01-28,77272,4671,13671,53891,30799873,12490089,746594,,11743495,6325170
2022-01-29,84806,5529,17708,58107,30884679,12495254,734408,,11760846,6383032
2022-01-30,66493,5025,20622,40151,30951172,12499937,718797,,11781140,6422958
2022-01-31,34740,2176,9879,22346,30985912,12501794,711085,,11790709,6445115
2022-02-01,51345,3265,9662,36523,31037257,12504706,704678,,11800028,6481413
2022-02-02,57703,3845,12395,38677,31094960,12508221,696113,,11812108,6519891
2022-02-03,52575,3611,11508,34298,31147535,12511455,688204,,11823251,6553938
2022-02-04,43084,2948,10558,27281,31190619,12514093,680584,,11833509,6581025
2022-02-05,58710,3741,14469,37560,31249329,12517502,669844,,11847658,6618372
2022-02-06,49856,3640,16115,29571,31299185,12520819,657364,,11863455,6647719
2022-02-07,23228,1690,7807,13438,31322413,12522183,651234,,11870949,6660933
2022-02-08,33376,2354,7240,21966,31355789,12524207,646341,,11877866,6682666
2022-02-09,38869,2781,8912,24407,31394658,12526629,640204,,11886425,6706821
2022-02-10,37533,2764,8834,22550,31432191,12529057,634130,,11894927,6729141
2022-02-11,39439,2723,10288,23001,31471630,12531434,626556,,11904878,6751904
2022-02-12,42036,2953,11453,25313,31513666,12534053,618045,,11916008,6776993
2022-02-13,36311,2799,13140,19939,31549977,12536565,607701,,11928864,6796734
2022-02-14,16970,1175,6118,9469,31566947,12537465,602750,,11934715,6806003
2022-02-15,19344,1383,4746,11875,31586291,12538525,599377,,11939148,6817651
2022-02-16,26017,1766,7730,14946,31612308,12539994,593409,,11946585,6832396
2022-02-17,26756,1682,7518,14984,31639064,12541321,587564,,11953757,6847125
2022-02-18,23933,1353,6605,13674,31662997,12542357,582300,,11960057,6860590
2022-02-19,37830,1902,8335,26050,31700827,12543928,575862,,11968066,6886399
2022-02-20,32568,1495,7960,22804,31733395,12545123,569389,,11975734,6908999
2022-02-21,17501,913,3678,12756,31750896,12545741,566615,,11979126,6921544
2022-02-22,9100,428,1550,6953,31759996,12545880,565488,,11980392,6928287
2022-02-23,25328,1326,4791,17292,31785324,12546896,562016,,11984880,6945343
2022-02-24,24569,1401,5233,15480,31809893,12547976,558180,,11989796,6960580
2022-02-25,23099,1389,5137,14507,31832992,12549071,554425,,11994646,6974861
2022-02-26,25225,1384,5908,16554,31858217,12550145,549894,,12000251,6991189
2022-02-27,26952,1370,7367,17701,31885169,12551246,543886,,12007360,7008695
2022-02-28,10127,594,2529,6745,31895296,12551587,541943,,12009644,7015257
2022-03-01,13189,944,3148,8164,31908485,12552226,539729,,12012497,7023204
2022-03-02,15410,1163,3575,9616,31923895,12553128,537310,,12015818,7032643
2022-03-03,14293,1077,3224,8687,31938188,12553893,535155,,12018738,7041099
2022-03-04,14467,990,3442,8314,31952655,12554562,532699,,12021863,7049160
2022-03-05,18527,1277,4995,11182,31971182,12555530,528970,,12026560,7060118
2022-03-06,16509,1087,5522,9603,31987691,12556337,524529,,12031808,7069514
2022-03-07,5947,466,1861,3509,31993638,12556518,523127,,12033391,7072806
2022-03-08,7355,698,1937,4158,32000993,12556938,521881,,12035057,7076765
2022-03-09,11154,906,2736,6405,32012147,12557568,520045,,12037523,7082968
2022-03-10,12754,1044,3252,6835,32024901,12558335,517830,,12040505,7089590
2022-03-11,12886,904,3407,6862,32037787,12558950,515319,,12043631,7096236
2022-03-12,14679,1046,4179,8310,32052466,12559724,512183,,12047541,7104342
2022-03-13,14742,1090,4997,8330,32067208,12560523,508272,,12052251,7112435
2022-03-14,6329,448,2228,3497,32073537,12560700,506489,,12054211,7115718
2022-03-15,10196,791,2625,5972,32083733,12561201,504643,,12056558,7121476
2022-03-16,13054,933,3661,6950,32096787,12561846,501912,,12059934,7128196
2022-03-17,13190,1047,3957,6756,32109977,12562606,498995,,12063611,7134733
2022-03-18,11902,911,3145,6432,32121879,12563214,496751,,12066463,7140941
2022-03-19,14435,1002,4161,7900,32136314,12563936,493590,,12070346,7148622
2022-03-20,11740,989,3955,6370,32148054,12564654,490619,,12074035,7154784
2022-03-21,5056,414,1589,2813,32153110,12564809,489440,,12075369,7157394
2022-03-22,6704,552,1557,3888,32159814,12565074,488430,,12076644,7161066
2022-03-23,9966,785,2297,5193,32169780,12565544,486915,,12078629,7166018
2022-03-24,9293,724,2377,4609,32179073,12566004,485253,,12080751,7170423
2022-03-25,9218,782,2152,4746,32188291,12566523,483875,,12082648,7174957
2022-03-26,10923,935,2833,5504,32199214,12567181,481975,,12085206,7180242
2022-03-27,10222,909,3537,5299,32209436,12567830,479343,,12088487,7185330
2022-03-28,3578,319,1107,1987,32213014,12567909,478552,,12089357,7187123
2022-03-29,5337,498,1210,2688,32218351,12568122,477834,,12090288,7189589
2022-03-30,7850,748,1834,4121,32226201,12568592,476743,,12091849,7193486
2022-03-31,8646,689,1924,4413,32234847,12568992,475502,,12093490,7197677
2022-04-01,9303,802,1912,4885,32244150,12569502,474383,,12095119,7202323
2022-04-02,10432,884,2211,5570,32254582,12570099,473044,,12097055,7207676
2022-04-03,9199,880,2567,5063,32263781,12570723,471351,,12099372,7212538
2022-04-04,4197,387,1005,2406,32267978,12570849,470730,,12100119,7214741
2022-04-05,6068,599,1036,3050,32274046,12571107,470287,,12100820,7217516
2022-04-06,8370,715,1477,4377,32282416,12571531,469520,,12102011,7221666
2022-04-07,10334,733,1686,4834,32292750,12571964,468562,,12103402,7226257
2022-04-08,23990,811,1582,4836,32316740,12572497,467785,,12104712,7230877
2022-04-09,30489,969,1972,5894,32347229,12573168,466773,,12106395,7236548
2022-04-10,24856,976,2389,5331,32372085,12573887,465354,,12108533,7241679
2022-04-11,12569,385,875,2432,32384654,12574023,464860,,12109163,7243910
2022-04-12,28110,692,1017,3535,32412764,12574412,464528,,12109884,7247213
2022-04-13,37778,853,1561,4928,32450542,12574966,463816,,12111150,7251911
2022-04-14,37895,761,1614,4911,32488437,12575416,462960,,12112456,7256570
2022-04-15,43393,1230,2101,6726,32531830,12576348,462085,,12114263,7263059
2022-04-16,8089,358,650,1737,32539919,12576446,461791,,12114655,7264580
2022-04-17,21006,870,1924,4315,32560925,12577032,460730,,12116302,7268672
2022-04-18,5457,305,462,1288,32566382,12577050,460568,,12116482,7269719
2022-04-19,22648,615,773,3100,32589030,12577383,460401,,12116982,7272600
2022-04-20,40326,1063,1395,4617,32629356,12578120,460066,,12118054,7276953
2022-04-21,38750,942,1602,4678,32668106,12578766,459397,,12119369,7281397
2022-04-22,35616,1013,1429,4266,32703722,12579507,458974,,12120533,7285445
2022-04-23,34645,1006,1734,4713,32738367,12580229,458243,,12121986,7289919
2022-04-24,20810,1021,1886,3777,32759177,12581000,457375,,12123625,7293502
2022-04-25,8299,453,691,1707,32767476,12581184,457136,,12124048,7294993
2022-04-26,24611,732,945,3141,32792087,12581624,456917,,12124707,7297897
2022-04-27,33594,955,1368,3935,32825681,12582303,456496,,12125807,7301615
2022-04-28,32831,927,1412,3930,32858512,12582957,456002,,12126955,7305322
2022-04-29,32056,1098,1379,3910,32890568,12583758,455714,,12128044,7309004
2022-04-30,30275,923,1536,4020,32920843,12584384,455094,,12129290,7312788
2022-05-01,16750,768,1579,2970,32937593,12584855,454278,,12130577,7315515
2022-05-02,5933,309,524,1097,32943526,12584868,454059,,12130809,7316385
2022-05-03,20926,588,830,2346,32964452,12585151,453811,,12131340,7318492
2022-05-04,29416,800,1091,3293,32993868,12585641,453515,,12132126,7321536
2022-05-05,29093,873,1161,3125,33022961,12586202,453217,,12132985,7324417
2022-05-06,29087,1147,1280,2985,33052048,12587062,453079,,12133983,7327176
2022-05-07,28484,868,1261,3112,33080532,12587640,452681,,12134959,7330064
2022-05-08,15998,896,1309,2323,33096530,12588279,452266,,12136013,7332186
2022-05-09,5896,292,474,943,33102426,12588305,452078,,12136227,7332919
2022-05-10,21221,696,718,2119,33123647,12588684,452049,,12136635,7334779
2022-05-11,28945,837,1081,2655,33152592,12589188,451801,,12137387,7337162
2022-05-12,28236,800,1084,2511,33180828,12589691,451513,,12138178,7339432
2022-05-13,27591,878,1117,2468,33208419,12590259,451270,,12138989,7341643
2022-05-14,25688,807,1097,2609,33234107,12590751,450973,,12139778,7343998
2022-05-15,14845,751,1274,2055,33248952,12591230,450443,,12140787,7345834
2022-05-16,6381,325,532,1047,33255333,12591318,450232,,12141086,7346695
2022-05-17,19597,586,777,1742,33274930,12591590,450034,,12141556,7348189
2022-05-18,26542,878,1101,2272,33301472,12592204,449806,,12142398,7350246
2022-05-19,24436,682,1156,2159,33325908,12592619,449325,,12143294,7352188
2022-05-20,24260,801,1136,2215,33350168,12593153,448986,,12144167,7354186
2022-05-21,22398,692,1167,2346,33372566,12593536,448502,,12145034,7356290
2022-05-22,10556,551,889,1486,33383122,12593826,448159,,12145667,7357559
2022-05-23,4564,241,462,787,33387686,12593808,447936,,12145872,7358138
2022-05-24,2616,119,178,434,33390302,12593674,447875,,12145799,7358363
2022-05-25,19357,655,947,1952,33409659,12594063,447573,,12146490,7360105
2022-05-26,20639,664,949,1908,33430298,12594454,447282,,12147172,7361791
2022-05-27,21754,816,1057,2075,33452052,12594983,447038,,12147945,7363634
2022-05-28,19401,721,1165,2146,33471453,12595434,446591,,12148843,7365566
2022-05-29,12108,761,1280,1725,33483561,12595960,446065,,12149895,7367099
2022-05-30,4580,311,550,751,33488141,12596025,445823,,12150202,7367652
2022-05-31,13545,572,749,1666,33501686,12596295,445640,,12150655,7369078
2022-06-01,16607,702,970,1877,33518293,12596693,445370,,12151323,7370701
2022-06-02,14601,556,866,1675,33532894,12596937,445053,,12151884,7372135
2022-06-03,16100,697,1095,1814,33548994,12597357,444649,,12152708,7373731
2022-06-04,13319,648,1164,1843,33562313,12597747,444128,,12153619,7375372
2022-06-05,7866,587,1109,1432,33570179,12598085,443602,,12154483,7376612
2022-06-06,3293,206,444,641,33573472,12598043,443361,,12154682,7377052
2022-06-07,11213,474,725,1370,33584685,12598218,443105,,12155113,7378178
2022-06-08,14062,667,1013,1609,33598747,12598626,442754,,12155872,7379569
2022-06-09,13368,662,922,1673,33612115,12599000,442489,,12156511,7381010
2022-06-10,13847,685,1066,1695,33625962,12599399,442100,,12157299,7382475
2022-06-11,12980,616,1030,1858,33638942,12599730,441684,,12158046,7384110
2022-06-12,8094,644,1236,1500,33647036,12600117,441088,,12159029,7385404
2022-06-13,3187,284,422,710,33650223,12600135,440945,,12159190,7385905
2022-06-14,10127,511,666,1264,33660350,12600357,440784,,12159573,7386931
2022-06-15,13503,471,831,1620,33673853,12600534,440422,,12160112,7388315
2022-06-16,12539,494,856,1616,33686392,12600723,440055,,12160668,7389684
2022-06-17,11687,480,816,1652,33698079,12600918,439712,,12161206,7391102
2022-06-18,11446,436,874,1860,33709525,12601083,439271,,12161812,7392738
2022-06-19,7000,483,897,1419,33716525,12601317,438856,,12162461,7393946
2022-06-20,2286,147,301,643,33718811,12601240,438696,,12162544,7394419
2022-06-21,9540,358,614,1383,33728351,12601311,438435,,12162876,7395554
2022-06-22,13606,406,724,1702,33741957,12601445,438110,,12163335,7397031
2022-06-23,13700,401,774,1682,33755657,12601580,437734,,12163846,7398500
2022-06-24,15362,435,811,1672,33771019,12601755,437354,,12164401,7399957
2022-06-25,14468,425,851,1713,33785487,12601920,436917,,12165003,7401462
2022-06-26,8156,432,885,1280,33793643,12602091,436457,,12165634,7402526
2022-06-27,3212,171,364,594,33796855,12602014,436260,,12165754,7402914
2022-06-28,9615,370,556,1223,33806470,12602099,436070,,12166029,7403905
2022-06-29,13307,413,728,1628,33819777,12602222,435753,,12166469,7405293
2022-06-30,12228,483,846,1576,33832005,12602421,435388,,12167033,7406636
2022-07-01,13035,548,970,1947,33845040,12602713,434961,,12167752,7408378
2022-07-02,1610,110,115,363,33846650,12602547,434954,,12167593,7408509
2022-07-03,5158,261,493,958,33851808,12602552,434713,,12167839,7409252
2022-07-04,2757,132,279,614,33854565,12602437,434565,,12167872,7409669
2022-07-05,11141,372,599,1572,33865706,12602512,434330,,12168182,7410993
2022-07-06,15955,545,857,2008,33881661,12602763,434012,,12168751,7412760
2022-07-07,15659,520,832,1923,33897320,12602996,433699,,12169297,7414431
2022-07-08,17882,555,870,2244,33915202,12603246,433383,,12169863,7416426
2022-07-09,14136,450,597,1840,33929338,12603422,433235,,12170187,7418032
2022-07-10,8745,475,754,1501,33938083,12603649,432955,,12170694,7419327
2022-07-11,4093,199,331,870,33942176,12603583,432820,,12170763,7419977
2022-07-12,12104,412,523,1654,33954280,12603696,432704,,12170992,7421377
2022-07-13,16716,562,771,2142,33970996,12603963,432489,,12171474,7423277
2022-07-14,16858,486,674,2023,33987854,12604144,432290,,12171854,7425061
2022-07-15,28890,599,822,2182,34016744,12604443,432066,,12172377,7427002
2022-07-16,30291,586,772,2324,34047035,12604716,431871,,12172845,7429075
2022-07-17,22926,538,636,1887,34069961,12605017,431770,,12173247,7430768
2022-07-18,11394,187,255,856,34081355,12604936,431697,,12173239,7431402
2022-07-19,28950,593,590,2134,34110305,12605254,431697,,12173557,7433304
2022-07-20,37633,841,923,2590,34147938,12605816,431610,,12174206,7435657
2022-07-21,36351,732,810,2805,34184289,12606261,431525,,12174736,7438222
2022-07-22,35797,826,891,2682,34220086,12606800,431454,,12175346,7440667
2022-07-23,35139,820,913,2825,34255225,12607308,431353,,12175955,7443237
2022-07-24,21732,601,805,1773,34276957,12607646,431146,,12176500,7444785
2022-07-25,11932,308,311,1080,34288889,12607672,431138,,12176534,7445637
2022-07-26,26085,621,602,2209,34314974,12608010,431156,,12176854,7447604
2022-07-27,32465,810,846,2647,34347439,12608563,431118,,12177445,7450041
2022-07-28,31535,725,884,2605,34378974,12608994,430955,,12178039,7452398
2022-07-29,29990,1791,875,2643,34408964,12610494,431867,,12178627,7454792
2022-07-30,25824,2525,745,2433,34434788,12612743,433645,,12179098,7456996
2022-07-31,14298,1068,541,1559,34449086,12613543,434168,,12179375,7458328
2022-08-01,5911,336,223,681,34454997,12613621,434279,,12179342,7458786
2022-08-02,4474,305,135,601,34459471,12613656,434445,,12179211,7459165
2022-08-03,22932,2636,737,2236,34482403,12616016,436340,,12179676,7461165
2022-08-04,22226,2480,678,2129,34504629,12618170,438136,,12180034,7463032
2022-08-05,21791,2756,743,2066,34526420,12620646,440141,,12180505,7464871
2022-08-06,19642,2877,657,1990,34546062,12623212,442355,,12180857,7466603
2022-08-07,12701,2235,621,1418,34558763,12625174,443963,,12181211,7467805
2022-08-08,4766,570,188,603,34563529,12625459,444338,,12181121,7468174
2022-08-09,14007,1466,557,1590,34577536,12626638,445241,,12181397,7469523
2022-08-10,19127,2364,718,1990,34596663,12628729,446885,,12181844,7471285
2022-08-11,17074,2040,718,1854,34613737,12630496,448205,,12182291,7472909
2022-08-12,16980,2048,734,1851,34630717,12632256,449518,,12182738,7474532
2022-08-13,15949,2223,762,1806,34646666,12634198,450977,,12183221,7476100
2022-08-14,9524,1621,618,1082,34656190,12635530,451976,,12183554,7476946
2022-08-15,3869,388,269,477,34660059,12635666,452092,,12183574,7477215
2022-08-16,10802,1073,514,1355,34670861,12636440,452649,,12183791,7478320
2022-08-17,16095,1834,738,1781,34686956,12637988,453744,,12184244,7479866
2022-08-18,14928,1640,748,1692,34701884,12639305,454632,,12184673,7481288
2022-08-19,15309,1846,748,1546,34717193,12640876,455726,,12185150,7482602
2022-08-20,14281,1640,739,1545,34731474,12642225,456621,,12185604,7483909
2022-08-21,9899,1532,659,1163,34741373,12643494,457490,,12186004,7484857
2022-08-22,4163,481,271,561,34745536,12643677,457697,,12185980,7485163
2022-08-23,11130,1248,554,1493,34756666,12644620,458388,,12186232,7486405
2022-08-24,14754,1808,869,2186,34771420,12646159,459327,,12186832,7488362
2022-08-25,14026,1718,780,2120,34785446,12647590,460258,,12187332,7490238
2022-08-26,13925,1688,815,2090,34799371,12648984,461124,,12187860,7492080
2022-08-27,12411,1484,876,1997,34811782,12650143,461726,,12188417,7493811
2022-08-28,7922,1258,620,1397,34819704,12651142,462362,,12188780,7494990
2022-08-29,3395,504,283,681,34823099,12651371,462578,,12188793,7495443
2022-08-30,9904,1169,649,1855,34833003,12652184,463092,,12189092,7496997
2022-08-31,13509,1627,946,2312,34846512,12653523,463769,,12189754,7499068
2022-09-01,12903,1721,912,2138,34859415,12654948,464573,,12190375,7500960
2022-09-02,15041,1615,991,4919,34874456,12656288,465189,,12191099,7505653
2022-09-03,14710,1525,920,5513,34889166,12657532,465791,,12191741,7510933
2022-09-04,8663,1010,675,3234,34897829,12658283,466117,,12192166,7513950
2022-09-05,3553,321,229,1386,34901382,12658340,466206,,12192134,7515114
2022-09-06,2462,157,113,1128,34903844,12658244,466247,,12191997,7516034
2022-09-07,10924,1018,587,3491,34914768,12658965,466674,,12192291,7519275
2022-09-08,10865,1021,524,2790,34925633,12659660,467168,,12192492,7521791
2022-09-09,9580,1012,488,2501,34935213,12660386,467687,,12192699,7524058
2022-09-10,10630,1264,551,3164,34945843,12661377,468393,,12192984,7526992
2022-09-11,9404,982,667,3734,34955247,12662113,468702,,12193411,7530518
2022-09-12,3124,294,204,1079,34958371,12662126,468786,,12193340,7531360
2022-09-13,6013,542,281,1132,34964384,12662384,469038,,12193346,7532251
2022-09-14,14479,797,433,1844,34978863,12662867,469398,,12193469,7533832
2022-09-15,15749,780,408,1533,34994612,12663328,469765,,12193563,7535095
2022-09-16,17753,766,446,1690,35012365,12663838,470079,,12193759,7536567
2022-09-17,17609,722,456,1665,35029974,12664258,470341,,12193917,7537979
2022-09-18,11210,777,451,1684,35041184,12664779,470665,,12194114,7539444
2022-09-19,4977,403,288,670,35046161,12664916,470776,,12194140,7539903
2022-09-20,13761,439,330,942,35059922,12665041,470883,,12194158,7540583
2022-09-21,23031,646,407,1496,35082953,12665384,471117,,12194267,7541829
2022-09-22,22905,636,398,1378,35105858,12665717,471349,,12194368,7542949
2022-09-23,22938,726,599,1417,35128796,12666146,471471,,12194675,7544114
2022-09-24,21682,736,690,1498,35150478,12666589,471513,,12195076,7545377
2022-09-25,11317,595,702,1355,35161795,12666910,471401,,12195509,7546501
2022-09-26,4561,192,218,594,35166356,12666818,471369,,12195449,7546855
2022-09-27,37649,498,365,1498,35204005,12667051,471498,,12195553,7548130
2022-09-28,50960,730,670,1902,35254965,12667514,471557,,12195957,7549808
2022-09-29,47992,637,739,1836,35302957,12667839,471448,,12196391,7551374
2022-09-30,47267,679,806,2001,35350224,12668197,471319,,12196878,7553099
2022-10-01,34440,527,633,1545,35384664,12668420,471211,,12197209,7554381
2022-10-02,24239,736,1028,1710,35408903,12668868,470916,,12197952,7555845
2022-10-03,10864,238,230,611,35419767,12668819,470920,,12197899,7556221
2022-10-04,32186,478,458,1169,35451953,12668982,470936,,12198046,7557118
2022-10-05,40420,625,740,1558,35492373,12669297,470816,,12198481,7558419
2022-10-06,38685,610,653,1568,35531058,12669606,470771,,12198835,7559729
2022-10-07,42230,660,852,1742,35573288,12669924,470571,,12199353,7561174
2022-10-08,37387,783,1145,2122,35610675,12670381,470203,,12200178,7563026
2022-10-09,18812,549,727,1557,35629487,12670657,470022,,12200635,7564350
2022-10-10,6862,170,370,567,35636349,12670532,469820,,12200712,7564659
2022-10-11,4989,124,111,318,35641338,12670366,469828,,12200538,7564741
2022-10-12,35104,579,685,1426,35676442,12670618,469720,,12200898,7565884
2022-10-13,36751,644,857,1621,35713193,12670903,469504,,12201399,7567203
2022-10-14,36967,621,752,1541,35750160,12671197,469370,,12201827,7568467
2022-10-15,35447,716,1013,1625,35785607,12671632,469070,,12202562,7569853
2022-10-16,20662,654,1024,1593,35806269,12672021,468694,,12203327,7571218
2022-10-17,7351,206,477,539,35813620,12671948,468422,,12203526,7571518
2022-10-18,36416,457,500,1397,35850036,12672091,468374,,12203717,7572648
2022-10-19,49885,619,729,1985,35899921,12672413,468261,,12204152,7574386
2022-10-20,51270,623,648,2048,35951191,12672728,468233,,12204495,7576175
2022-10-21,52836,697,618,1938,36004027,12673105,468309,,12204796,7577849
2022-10-22,50853,751,905,2309,36054880,12673533,468150,,12205383,7579888
2022-10-23,30631,578,783,2119,36085511,12673801,467939,,12205862,7581748
2022-10-24,14129,231,270,978,36099640,12673740,467895,,12205845,7582476
2022-10-25,41348,475,488,1816,36140988,12673877,467879,,12205998,7584004
2022-10-26,51626,617,660,2123,36192614,12674167,467832,,12206335,7585854
2022-10-27,50093,609,767,2163,36242707,12674458,467667,,12206791,7587752
2022-10-28,49779,590,675,2094,36292486,12674699,467578,,12207121,7589545
2022-10-29,50583,736,778,2218,36343069,12675096,467532,,12207564,7591472
2022-10-30,28389,664,930,2034,36371458,12675484,467262,,12208222,7593268
2022-10-31,12437,199,234,777,36383895,12675412,467224,,12208188,7593817
2022-11-01,33077,340,197,1220,36416972,12675415,467361,,12208054,7594750
2022-11-02,44274,576,622,1904,36461246,12675671,467311,,12208360,7596366
2022-11-03,44172,540,605,1856,36505418,12675895,467243,,12208652,7597947
2022-11-04,44626,652,528,2024,36550044,12676254,467360,,12208894,7599726
2022-11-05,45194,648,754,2369,36595238,12676610,467251,,12209359,7601836
2022-11-06,26014,560,771,2096,36621252,12676836,467037,,12209799,7603642
2022-11-07,10710,243,235,876,36631962,12676813,467042,,12209771,7604297
2022-11-08,33467,487,395,1584,36665429,12677023,467131,,12209892,7605647
2022-11-09,40523,605,570,1966,36705952,12677322,467164,,12210158,7607353
2022-11-10,39163,624,547,1927,36745115,12677637,467236,,12210401,7609013
2022-11-11,43331,638,641,2206,36788446,12677970,467232,,12210738,7610954
2022-11-12,36835,640,592,2184,36825281,12678294,467272,,12211022,7612863
2022-11-13,24261,559,770,2276,36849542,12678569,467055,,12211514,7614896
2022-11-14,10965,233,204,1023,36860507,12678519,467083,,12211436,7615672
2022-11-15,33585,484,379,1691,36894092,12678651,467184,,12211467,7617065
2022-11-16,43521,798,582,2371,36937613,12679165,467394,,12211771,7619198
2022-11-17,38320,674,646,2241,36975933,12679516,467418,,12212098,7621162
2022-11-18,40608,726,530,2328,37016541,12679910,467610,,12212300,7623200
2022-11-19,39644,1015,1031,3074,37056185,12680594,467590,,12213004,7625981
2022-11-20,22412,661,718,2440,37078597,12680991,467530,,12213461,7628201
2022-11-21,8918,197,192,969,37087515,12680937,467530,,12213407,7628975
2022-11-22,26431,479,368,1512,37113946,12681081,467637,,12213444,7630193
2022-11-23,32058,687,668,2068,37146004,12681450,467654,,12213796,7631991
2022-11-24,31893,663,750,2083,37177897,12681813,467565,,12214248,7633823
2022-11-25,30749,764,828,1950,37208646,12682282,467495,,12214787,7635524
2022-11-26,30275,907,1191,2696,37238921,12682867,467203,,12215664,7637944
2022-11-27,18672,611,944,2087,37257593,12683189,466865,,12216324,7639785
2022-11-28,7536,191,280,786,37265129,12683095,466769,,12216326,7640321
2022-11-29,21014,421,452,1291,37286143,12683202,466734,,12216468,7641343
2022-11-30,27884,647,648,1840,37314027,12683551,466731,,12216820,7642925
2022-12-01,24799,593,682,1691,37338826,12683836,466639,,12217197,7644347
2022-12-02,25047,524,631,1771,37363873,12684050,466526,,12217524,7645850
2022-12-03,25551,587,780,1944,37389424,12684328,466323,,12218005,7647544
2022-12-04,15246,499,606,1699,37404670,12684514,466212,,12218302,7648966
2022-12-05,6879,168,156,746,37411549,12684404,466219,,12218185,7649473
2022-12-06,20335,421,351,1376,37431884,12684482,466285,,12218197,7650557
2022-12-07,24759,553,608,1668,37456643,12684740,466225,,12218515,7651970
2022-12-08,23154,564,523,1760,37479797,12685005,466264,,12218741,7653468
2022-12-09,23320,636,575,1631,37503117,12685336,466322,,12219014,7654843
2022-12-10,22566,511,600,1627,37525683,12685554,466231,,12219323,7656214
2022-12-11,14200,549,785,1566,37539883,12685857,465993,,12219864,7657566
2022-12-12,5506,150,157,593,37545389,12685737,465981,,12219756,7657932
2022-12-13,17788,378,367,1125,37563177,12685815,465991,,12219824,7658800
2022-12-14,21311,511,547,1452,37584488,12686060,465949,,12220111,7660027
2022-12-15,21958,532,602,1578,37606446,12686280,465878,,12220402,7661334
2022-12-16,16282,379,450,1030,37622728,12686351,465804,,12220547,7662105
2022-12-17,18693,559,506,1273,37641421,12686615,465855,,12220760,7663113
2022-12-18,12635,529,794,1305,37654056,12686885,465589,,12221296,7664187
2022-12-19,4585,133,115,448,37658641,12686713,465603,,12221110,7664371
2022-12-20,16202,501,448,1105,37674843,12686920,465650,,12221270,7665226
2022-12-21,18465,547,551,1298,37693308,12687189,465643,,12221546,7666281
2022-12-22,18589,576,589,1743,37711897,12687495,465630,,12221865,7667787
2022-12-23,15637,580,598,1712,37727534,12687748,465607,,12222141,7669225
2022-12-24,5335,224,171,671,37732869,12687686,465659,,12222027,7669640
2022-12-25,2441,153,152,480,37735310,12687552,465652,,12221900,7669872
2022-12-26,262,12,7,48,37735572,12687294,465653,,12221641,7669686
2022-12-27,2091,99,36,305,37737663,12687135,465713,,12221422,7669774
2022-12-28,8316,336,167,976,37745979,12687184,465878,,12221306,7670496
2022-12-29,13159,584,524,1601,37759138,12687482,465934,,12221548,7671849
2022-12-30,15815,671,657,1880,37774953,12687871,465945,,12221926,7673476
2022-12-31,11229,462,387,1353,37786182,12688019,466016,,12222003,7674553
2023-01-01,3907,202,219,562,37790089,12687939,465999,,12221940,7674866
2023-01-02,651,37,14,96,37790740,12687719,466022,,12221697,7674736
2023-01-03,8192,298,151,898,37798932,12687758,466163,,12221595,7675417
2023-01-04,14715,575,547,1544,37813647,12688076,466185,,12221891,7676737
2023-01-05,16111,653,534,1795,37829758,12688462,466300,,12222162,7678299
2023-01-06,18820,718,609,2044,37848578,12688930,466406,,12222524,7680123
2023-01-07,18520,706,638,2055,37867098,12689384,466469,,12222915,7681961
2023-01-08,11611,584,608,1630,37878709,12689738,466442,,12223296,7683386
2023-01-09,5298,216,196,664,37884007,12689691,466460,,12223231,7683825
2023-01-10,12157,419,316,781,37896164,12689843,466563,,12223280,7684368
2023-01-11,15538,460,370,1092,37911702,12690035,466651,,12223384,7685228
2023-01-12,14060,446,407,973,37925762,12690208,466689,,12223519,7685961
2023-01-13,14163,424,345,1039,37939925,12690422,466766,,12223656,7686809
2023-01-14,13375,478,452,1077,37953300,12690654,466789,,12223865,7687663
2023-01-15,9043,466,507,1049,37962343,12690899,466747,,12224152,7688524
2023-01-16,3745,148,130,479,37966088,12690813,466765,,12224048,7688791
2023-01-17,8850,270,179,651,37974938,12690795,466855,,12223940,7689195
2023-01-18,10243,350,273,760,37985181,12690902,466932,,12223970,7689731
2023-01-19,10580,318,318,760,37995761,12690978,466928,,12224050,7690282
2023-01-20,9824,318,272,716,38005585,12691060,466972,,12224088,7690782
2023-01-21,11302,358,398,904,38016887,12691192,466932,,12224260,7691492
2023-01-22,7567,345,404,816,38024454,12691326,466871,,12224455,7692114
2023-01-23,3379,143,131,288,38027833,12691284,466883,,12224401,7692239
2023-01-24,8279,227,165,549,38036112,12691255,466943,,12224312,7692563
2023-01-25,10304,349,296,661,38046416,12691378,466994,,12224384,7693027
2023-01-26,6721,236,203,469,38053137,12691378,467026,,12224352,7693296
2023-01-27,6906,241,197,491,38060043,12691370,467069,,12224301,7693573
2023-01-28,9337,312,339,693,38069380,12691448,467038,,12224410,7694061
2023-01-29,5960,235,341,689,38075340,12691450,466927,,12224523,7694541
2023-01-30,1899,88,79,215,38077239,12691313,466934,,12224379,7694555
2023-01-31,5876,157,150,412,38083115,12691213,466939,,12224274,7694735
2023-02-01,7295,250,249,489,38090410,12691254,466938,,12224316,7695042
2023-02-02,6480,296,239,501,38096890,12691348,466993,,12224355,7695375
2023-02-03,6541,197,191,462,38103431,12691335,466997,,12224338,7695651
2023-02-04,6720,231,305,541,38110151,12691368,466918,,12224450,7696024
2023-02-05,4175,198,291,484,38114326,12691339,466824,,12224515,7696319
2023-02-06,1834,91,98,211,38116160,12691199,466815,,12224384,7696320
2023-02-07,4960,162,181,383,38121120,12691116,466794,,12224322,7696493
2023-02-08,5767,213,206,429,38126887,12691112,466800,,12224312,7696726
2023-02-09,6117,214,243,438,38133004,12691118,466771,,12224347,7696985
2023-02-10,5081,159,207,370,38138085,12691107,466721,,12224386,7697203
2023-02-11,6050,185,259,458,38144135,12691069,466643,,12224426,7697458
2023-02-12,4082,219,344,408,38148217,12691078,466515,,12224563,7697675
2023-02-13,1482,57,87,146,38149699,12690940,466484,,12224456,7697659
2023-02-14,3943,132,179,308,38153642,12690836,466436,,12224400,7697757
2023-02-15,4539,119,191,286,38158181,12690744,466364,,12224380,7697858
2023-02-16,4912,174,285,400,38163093,12690700,466251,,12224449,7698063
2023-02-17,4981,180,210,342,38168074,12690680,466220,,12224460,7698230
2023-02-18,5113,231,295,488,38173187,12690695,466154,,12224541,7698526
2023-02-19,3350,133,243,373,38176537,12690621,466041,,12224580,7698726
2023-02-20,1419,64,54,157,38177956,12690490,466049,,12224441,7698716
2023-02-21,912,25,14,107,38178868,12690329,466058,,12224271,7698654
2023-02-22,4134,130,213,370,38183002,12690268,465970,,12224298,7698865
2023-02-23,4276,163,231,390,38187278,12690202,465895,,12224307,7699052
2023-02-24,3028,138,229,272,38190306,12690145,465800,,12224345,7699146
2023-02-25,5019,215,540,384,38195325,12690156,465474,,12224682,7699360
2023-02-26,3472,146,681,384,38198797,12690095,464937,,12225158,7699564
2023-02-27,1074,37,57,97,38199871,12689943,464914,,12225029,7699505
2023-02-28,2723,98,163,232,38202594,12689805,464847,,12224958,7699524
2023-03-01,3845,138,428,333,38206439,12689704,464555,,12225149,7699637
2023-03-02,4588,158,495,328,38211027,12689625,464213,,12225412,7699765
2023-03-03,4364,160,357,333,38215391,12689573,464014,,12225559,7699905
2023-03-04,4965,207,623,350,38220356,12689574,463596,,12225978,7700072
2023-03-05,2532,110,449,251,38222888,12689466,463256,,12226210,7700131
2023-03-06,1156,48,37,114,38224044,12689318,463265,,12226053,7700073
2023-03-07,3213,89,171,222,38227257,12689167,463180,,12225987,7700091
2023-03-08,4311,133,412,283,38231568,12689084,462900,,12226184,7700180
2023-03-09,4608,171,452,312,38236176,12689040,462614,,12226426,7700310
2023-03-10,3939,101,138,255,38240115,12688954,462575,,12226379,7700400
2023-03-11,4055,140,170,285,38244170,12688922,462542,,12226380,7700530
2023-03-12,2882,109,234,301,38247052,12688828,462412,,12226416,7700651
2023-03-13,862,32,32,105,38247914,12688685,462410,,12226275,7700605
2023-03-14,3057,100,109,256,38250971,12688588,462401,,12226187,7700690
2023-03-15,4095,140,163,309,38255066,12688548,462378,,12226170,7700838
2023-03-16,4018,174,234,277,38259084,12688492,462314,,12226178,7700922
2023-03-17,4276,170,202,307,38263360,12688440,462278,,12226162,7701030
2023-03-18,4352,145,194,296,38267712,12688390,462229,,12226161,7701151
2023-03-19,2718,129,233,255,38270430,12688367,462125,,12226242,7701265
2023-03-20,774,31,19,74,38271204,12688211,462137,,12226074,7701172
2023-03-21,2890,69,84,199,38274094,12688085,462118,,12225967,7701203
2023-03-22,3889,130,131,249,38277983,12688027,462114,,12225913,7701282
2023-03-23,3802,119,171,224,38281785,12687959,462057,,12225902,7701343
2023-03-24,3682,103,115,236,38285467,12687894,462044,,12225850,7701426
2023-03-25,4267,108,171,248,38289734,12687827,461977,,12225850,7701521
2023-03-26,2470,114,211,200,38292204,12687782,461878,,12225904,7701578
2023-03-27,912,48,32,68,38293116,12687690,461894,,12225796,7701523
2023-03-28,3097,86,78,202,38296213,12687605,461896,,12225709,7701577
2023-03-29,4148,128,136,221,38300361,12687560,461886,,12225674,7701641
2023-03-30,3837,109,164,210,38304198,12687520,461831,,12225689,7701713
2023-03-31,3973,142,109,219,38308171,12687495,461863,,12225632,7701785
2023-04-01,4180,137,146,224,38312351,12687481,461853,,12225628,7701875
2023-04-02,2178,58,121,172,38314529,12687370,461788,,12225582,7701899
2023-04-03,776,25,12,52,38315305,12687244,461800,,12225444,7701820
2023-04-04,3396,73,73,167,38318701,12687163,461799,,12225364,7701842
2023-04-05,4329,95,107,245,38323030,12687107,461786,,12225321,7701956
2023-04-06,3684,111,107,187,38326714,12687083,461790,,12225293,7702015
2023-04-07,4588,107,115,240,38331302,12687044,461780,,12225264,7702127
2023-04-08,833,22,11,54,38332135,12686946,461789,,12225157,7702080
2023-04-09,2426,83,103,157,38334561,12686936,461768,,12225168,7702157
2023-04-10,357,9,6,20,38334918,12686834,461769,,12225065,7702083
2023-04-11,2763,36,28,119,38337681,12686717,461777,,12224940,7702063
2023-04-12,6277,104,95,186,38343958,12686719,461786,,12224933,7702159
2023-04-13,6946,106,127,206,38350904,12686706,461763,,12224943,7702254
2023-04-14,6474,90,101,205,38357378,12686685,461751,,12224934,7702361
2023-04-15,6925,110,147,227,38364303,12686674,461713,,12224961,7702482
2023-04-16,3247,88,140,164,38367550,12686643,461660,,12224983,7702541
2023-04-17,857,12,13,49,38368407,12686564,461659,,12224905,7702508
2023-04-18,4756,102,77,158,38373163,12686577,461683,,12224894,7702586
2023-04-19,6490,121,98,174,38379653,12686627,461705,,12224922,7702698
2023-04-20,6271,103,149,207,38385924,12686654,461659,,12224995,7702839
2023-04-21,5735,87,72,133,38391659,12686680,461673,,12225007,7702917
2023-04-22,6307,94,89,177,38397966,12686726,461678,,12225048,7703058
2023-04-23,3266,121,147,170,38401232,12686821,461652,,12225169,7703205
2023-04-24,943,4,12,57,38402175,12686800,461644,,12225156,7703242
2023-04-25,4679,69,68,183,38406854,12686859,461645,,12225214,7703417
2023-04-26,6416,116,89,200,38413270,12686975,461672,,12225303,7703617
2023-04-27,6550,124,140,189,38419820,12687099,461656,,12225443,7703806
