"report_date","previous_day_total_doses_administered","previous_day_at_least_one","previous_day_fully_vaccinated","previous_day_3doses","total_doses_administered","total_individuals_at_least_one","total_individuals_partially_vaccinated","total_doses_in_fully_vaccinated_individuals","total_individuals_fully_vaccinated","total_individuals_3doses"
2021-01-01,6252,6242,2,,32205,32150,32139,22,11,
2021-01-02,4614,4602,6,,36819,36700,36687,26,13,
2021-01-03,5395,5388,3,,42214,42088,42072,32,16,
2021-01-04,5995,5993,0,,48209,48080,48065,30,15,
2021-01-05,9687,9662,21,,57896,57740,57705,70,35,
2021-01-06,12793,12328,450,,70689,70065,69583,964,482,
2021-01-07,16219,15508,697,,86908,85572,84393,2358,1179,
2021-01-08,18038,17023,1002,,104946,102595,100414,4362,2181,
2021-01-09,19500,18423,1064,,124446,121017,117772,6490,3245,
2021-01-10,11372,11332,38,,135818,132341,129058,6566,3283,
2021-01-11,11710,11660,48,,147528,144001,140670,6662,3331,
2021-01-12,14467,14160,298,,161995,158153,154524,7258,3629,
2021-01-13,15437,13813,1594,,177432,171952,166731,10442,5221,
2021-01-14,19191,16739,2436,,196623,188685,181029,15312,7656,
2021-01-15,20070,18012,2038,,216693,206686,196992,19388,9694,
2021-01-16,17119,15935,1171,,233812,222605,211740,21730,10865,
2021-01-17,11259,10015,1237,,245071,232605,220505,24200,12100,
2021-01-18,6794,6712,72,,251865,239294,227125,24338,12169,
2021-01-19,11829,9721,2094,,263694,248994,234731,28526,14263,
2021-01-20,10804,7215,3572,,274498,256186,238352,35668,17834,
2021-01-21,10975,6855,4092,,285473,263025,241099,43852,21926,
2021-01-22,9037,4320,4697,,294510,267308,240687,53242,26621,
2021-01-23,7458,3042,4388,,301968,270320,239312,62016,31008,
2021-01-24,4385,1828,2536,,306353,272130,238586,67088,33544,
2021-01-25,5322,1049,4264,,311675,273147,235340,75614,37807,
2021-01-26,9394,2867,6499,,321069,275982,231677,88610,44305,
2021-01-27,9898,2866,7004,,330967,278819,227511,102616,51308,
2021-01-28,13119,5742,7335,,344086,284528,225885,117286,58643,
2021-01-29,10696,3283,7379,,354782,287780,221759,132042,66021,
2021-01-30,9191,2730,6424,,363973,290468,218026,144884,72442,
2021-01-31,3383,1570,1768,,367356,292004,217795,148418,74209,
2021-02-01,2124,487,1609,,369480,292457,216643,151628,75814,
2021-02-02,4415,1362,2995,,373895,293781,214976,157610,78805,
2021-02-03,6236,1716,4458,,380131,295456,212200,166512,83256,
2021-02-04,9083,1712,7292,,389214,297125,206583,181084,90542,
2021-02-05,8446,1468,6904,,397660,298553,201113,194880,97440,
2021-02-06,10665,1869,8736,,408325,300367,194200,212334,106167,
2021-02-07,7576,1729,5796,,415901,302056,190105,223902,111951,
2021-02-08,8220,3096,5081,,424121,305104,188085,234038,117019,
2021-02-09,15010,3860,11082,,439131,308922,180837,256170,128085,
2021-02-10,15511,4932,10518,,454642,313802,175224,277156,138578,
2021-02-11,16366,3899,12409,,471008,317649,166693,301912,150956,
2021-02-12,17671,2098,15523,,488679,319708,153249,332918,166459,
2021-02-13,16212,2446,13751,,504891,322109,141918,360382,180191,
2021-02-14,12880,923,11925,,517771,322984,130898,384172,192086,
2021-02-15,7862,486,7328,,525633,323422,124034,398776,199388,
2021-02-16,5995,1042,4903,,531628,324421,120153,408536,204268,
2021-02-17,10168,1609,8525,,541796,325986,113221,425530,212765,
2021-02-18,13870,2955,10871,,555666,328893,105287,447212,223606,
2021-02-19,18490,6213,12210,,574156,335054,99269,471570,235785,
2021-02-20,22629,11132,11444,,596785,346123,98932,494382,247191,
2021-02-21,17241,10385,6822,,614026,356448,102477,507942,253971,
2021-02-22,13586,8759,4775,,627612,365138,106441,517394,258697,
2021-02-23,17866,11126,6669,,645478,376208,110878,530660,265330,
2021-02-24,18576,13611,4884,,664054,389763,119591,540344,270172,
2021-02-25,20810,16489,4264,,684864,406186,131798,548776,274388,
2021-02-26,24900,21836,3003,,709764,427962,150608,554708,277354,
2021-02-27,27464,23582,3840,,737228,451480,170334,562292,281146,
2021-02-28,20584,19143,1406,,757812,470569,188059,565020,282510,
2021-03-01,18225,17028,1148,,776037,487535,203924,567222,283611,
2021-03-02,24688,22278,2325,,800725,509752,223862,571780,285890,
2021-03-03,30597,27965,2578,,831322,537666,249231,576870,288435,
2021-03-04,34692,32462,2144,,866014,570062,279533,581058,290529,
2021-03-05,40000,38166,1785,,906014,608180,315900,584560,292280,
2021-03-06,44155,41947,2170,,950169,650072,355663,588818,294409,
2021-03-07,32734,31555,1175,,982903,681553,386027,591052,295526,
2021-03-08,24038,22162,1861,,1006941,703647,406314,594666,297333,
2021-03-09,33295,29844,3423,,1040236,733425,432715,601420,300710,
2021-03-10,38344,34081,4218,,1078580,767432,462552,609760,304880,
2021-03-11,43980,40707,3234,,1122560,808073,500011,616124,308062,
2021-03-12,47713,46001,1689,,1170273,854010,544309,619402,309701,
2021-03-13,57929,55053,2849,,1228202,908992,596496,624992,312496,
2021-03-14,43419,42179,1222,,1271621,951088,637438,627300,313650,
2021-03-15,32813,31115,1682,,1304434,982144,666855,630578,315289,
2021-03-16,53958,51659,2282,,1358392,1033738,716210,635056,317528,
2021-03-17,61065,58524,2497,,1419457,1092196,772221,639950,319975,
2021-03-18,61552,59094,2430,,1481009,1151218,828866,644704,322352,
2021-03-19,64474,61142,3274,,1545483,1212282,886709,651146,325573,
2021-03-20,62567,59977,2559,,1608050,1272203,944119,656168,328084,
2021-03-21,44000,42475,1538,,1652050,1314613,985028,659170,329585,
2021-03-22,31002,30035,978,,1683052,1344560,1014053,661014,330507,
2021-03-23,54622,51849,2722,,1737674,1396314,1063148,666332,333166,
2021-03-24,76432,73251,3133,,1814106,1469475,1133233,672484,336242,
2021-03-25,82915,80335,2533,,1897021,1549731,1211013,677436,338718,
2021-03-26,87014,83484,3490,,1984035,1633134,1290978,684312,342156,
2021-03-27,80862,77908,2868,,2064897,1710939,1365980,689918,344959,
2021-03-28,66995,65405,1555,,2131892,1776254,1429797,692914,346457,
2021-03-29,51737,49049,2651,,2183629,1825223,1476161,698124,349062,
2021-03-30,73583,70171,3350,,2257212,1895317,1542946,704742,352371,
2021-03-31,93154,89502,3586,,2350366,1984721,1628817,711808,355904,
2021-04-01,89317,85439,3840,,2439683,2070062,1710371,719382,359691,
2021-04-02,93085,88860,4209,,2532768,2158836,1794988,727696,363848,
2021-04-03,61008,59329,1736,,2593776,2218074,1852541,731066,365533,
2021-04-04,72330,70677,1650,,2666106,2288640,1921515,734250,367125,
2021-04-05,53731,53260,470,,2719837,2341816,1974269,735094,367547,
2021-04-06,79581,77713,1887,,2799418,2419427,2050047,738760,369380,
2021-04-07,108009,104943,3055,,2907427,2524245,2151868,744754,372377,
2021-04-08,114078,110105,4027,,3021505,2634239,2257891,752696,376348,
2021-04-09,109849,105622,4298,,3131354,2739743,2359162,761162,380581,
2021-04-10,109241,105479,3852,,3240595,2845094,2460727,768734,384367,
2021-04-11,98628,95511,3259,,3339223,2940480,2552913,775134,387567,
2021-04-12,76068,75004,1157,,3415291,3015336,2626680,777312,388656,
2021-04-13,99471,96089,3399,,3514762,3111316,2719309,784014,392007,
2021-04-14,117050,113285,3650,,3631812,3224483,2828866,791234,395617,
2021-04-15,113559,109503,3898,,3745371,3333860,2934402,798916,399458,
2021-04-16,118088,113714,4194,,3863459,3447464,3043856,807216,403608,
2021-04-17,112419,107828,4451,,3975878,3555158,3147158,816000,408000,
2021-04-18,88746,86508,2103,,4064624,3641543,3231494,820098,410049,
2021-04-19,68973,67441,1452,,4133597,3708854,3297404,822900,411450,
2021-04-20,102096,98773,3118,,4235693,3807465,3392962,829006,414503,
2021-04-21,142042,137764,4042,,4377735,3945055,3526578,836954,418477,
2021-04-22,139499,135348,3910,,4517234,4080274,3657943,844662,422331,
2021-04-23,138218,131797,6174,,4655452,4211917,3783470,856894,428447,
2021-04-24,130292,126230,3887,,4785744,4337999,3905721,864556,432278,
2021-04-25,102018,98608,3179,,4887762,4436459,4001069,870780,435390,
2021-04-26,71006,69300,1558,,4958768,4505628,4068740,873776,436888,
2021-04-27,98510,95421,2897,,5057278,4600888,4161166,879444,439722,
2021-04-28,120578,115953,4433,,5177856,4716673,4272590,888166,444083,
2021-04-29,124486,119291,5046,,5302342,4835797,4386737,898120,449060,
2021-04-30,115824,110568,5014,,5418166,4946192,4492195,907994,453997,
2021-05-01,111302,107432,3649,,5529468,5053443,4595874,915138,457569,
2021-05-02,79142,76166,2863,,5608610,5129452,4669086,920732,460366,
2021-05-03,56793,55123,1597,,5665403,5184420,4722517,923806,461903,
2021-05-04,91929,88560,3281,,5757332,5272802,4807695,930214,465107,
2021-05-05,138000,133293,4620,,5895332,5405926,4936262,939328,469664,
2021-05-06,141835,136880,4816,,6037167,5542622,5068204,948836,474418,
2021-05-07,150289,145247,4837,,6187456,5687709,5208513,958392,479196,
2021-05-08,142465,137776,4438,,6329921,5825290,5341735,967110,483555,
2021-05-09,124809,121159,3480,,6454730,5946285,5459314,973942,486971,
2021-05-10,97807,95822,1881,,6552537,6041918,5553133,977570,488785,
2021-05-11,113537,108856,4493,,6666074,6150572,5657365,986414,493207,
2021-05-12,145047,138019,6881,,6811121,6288412,5788390,1000044,500022,
2021-05-13,142710,135320,7236,,6953831,6423557,5916373,1014368,507184,
2021-05-14,148868,138777,9920,,7102699,6562146,6045107,1034078,517039,
2021-05-15,159739,149692,9866,,7262438,6711651,6184821,1053660,526830,
2021-05-16,144359,136092,8060,,7406797,6847575,6312765,1069620,534810,
2021-05-17,114979,110883,3943,,7521776,6958269,6419592,1077354,538677,
2021-05-18,111332,100466,10664,,7633108,7058539,6509260,1098558,549279,
2021-05-19,149882,133470,16235,,7782990,7191857,6626417,1130880,565440,
2021-05-20,151573,131580,19777,,7934563,7323248,6738100,1170296,585148,
2021-05-21,165395,140888,24248,,8099958,7463955,6854636,1218638,609319,
2021-05-22,199445,172247,26970,,8299403,7636004,6999796,1272416,636208,
2021-05-23,139832,127463,12224,,8439235,7763289,7114919,1296740,648370,
2021-05-24,100298,93325,6828,,8539533,7856441,7201313,1310256,655128,
2021-05-25,90470,82985,7276,,8630003,7939263,7276926,1324674,662337,
2021-05-26,139784,113015,26505,,8769787,8052091,7363319,1377544,688772,
2021-05-27,152067,123047,28767,,8921854,8174981,7457511,1434940,717470,
2021-05-28,163870,132315,31248,,9085724,8307123,7558464,1497318,748659,
2021-05-29,153391,117129,36029,,9239115,8424102,7639470,1569264,784632,
2021-05-30,149724,119018,30479,,9388839,8542950,7727901,1630098,815049,
2021-05-31,99216,79822,19201,,9488055,8622602,7788416,1668372,834186,
2021-06-01,124203,90614,33250,,9612258,8713021,7845660,1734722,867361,
2021-06-02,145324,102157,42916,,9757582,8814997,7904789,1820416,910208,
2021-06-03,155373,99917,55175,,9912955,8914729,7949417,1930624,965312,
2021-06-04,181722,115538,65912,,10094677,9030068,7998932,2062272,1031136,
2021-06-05,172032,103438,68311,,10266709,9133308,8033946,2198724,1099362,
2021-06-06,163395,91870,71245,,10430104,9225000,8054463,2341074,1170537,
2021-06-07,119560,63054,56288,,10549664,9287857,8061107,2453500,1226750,
2021-06-08,161893,72451,89003,,10711557,9360119,8044446,2631346,1315673,
2021-06-09,181469,70810,110189,,10893026,9430752,8004971,2851562,1425781,
2021-06-10,185583,66426,118666,,11078609,9496975,7952619,3088712,1544356,
2021-06-11,204793,67518,136514,,11283402,9564307,7883519,3361576,1680788,
2021-06-12,199738,62680,136457,,11483140,9626805,7809652,3634306,1817153,
2021-06-13,190345,58893,130921,,11673485,9685523,7737529,3895988,1947994,
2021-06-14,137691,38698,98594,,11811176,9724025,7677542,4092966,2046483,
2021-06-15,189546,42621,146568,,12000722,9766427,7573473,4385908,2192954,
2021-06-16,206252,42435,163175,,12206974,9808666,7452640,4712052,2356026,
2021-06-17,210473,37945,171942,,12417447,9846396,7318520,5055752,2527876,
2021-06-18,217195,35362,181229,,12634642,9881568,7172555,5418026,2709013,
2021-06-19,215898,35500,179722,,12850540,9916862,7028239,5777246,2888623,
2021-06-20,186276,35570,150127,,13036816,9952234,6913592,6077284,3038642,
2021-06-21,120435,20830,99103,,13157251,9972869,6835216,6275306,3137653,
2021-06-22,204950,27525,176668,,13362201,10000200,6685988,6628424,3314212,
2021-06-23,230545,28635,201163,,13592746,10028635,6513368,7030534,3515267,
2021-06-24,227702,26677,200268,,13820448,10055116,6339691,7430850,3715425,
2021-06-25,251126,27994,222381,,14071574,10082909,6145221,7875376,3937688,
2021-06-26,261310,30012,230590,,14332884,10112695,5944558,8336274,4168137,
2021-06-27,205005,27788,176609,,14537889,10140301,5795665,8689272,4344636,
2021-06-28,199254,20956,177729,,14737143,10161059,5638819,9044480,4522240,
2021-06-29,250117,24494,224888,,14987260,10185312,5438338,9493948,4746974,
2021-06-30,275545,24178,250799,,15262805,10209287,5211643,9995288,4997644,
2021-07-01,271977,25312,246110,,15534782,10234381,4990766,10487230,5243615,
2021-07-02,144737,11594,132913,,15679519,10245801,4869375,10752852,5376426,
2021-07-03,216901,19934,196736,,15896420,10265513,4692500,11146026,5573013,
2021-07-04,196212,19450,176538,,16092632,10284777,4535345,11498864,5749432,
2021-07-05,148721,12444,136134,,16241353,10297031,4411593,11770876,5885438,
2021-07-06,220042,20000,199826,,16461395,10316815,4231697,12170236,6085118,
2021-07-07,246616,22967,223407,,16708011,10339556,4031179,12616754,6308377,
2021-07-08,231218,21362,209642,,16939229,10360712,3842828,13035768,6517884,
2021-07-09,227004,21513,205322,,17166233,10382023,3658949,13446148,6723074,
2021-07-10,209067,20540,188369,,17375300,10402359,3491053,13822612,6911306,
2021-07-11,171683,17586,153969,,17546983,10419744,3354616,14130256,7065128,
2021-07-12,123138,11446,111593,,17670121,10431001,3254417,14353168,7176584,
2021-07-13,178514,19030,159340,,17848635,10449809,3114040,14671538,7335769,
2021-07-14,180045,19306,160582,,18028680,10468900,2972712,14992376,7496188,
2021-07-15,167210,19586,147449,,18195890,10488275,2844802,15286946,7643473,
2021-07-16,169359,19909,149299,,18365249,10507982,2715363,15585238,7792619,
2021-07-17,173015,20269,152617,,18538264,10528002,2582958,15890088,7945044,
2021-07-18,133637,15938,117561,,18671901,10543756,2481299,16124914,8062457,
2021-07-19,91987,10421,81458,,18763888,10553964,2410224,16287480,8143740,
2021-07-20,133546,16955,116535,,18897434,10570679,2310580,16520198,8260099,
2021-07-21,140089,16987,123032,,19037523,10587451,2204482,16765938,8382969,
2021-07-22,125624,17649,107837,,19163147,10604876,2114247,16981258,8490629,
2021-07-23,120278,16994,103077,,19283425,10621629,2028122,17187014,8593507,
2021-07-24,126701,18334,108129,,19410126,10639760,1938287,17402946,8701473,
2021-07-25,103646,14867,88648,,19513772,10654403,1864463,17579880,8789940,
2021-07-26,66693,9889,56709,,19580465,10664074,1817606,17692936,8846468,
2021-07-27,92388,15319,76907,,19672853,10679132,1755974,17846316,8923158,
2021-07-28,93949,16469,77409,,19766802,10695366,1694990,18000752,9000376,
2021-07-29,89402,16704,72535,,19856204,10711838,1639115,18145446,9072723,
2021-07-30,84069,16105,67848,,19940273,10727715,1587332,18280766,9140383,
2021-07-31,83858,15725,67985,,20024131,10743222,1535044,18416356,9208178,
2021-08-01,61875,11322,50369,,20086006,10754318,1495962,18516712,9258356,
2021-08-02,42496,7420,34956,,20128502,10761540,1468394,18586292,9293146,
2021-08-03,33298,5957,27168,,20161800,10767264,1447160,18640208,9320104,
2021-08-04,61323,12374,48759,,20223123,10779403,1410738,18737330,9368665,
2021-08-05,59459,12549,46758,,20282582,10791744,1376485,18830518,9415259,
2021-08-06,56024,11858,43950,,20338606,10803342,1344362,18917960,9458980,
2021-08-07,62380,12137,50048,,20400986,10815218,1306408,19017620,9508810,
2021-08-08,48694,9275,39227,,20449680,10824265,1276433,19095664,9547832,
2021-08-09,30857,5937,24742,,20480537,10829988,1257601,19144774,9572387,
2021-08-10,49260,10512,38446,,20529797,10840220,1229633,19221174,9610587,
2021-08-11,48728,10767,37710,,20578525,10850740,1202659,19296162,9648081,
2021-08-12,49253,11199,37824,,20627778,10861688,1175992,19371392,9685696,
2021-08-13,49633,11732,37625,,20677411,10873179,1150069,19446220,9723110,
2021-08-14,51225,12135,38880,,20728636,10885064,1123298,19523532,9761766,
2021-08-15,41773,9854,31694,,20770409,10894716,1101428,19586576,9793288,
2021-08-16,26740,6186,20404,,20797149,10900679,1087184,19626990,9813495,
2021-08-17,40504,11059,29179,,20837653,10911488,1069040,19684896,9842448,
2021-08-18,41899,11972,29683,,20879552,10923218,1051297,19743842,9871921,
2021-08-19,45898,16536,29099,,20925450,10939503,1038706,19801594,9900797,
2021-08-20,46453,16295,29744,,20971903,10955542,1025230,19860624,9930312,
2021-08-21,47956,15149,32439,,21019859,10970431,1007907,19925048,9962524,
2021-08-22,34396,10806,23319,,21054255,10980991,995370,19971242,9985621,
2021-08-23,23222,7005,16000,,21077477,10987761,986354,20002814,10001407,
2021-08-24,37650,13374,23820,,21115127,11000881,975885,20049992,10024996,
2021-08-25,41352,14423,26319,,21156479,11015048,963970,20102156,10051078,
2021-08-26,39271,13555,24975,,21195750,11028327,952515,20151624,10075812,
2021-08-27,37673,12940,23687,,21233423,11041026,941741,20198570,10099285,
2021-08-28,40124,13424,25521,,21273547,11054171,929620,20249102,10124551,
2021-08-29,30560,10255,19944,,21304107,11064194,919912,20288564,10144282,
2021-08-30,18236,6139,11846,,21322343,11070085,914176,20311818,10155909,
2021-08-31,32716,11939,19623,,21355059,11081756,906464,20350584,10175292,
2021-09-01,36250,12948,21958,,21391309,11094471,897438,20394066,10197033,
2021-09-02,37778,15645,19667,,21429087,11109864,893391,20432946,10216473,
2021-09-03,46889,21096,22442,,21475976,11130711,892026,20477370,10238685,
2021-09-04,46879,20588,24775,,21522855,11151053,887816,20526474,10263237,
2021-09-05,33076,14205,18577,,21555931,11165014,883424,20563180,10281590,
2021-09-06,21717,9490,12035,,21577648,11174255,880862,20586786,10293393,
2021-09-07,15010,6728,8097,,21592658,11180726,879476,20602500,10301250,
2021-09-08,41149,17115,20936,,21633807,11197577,875637,20643880,10321940,
2021-09-09,41450,16976,19678,,21675257,11214276,872910,20682732,10341366,
2021-09-10,39653,15509,19011,,21714910,11229522,869390,20720264,10360132,
2021-09-11,42382,15934,23339,,21757292,11245177,861964,20766426,10383213,
2021-09-12,29967,11532,17868,,21787259,11256415,855598,20801634,10400817,
2021-09-13,16090,6406,9187,,21803349,11262587,852802,20819570,10409785,
2021-09-14,29905,11559,15289,,21833254,11273844,849045,20849598,10424799,
2021-09-15,39283,14024,19424,,21872537,11287608,843629,20887958,10443979,
2021-09-16,39350,13987,19248,,21911887,11301360,838345,20926030,10463015,
2021-09-17,38932,13611,19340,,21950819,11314728,832604,20964248,10482124,
2021-09-18,41252,14086,23542,,21992071,11328541,823127,21010828,10505414,
2021-09-19,30663,10829,18984,,22022734,11339111,814959,21048304,10524152,
2021-09-20,16731,6098,10177,,22039465,11344955,810857,21068196,10534098,
2021-09-21,31364,11215,16994,,22070829,11355905,805062,21101686,10550843,
2021-09-22,41813,14814,22928,,22112642,11370423,796927,21146992,10573496,
2021-09-23,47232,16138,26032,,22159874,11386298,787014,21198568,10599284,
2021-09-24,46315,15636,26655,,22206189,11401674,775976,21251396,10625698,
2021-09-25,48199,15257,29947,,22254388,11416678,761267,21310822,10655411,
2021-09-26,37511,12421,24495,,22291899,11428824,749172,21359304,10679652,
2021-09-27,19159,6530,12322,,22311058,11435100,743364,21383472,10691736,
2021-09-28,30959,11294,17882,,22342017,11446135,736764,21418742,10709371,
2021-09-29,37890,12476,21729,,22379907,11458340,727491,21461698,10730849,
2021-09-30,37345,11654,21374,,22417252,11469735,717752,21503966,10751983,
2021-10-01,30881,9810,18414,,22448133,11479319,709135,21540368,10770184,
2021-10-02,37141,11159,23588,,22485274,11490208,696688,21587040,10793520,
2021-10-03,27206,8164,18324,,22512480,11498131,686515,21623232,10811616,
2021-10-04,14867,4746,9802,,22527347,11502630,681441,21642378,10821189,
2021-10-05,26832,8597,15875,,22554179,11510966,674148,21673636,10836818,
2021-10-06,31665,9638,18511,,22585844,11520345,665267,21710156,10855078,
2021-10-07,30350,9397,17120,,22616194,11529491,657531,21743920,10871960,
2021-10-08,32843,10743,18854,,22649037,11539963,649406,21781114,10890557,
2021-10-09,34143,10665,21016,,22683180,11550365,639041,21822648,10911324,
2021-10-10,23414,7661,15086,,22706594,11557775,631604,21852342,10926171,
2021-10-11,12004,3839,7866,,22718598,11561364,627561,21867606,10933803,
2021-10-12,5111,1626,3268,,22723709,11562712,625904,21873616,10936808,
2021-10-13,29114,9192,18090,,22752823,11571614,616990,21909248,10954624,
2021-10-14,29017,8905,17750,,22781840,11580243,608135,21944216,10972108,
2021-10-15,29101,8832,18169,,22810941,11588812,598785,21980054,10990027,
2021-10-16,31139,8985,19871,,22842080,11597506,587887,22019238,11009619,
2021-10-17,23714,7263,15379,,22865794,11604515,579758,22049514,11024757,
2021-10-18,12307,3747,8147,,22878101,11607981,575346,22065270,11032635,
2021-10-19,21274,6627,12634,,22899375,11614326,569326,22090000,11045000,
2021-10-20,25671,7540,14924,,22925046,11621619,561929,22119380,11059690,
2021-10-21,23181,6683,13032,,22948227,11628033,555569,22144928,11072464,
2021-10-22,26124,7312,15117,,22974351,11635022,547748,22174548,11087274,
2021-10-23,28184,7605,17161,,23002535,11642365,538185,22208360,11104180,
2021-10-24,19350,5728,12600,,23021885,11647837,531301,22233072,11116536,
2021-10-25,9931,2710,6476,,23031816,11650278,527527,22245502,11122751,
2021-10-26,18917,5391,11102,,23050733,11655391,521807,22267168,11133584,
2021-10-27,22857,6080,13214,,23073590,11661216,514659,22293114,11146557,
2021-10-28,22305,5791,12645,,23095895,11666719,507794,22317850,11158925,
2021-10-29,22814,5731,13050,,23118709,11672148,500460,22343376,11171688,
2021-10-30,24116,6047,14615,,23142825,11677923,491880,22372086,11186043,
2021-10-31,16483,4595,10601,,23159308,11682224,485869,22392710,11196355,
2021-11-01,7871,2081,5055,,23167179,11684025,482882,22402286,11201143,
2021-11-02,15627,4364,7747,,23182806,11688100,479488,22417224,11208612,
2021-11-03,18626,5068,9603,,23201432,11692865,474943,22435844,11217922,
2021-11-04,19510,4875,10034,,23220942,11697464,469769,22455390,11227695,
2021-11-05,21469,4405,9522,,23242411,11701580,464638,22473884,11236942,
2021-11-06,25334,5206,12156,,23267745,11706517,457671,22497692,11248846,
2021-11-07,21451,4024,8923,,23289196,11710260,452760,22515000,11257500,
2021-11-08,11991,2110,4732,,23301187,11712075,450122,22523906,11261953,
2021-11-09,24128,3851,7651,,23325315,11715605,446312,22538586,11269293,
2021-11-10,28475,4508,8994,,23353790,11719836,441812,22556048,11278024,
2021-11-11,28763,4308,9098,,23382553,11723848,437013,22573670,11286835,
2021-11-12,26749,4166,8243,,23409302,11727723,432922,22589602,11294801,
2021-11-13,34316,5080,11414,,23443618,11732497,426579,22611836,11305918,
2021-11-14,23223,3899,8608,,23466841,11736133,421863,22628540,11314270,
2021-11-15,12701,2184,4495,,23479542,11738057,419544,22637026,11318513,
2021-11-16,26178,3931,7483,,23505720,11741732,415988,22651488,11325744,
2021-11-17,31174,4047,7824,,23536894,11745497,412201,22666592,11333296,
2021-11-18,32506,3866,7528,,23569400,11749057,408525,22681064,11340532,
2021-11-19,35474,3863,7754,,23604874,11752619,404622,22695994,11347997,
2021-11-20,40113,4381,8817,,23644987,11756720,400177,22713086,11356543,
2021-11-21,28118,3436,6946,,23673105,11759894,396653,22726482,11363241,
2021-11-22,14898,1950,3894,,23688003,11761567,394703,22733728,11366864,
2021-11-23,33053,3276,6009,,23721056,11764563,391962,22745202,11372601,
2021-11-24,42661,3759,6807,,23763717,11768018,388903,22758230,11379115,
2021-11-25,46045,3932,6576,,23809762,11771675,386256,22770838,11385419,
2021-11-26,52867,11348,6615,,23862629,11782753,390982,22783542,11391771,
2021-11-27,63521,22355,7038,,23926150,11804827,406289,22797076,11398538,
2021-11-28,51456,27740,5314,,23977606,11832275,428703,22807144,11403572,
2021-11-29,33527,18933,2882,,24011133,11850947,444743,22812408,11406204,
2021-11-30,56039,20685,5135,,24067172,11871351,460283,22822136,11411068,
2021-12-01,69541,26243,5637,,24136713,11897288,480875,22832826,11416413,
2021-12-02,71634,26488,5037,,24208347,11923478,502313,22842330,11421165,
2021-12-03,73422,25096,5171,,24281769,11948278,522232,22852092,11426046,
2021-12-04,81157,27784,6072,47281,24362926,11975769,543935,,11431834,807705
2021-12-05,62632,31929,4413,26268,24425558,12007403,571443,,11435960,833869
2021-12-06,38627,19143,2713,16756,24464185,12026257,587866,,11438391,850547
2021-12-07,60294,14852,4480,40948,24524479,12040837,598228,,11442609,891421
2021-12-08,73452,19055,4681,49713,24597931,12059615,612592,,11447023,941056
2021-12-09,74503,18274,4347,51862,24672434,12077580,626511,,11451069,992833
2021-12-10,77503,17590,4657,55245,24749937,12094889,639439,,11455450,1047997
2021-12-11,83188,20405,5832,56939,24833125,12115005,653998,,11461007,1104850
2021-12-12,60755,22697,4157,33858,24893880,12137422,672532,,11464890,1138619
2021-12-13,34937,11603,2411,20900,24928817,12148728,681714,,11467014,1159424
2021-12-14,101986,9002,3872,89068,25030803,12157419,686829,,11470590,1248372
2021-12-15,127700,12428,4513,110720,25158503,12169543,694734,,11474809,1358992
2021-12-16,139363,12465,4252,122630,25297866,12181722,702937,,11478785,1481523
2021-12-17,159177,12403,4522,142230,25457043,12193850,710809,,11483041,1623656
2021-12-18,175588,13523,4923,157096,25632631,12207079,719397,,11487682,1780657
2021-12-19,140439,18159,3930,118313,25773070,12224937,733618,,11491319,1898859
2021-12-20,106822,10305,2745,93725,25879892,12234974,741168,,11493806,1992486
2021-12-21,215392,12964,4315,198091,26095284,12247622,749810,,11497812,2190456
2021-12-22,237262,14426,5203,217749,26332546,12261748,759019,,11502729,2408087
2021-12-23,257779,11726,5089,240866,26590325,12273169,765650,,11507519,2648847
2021-12-24,223619,9462,4572,209517,26813944,12282334,770536,,11511798,2858248
2021-12-25,89730,3889,2510,83343,26903674,12285948,771910,,11514038,2941484
2021-12-26,11900,388,360,11142,26915574,12286044,771930,,11514114,2952496
2021-12-27,46945,1491,1116,44307,26962519,12287290,772298,,11514992,2996683
2021-12-28,144786,6100,4012,134611,27107305,12293096,774375,,11518721,3131163
2021-12-29,175470,9378,4581,161441,27282775,12302178,779168,,11523010,3292476
2021-12-30,200068,10132,5349,184545,27482843,12312007,783936,,11528071,3476887
2021-12-31,195211,10007,5803,179148,27678054,12321725,788131,,11533594,3655909
2022-01-01,96956,5383,3883,87363,27775010,12326799,789623,,11537176,3743123
2022-01-02,19447,942,930,17446,27794457,12327450,789626,,11537824,3760423
2022-01-03,88255,4773,4593,78808,27882712,12331913,789798,,11542115,3839078
2022-01-04,146370,6001,5319,135010,28029082,12337586,790467,,11547119,3973932
2022-01-05,177514,7630,7297,162413,28206596,12344862,790789,,11554073,4136185
2022-01-06,191539,7209,6790,177013,28398135,12351752,791197,,11560555,4313043
2022-01-07,191300,7965,7006,175515,28589435,12359373,792144,,11567229,4488385
2022-01-08,181683,8629,6642,165224,28771118,12367670,794118,,11573552,4653453
2022-01-09,131105,9866,7187,113959,28902223,12377214,796792,,11580422,4767252
2022-01-10,90558,5107,4489,80831,28992781,12381999,797400,,11584599,4847930
2022-01-11,138896,6159,6580,125451,29131677,12387811,796966,,11590845,4973191
2022-01-12,157033,8160,8057,138693,29288710,12395642,797064,,11598578,5111716
2022-01-13,162685,9212,9216,141547,29451395,12404492,797046,,11607446,5253080
2022-01-14,159894,10755,10383,136064,29611289,12414885,797413,,11617472,5388946
2022-01-15,161208,11012,11675,135887,29772497,12425526,796739,,11628787,5524640
2022-01-16,109788,9294,9676,89457,29882285,12434458,796350,,11638108,5613879
2022-01-17,65788,5938,6567,52642,29948073,12440060,795711,,11644349,5666336
2022-01-18,36116,2004,2134,31154,29984189,12441709,795570,,11646139,5697294
2022-01-19,101325,5583,6721,85960,30085514,12446892,794414,,11652478,5783027
2022-01-20,103607,6325,7007,85737,30189121,12452833,793724,,11659109,5868541
2022-01-21,102113,6232,8059,82509,30291234,12458661,791883,,11666778,5950822
2022-01-22,102583,8713,12075,78116,30393817,12466985,788514,,11678471,6028710
2022-01-23,76704,7307,13999,54799,30470521,12473949,781815,,11692134,6083287
2022-01-24,42266,3196,7935,30746,30512787,12476781,777058,,11699723,6113826
2022-01-25,62569,3759,8372,48119,30575356,12480161,772430,,11707731,6161726
2022-01-26,77894,4918,13172,55693,30653250,12484702,764171,,11720531,6217177
2022-01-27,78078,4895,13244,56052,30731328,12489225,755812,,11733413,6272992
2022-01-28,77290,4675,13676,53899,30808618,12493542,746798,,11746744,6326672
2022-01-29,84827,5529,17716,58119,30893445,12498707,734604,,11764103,6384546
2022-01-30,66510,5024,20631,40159,30959955,12503389,718983,,11784406,6424480
2022-01-31,34752,2175,9887,22351,30994707,12505245,711262,,11793983,6446642
2022-02-01,51351,3265,9664,36527,31046058,12508157,704853,,11803304,6482944
2022-02-02,57711,3848,12397,38680,31103769,12511674,696289,,11815385,6521424
2022-02-03,52582,3610,11511,34301,31156351,12514907,688376,,11826531,6555474
2022-02-04,43097,2945,10565,27286,31199448,12517541,680746,,11836795,6582566
2022-02-05,58728,3746,14473,37566,31258176,12520955,670007,,11850948,6619919
2022-02-06,49859,3641,16116,29572,31308035,12524273,657527,,11866746,6649267
2022-02-07,23236,1690,7811,13442,31331271,12525637,651393,,11874244,6662485
2022-02-08,33401,2357,7254,21972,31364672,12527664,646489,,11881175,6684224
2022-02-09,38889,2785,8923,24410,31403561,12530090,640345,,11889745,6708382
2022-02-10,37539,2765,8837,22552,31441100,12532518,634269,,11898249,6730703
2022-02-11,39450,2724,10293,23006,31480550,12534896,626691,,11908205,6753471
2022-02-12,42051,2959,11456,25319,31522601,12537521,618183,,11919338,6778566
2022-02-13,36325,2800,13146,19943,31558926,12540034,607834,,11932200,6798311
2022-02-14,16983,1176,6123,9474,31575909,12540935,602879,,11938056,6807585
2022-02-15,19365,1386,4758,11879,31595274,12541997,599497,,11942500,6819237
2022-02-16,26025,1767,7734,14949,31621299,12543467,593526,,11949941,6833985
2022-02-17,26769,1684,7526,14986,31648068,12544796,587675,,11957121,6848716
2022-02-18,23949,1354,6614,13678,31672017,12545833,582403,,11963430,6862185
2022-02-19,37835,1903,8338,26052,31709852,12547405,575963,,11971442,6887996
2022-02-20,32578,1498,7963,22807,31742430,12548602,569490,,11979112,6910598
2022-02-21,17502,913,3678,12757,31759932,12549219,566716,,11982503,6923143
2022-02-22,9112,430,1555,6957,31769044,12549359,565586,,11983773,6929889
2022-02-23,25339,1326,4796,17298,31794383,12550375,562109,,11988266,6946951
2022-02-24,24576,1401,5233,15485,31818959,12551454,558272,,11993182,6962193
2022-02-25,23110,1396,5137,14509,31842069,12552556,554524,,11998032,6976476
2022-02-26,25235,1386,5910,16558,31867304,12553632,549993,,12003639,6992808
2022-02-27,26960,1371,7371,17704,31894264,12554734,543982,,12010752,7010317
2022-02-28,10130,594,2531,6745,31904394,12555075,542037,,12013038,7016879
2022-03-01,13203,948,3152,8167,31917597,12555718,539823,,12015895,7024829
2022-03-02,15418,1164,3578,9619,31933015,12556621,537402,,12019219,7034271
2022-03-03,14300,1078,3227,8689,31947315,12557387,535245,,12022142,7042729
2022-03-04,14479,993,3445,8318,31961794,12558059,532789,,12025270,7050794
2022-03-05,18534,1278,4998,11183,31980328,12559028,529058,,12029970,7061753
2022-03-06,16518,1088,5525,9607,31996846,12559835,524615,,12035220,7071153
2022-03-07,5950,469,1861,3509,32002796,12560019,523216,,12036803,7074445
2022-03-08,7366,700,1944,4159,32010162,12560441,521965,,12038476,7078405
2022-03-09,11161,908,2739,6406,32021323,12561073,520128,,12040945,7084609
2022-03-10,12769,1046,3258,6842,32034092,12561842,517909,,12043933,7091238
2022-03-11,12893,905,3410,6866,32046985,12562458,515396,,12047062,7097888
2022-03-12,14688,1049,4185,8310,32061673,12563235,512257,,12050978,7105994
2022-03-13,14748,1091,4999,8333,32076421,12564035,508345,,12055690,7114090
2022-03-14,6333,450,2228,3499,32082754,12564214,506564,,12057650,7117375
2022-03-15,10199,793,2625,5973,32092953,12564717,504720,,12059997,7123134
2022-03-16,13064,934,3667,6953,32106017,12565362,501984,,12063378,7129856
2022-03-17,13198,1049,3962,6758,32119215,12566123,499064,,12067059,7136394
2022-03-18,11907,914,3146,6433,32131122,12566734,496822,,12069912,7142603
2022-03-19,14443,1005,4163,7902,32145565,12567459,493662,,12073797,7150286
2022-03-20,11748,991,3958,6372,32157313,12568179,490690,,12077489,7156450
2022-03-21,5058,415,1589,2814,32162371,12568335,489512,,12078823,7159061
2022-03-22,6715,552,1559,3893,32169086,12568599,488499,,12080100,7162738
2022-03-23,9971,785,2300,5195,32179057,12569068,486981,,12082087,7167692
2022-03-24,9297,724,2377,4612,32188354,12569528,485319,,12084209,7172100
2022-03-25,9227,781,2155,4753,32197581,12570046,483937,,12086109,7176641
2022-03-26,10931,937,2837,5506,32208512,12570706,482035,,12088671,7181928
2022-03-27,10226,910,3538,5301,32218738,12571356,479403,,12091953,7187018
2022-03-28,3584,322,1109,1987,32222322,12571437,478613,,12092824,7188810
2022-03-29,5349,499,1214,2692,32227671,12571651,477892,,12093759,7191280
2022-03-30,7855,748,1837,4123,32235526,12572120,476798,,12095322,7195178
2022-03-31,8655,689,1926,4414,32244181,12572520,475555,,12096965,7199370
2022-04-01,9313,801,1916,4889,32253494,12573029,474431,,12098598,7204020
2022-04-02,10446,887,2215,5571,32263940,12573629,473091,,12100538,7209374
2022-04-03,9212,880,2569,5067,32273152,12574252,471396,,12102856,7214239
2022-04-04,4203,388,1006,2406,32277355,12574379,470775,,12103604,7216442
2022-04-05,6082,601,1037,3054,32283437,12574640,470333,,12104307,7219221
2022-04-06,8381,714,1478,4384,32291818,12575063,469564,,12105499,7223378
2022-04-07,10346,733,1688,4837,32302164,12575496,468604,,12106892,7227972
2022-04-08,23995,811,1583,4836,32326159,12576029,467826,,12108203,7232592
2022-04-09,30497,969,1975,5894,32356656,12576700,466811,,12109889,7238263
2022-04-10,24865,976,2391,5333,32381521,12577417,465390,,12112027,7243394
2022-04-11,12573,385,877,2431,32394094,12577552,464894,,12112658,7245623
2022-04-12,28129,693,1020,3537,32422223,12577941,464560,,12113381,7248927
2022-04-13,37784,853,1561,4927,32460007,12578495,463848,,12114647,7253624
2022-04-14,37905,760,1616,4915,32497912,12578942,462989,,12115953,7258286
2022-04-15,43402,1232,2104,6725,32541314,12579876,462113,,12117763,7264774
2022-04-16,8095,357,650,1741,32549409,12579973,461818,,12118155,7266299
2022-04-17,21026,871,1925,4319,32570435,12580560,460757,,12119803,7270395
2022-04-18,5460,306,463,1289,32575895,12580579,460595,,12119984,7271443
2022-04-19,22656,615,773,3103,32598551,12580911,460428,,12120483,7274326
2022-04-20,40341,1063,1400,4620,32638892,12581648,460088,,12121560,7278682
2022-04-21,38757,943,1600,4683,32677649,12582295,459422,,12122873,7283131
2022-04-22,35634,1017,1436,4268,32713283,12583040,458996,,12124044,7287181
2022-04-23,34659,1007,1738,4714,32747942,12583763,458262,,12125501,7291656
2022-04-24,20816,1021,1889,3777,32768758,12584534,457391,,12127143,7295239
2022-04-25,8299,453,691,1707,32777057,12584718,457152,,12127566,7296730
2022-04-26,24624,733,948,3145,32801681,12585159,456931,,12128228,7299638
2022-04-27,33602,955,1369,3938,32835283,12585838,456509,,12129329,7303359
2022-04-28,32838,928,1414,3931,32868121,12586493,456014,,12130479,7307067
2022-04-29,32061,1098,1379,3909,32900182,12587293,455726,,12131567,7310747
2022-04-30,30290,925,1538,4025,32930472,12587921,455106,,12132815,7314537
2022-05-01,16754,769,1579,2970,32947226,12588392,454291,,12134101,7317263
2022-05-02,5936,309,526,1098,32953162,12588405,454070,,12134335,7318134
2022-05-03,20930,588,832,2347,32974092,12588688,453820,,12134868,7320242
2022-05-04,29418,800,1093,3291,33003510,12589178,453522,,12135656,7323284
2022-05-05,29100,872,1165,3125,33032610,12589738,453219,,12136519,7326165
2022-05-06,29099,1147,1285,2987,33061709,12590597,453076,,12137521,7328925
2022-05-07,28493,870,1266,3113,33090202,12591177,452675,,12138502,7331814
2022-05-08,15998,895,1308,2322,33106200,12591815,452260,,12139555,7333935
2022-05-09,5897,293,474,943,33112097,12591842,452073,,12139769,7334668
2022-05-10,21228,696,720,2120,33133325,12592220,452042,,12140178,7336528
2022-05-11,28953,837,1085,2656,33162278,12592725,451790,,12140935,7338913
2022-05-12,28242,799,1086,2513,33190520,12593227,451499,,12141728,7341185
2022-05-13,27595,877,1118,2469,33218115,12593793,451253,,12142540,7343397
2022-05-14,25694,807,1100,2610,33243809,12594285,450953,,12143332,7345753
2022-05-15,14852,751,1276,2058,33258661,12594764,450421,,12144343,7347592
2022-05-16,6384,326,532,1047,33265045,12594852,450211,,12144641,7348452
2022-05-17,19605,590,780,1742,33284650,12595126,450014,,12145112,7349945
2022-05-18,26546,877,1101,2275,33311196,12595738,449785,,12145953,7352004
2022-05-19,24442,683,1155,2164,33335638,12596154,449306,,12146848,7353951
2022-05-20,24271,801,1140,2218,33359909,12596685,448963,,12147722,7355949
2022-05-21,22405,691,1167,2350,33382314,12597066,448478,,12148588,7358056
2022-05-22,10561,549,891,1489,33392875,12597354,448131,,12149223,7359328
2022-05-23,4574,242,465,793,33397449,12597336,447906,,12149430,7359912
2022-05-24,2627,120,181,441,33400076,12597201,447843,,12149358,7360142
2022-05-25,19369,656,949,1954,33419445,12597591,447540,,12150051,7361886
2022-05-26,20647,663,950,1912,33440092,12597980,447247,,12150733,7363575
2022-05-27,21763,818,1061,2078,33461855,12598510,447001,,12151509,7365420
2022-05-28,19413,722,1167,2150,33481268,12598961,446553,,12152408,7367355
2022-05-29,12111,760,1282,1726,33493379,12599486,446024,,12153462,7368889
2022-05-30,4580,311,550,751,33497959,12599551,445782,,12153769,7369442
2022-05-31,13552,573,753,1667,33511511,12599822,445596,,12154226,7370869
2022-06-01,16614,704,972,1879,33528125,12600224,445326,,12154898,7372495
2022-06-02,14609,557,867,1677,33542734,12600469,445009,,12155460,7373931
2022-06-03,16108,699,1097,1815,33558842,12600889,444605,,12156284,7375527
2022-06-04,13323,647,1165,1845,33572165,12601278,444082,,12157196,7377170
2022-06-05,7868,587,1111,1432,33580033,12601616,443554,,12158062,7378410
2022-06-06,3294,206,445,641,33583327,12601573,443312,,12158261,7378849
2022-06-07,11222,475,728,1370,33594549,12601748,443054,,12158694,7379975
2022-06-08,14068,667,1013,1611,33608617,12602155,442703,,12159452,7381367
2022-06-09,13378,663,926,1676,33621995,12602530,442435,,12160095,7382811
2022-06-10,13853,686,1068,1698,33635848,12602930,442045,,12160885,7384279
2022-06-11,12985,616,1031,1846,33648833,12603260,441628,,12161632,7385902
2022-06-12,8098,643,1236,1504,33656931,12603645,441031,,12162614,7387199
2022-06-13,3189,284,422,712,33660120,12603662,440888,,12162774,7387702
2022-06-14,10129,512,666,1264,33670249,12603885,440728,,12163157,7388728
2022-06-15,13510,472,832,1621,33683759,12604061,440366,,12163695,7390111
2022-06-16,12545,495,856,1617,33696304,12604250,440000,,12164250,7391481
2022-06-17,11693,479,818,1653,33707997,12604442,439654,,12164788,7392898
2022-06-18,11452,436,876,1860,33719449,12604607,439211,,12165396,7394534
2022-06-19,7004,483,899,1420,33726453,12604837,438794,,12166043,7395739
2022-06-20,2287,147,301,643,33728740,12604760,438634,,12166126,7396212
2022-06-21,9547,358,616,1386,33738287,12604831,438371,,12166460,7397350
2022-06-22,13613,407,726,1703,33751900,12604966,438045,,12166921,7398828
2022-06-23,13704,401,775,1683,33765604,12605100,437668,,12167432,7400297
2022-06-24,15365,435,811,1675,33780969,12605275,437288,,12167987,7401757
2022-06-25,14471,427,852,1713,33795440,12605441,436852,,12168589,7403261
2022-06-26,8159,432,886,1280,33803599,12605611,436391,,12169220,7404324
2022-06-27,3212,171,365,594,33806811,12605533,436193,,12169340,7404711
2022-06-28,9620,369,558,1226,33816431,12605616,436000,,12169616,7405704
2022-06-29,13318,415,731,1632,33829749,12605741,435682,,12170059,7407096
2022-06-30,12233,482,847,1581,33841982,12605938,435315,,12170623,7408443
2022-07-01,13041,550,972,1950,33855023,12606230,434888,,12171342,7410187
2022-07-02,1616,110,115,365,33856639,12606064,434881,,12171183,7410320
2022-07-03,5162,260,494,961,33861801,12606066,434638,,12171428,7411065
2022-07-04,2757,132,279,614,33864558,12605951,434490,,12171461,7411482
2022-07-05,11145,372,599,1576,33875703,12606025,434255,,12171770,7412810
2022-07-06,15961,549,859,2010,33891664,12606278,433939,,12172339,7414577
2022-07-07,15667,521,832,1927,33907331,12606510,433627,,12172883,7416251
2022-07-08,17887,555,869,2245,33925218,12606760,433312,,12173448,7418247
2022-07-09,14148,451,597,1849,33939366,12606933,433165,,12173768,7419858
2022-07-10,8750,475,755,1505,33948116,12607159,432884,,12174275,7421156
2022-07-11,4094,199,331,871,33952210,12607093,432749,,12174344,7421807
2022-07-12,12111,412,525,1657,33964321,12607206,432631,,12174575,7423210
2022-07-13,16722,564,773,2144,33981043,12607473,432416,,12175057,7425110
2022-07-14,16861,483,675,2024,33997904,12607650,432213,,12175437,7426894
2022-07-15,28899,599,822,2187,34026803,12607949,431989,,12175960,7428840
2022-07-16,30301,586,773,2328,34057104,12608220,431793,,12176427,7430915
2022-07-17,22935,538,636,1893,34080039,12608521,431692,,12176829,7432614
2022-07-18,11398,189,255,857,34091437,12608442,431621,,12176821,7433249
2022-07-19,28960,592,592,2138,34120397,12608759,431618,,12177141,7435155
2022-07-20,37642,839,924,2595,34158039,12609319,431528,,12177791,7437513
2022-07-21,36358,734,812,2809,34194397,12609765,431443,,12178322,7440081
2022-07-22,35805,824,892,2687,34230202,12610300,431368,,12178932,7442530
2022-07-23,35154,821,913,2836,34265356,12610806,431268,,12179538,7445110
2022-07-24,21738,599,804,1778,34287094,12611142,431060,,12180082,7446663
2022-07-25,11938,308,311,1082,34299032,12611165,431052,,12180113,7447514
2022-07-26,26093,619,604,2213,34325125,12611499,431066,,12180433,7449483
2022-07-27,32471,808,847,2650,34357596,12612049,431025,,12181024,7451922
2022-07-28,31542,724,884,2610,34389138,12612476,430861,,12181615,7454281
2022-07-29,29995,1790,875,2646,34419133,12613974,431772,,12182202,7456677
2022-07-30,25836,2525,747,2438,34444969,12616218,433548,,12182670,7458881
2022-07-31,14314,1068,541,1567,34459283,12617017,434071,,12182946,7460220
2022-08-01,5916,337,223,683,34465199,12617094,434183,,12182911,7460680
2022-08-02,4486,306,138,606,34469685,12617130,434347,,12182783,7461064
2022-08-03,22941,2637,738,2239,34492626,12619490,436242,,12183248,7463066
2022-08-04,22237,2482,681,2134,34514863,12621645,438037,,12183608,7464937
2022-08-05,21800,2755,747,2071,34536663,12624118,440037,,12184081,7466779
2022-08-06,19649,2875,657,1998,34556312,12626681,442249,,12184432,7468518
2022-08-07,12707,2236,620,1423,34569019,12628642,443859,,12184783,7469723
2022-08-08,4766,570,188,603,34573785,12628923,444234,,12184689,7470088
2022-08-09,14015,1468,558,1594,34587800,12630103,445138,,12184965,7471440
2022-08-10,19133,2364,718,1994,34606933,12632193,446782,,12185411,7473205
2022-08-11,17079,2041,718,1858,34624012,12633958,448103,,12185855,7474830
2022-08-12,16985,2048,734,1852,34640997,12635717,449416,,12186301,7476453
2022-08-13,15954,2223,765,1808,34656951,12637655,450872,,12186783,7478020
2022-08-14,9531,1621,619,1087,34666482,12638986,451870,,12187116,7478871
2022-08-15,3873,388,271,479,34670355,12639121,451984,,12187137,7479141
2022-08-16,10809,1075,516,1356,34681164,12639895,452541,,12187354,7480245
2022-08-17,16100,1834,739,1782,34697264,12641441,453635,,12187806,7481791
2022-08-18,14933,1642,749,1695,34712197,12642758,454524,,12188234,7483214
2022-08-19,15318,1846,749,1552,34727515,12644326,455617,,12188709,7484532
2022-08-20,14285,1641,740,1546,34741800,12645675,456512,,12189163,7485839
2022-08-21,9906,1533,660,1165,34751706,12646943,457381,,12189562,7486787
2022-08-22,4165,481,271,563,34755871,12647119,457588,,12189531,7487090
2022-08-23,11140,1248,556,1499,34767011,12648059,458276,,12189783,7488336
2022-08-24,14761,1808,871,2187,34781772,12649595,459213,,12190382,7490291
2022-08-25,14028,1716,780,2123,34795800,12651022,460142,,12190880,7492168
2022-08-26,13929,1687,816,2094,34809729,12652412,461006,,12191406,7494012
2022-08-27,12418,1486,876,2001,34822147,12653570,461610,,12191960,7495746
2022-08-28,7926,1259,622,1398,34830073,12654567,462245,,12192322,7496923
2022-08-29,3400,502,286,684,34833473,12654787,462456,,12192331,7497372
2022-08-30,9907,1169,651,1855,34843380,12655598,462968,,12192630,7498924
2022-08-31,13514,1626,946,2315,34856894,12656933,463644,,12193289,7500996
2022-09-01,12906,1720,912,2142,34869800,12658356,464447,,12193909,7502891
2022-09-02,15045,1616,991,4917,34884845,12659697,465064,,12194633,7507582
2022-09-03,14718,1525,923,5515,34899563,12660939,465663,,12195276,7512862
2022-09-04,8667,1009,676,3237,34908230,12661682,465987,,12195695,7515877
2022-09-05,3555,321,229,1386,34911785,12661736,466076,,12195660,7517040
2022-09-06,2469,157,116,1132,34914254,12661638,466114,,12195524,7517963
2022-09-07,10925,1019,587,3491,34925179,12662358,466542,,12195816,7521202
2022-09-08,10871,1022,527,2791,34936050,12663051,467034,,12196017,7523716
2022-09-09,9583,1011,488,2504,34945633,12663773,467552,,12196221,7525983
2022-09-10,10634,1264,552,3166,34956267,12664758,468257,,12196501,7528914
2022-09-11,9410,982,667,3736,34965677,12665490,468566,,12196924,7532440
2022-09-12,3125,294,204,1079,34968802,12665501,468649,,12196852,7533282
2022-09-13,6018,544,283,1132,34974820,12665758,468901,,12196857,7534171
2022-09-14,14483,798,434,1844,34989303,12666237,469261,,12196976,7535749
2022-09-15,15755,780,410,1533,35005058,12666697,469626,,12197071,7537011
2022-09-16,17759,766,447,1693,35022817,12667201,469939,,12197262,7538481
2022-09-17,17618,722,457,1668,35040435,12667618,470200,,12197418,7539894
2022-09-18,11214,773,451,1688,35051649,12668130,470520,,12197610,7541358
2022-09-19,4979,404,288,670,35056628,12668262,470631,,12197631,7541814
2022-09-20,13771,442,332,948,35070399,12668389,470739,,12197650,7542499
2022-09-21,23041,646,410,1499,35093440,12668724,470970,,12197754,7543742
2022-09-22,22917,636,398,1380,35116357,12669052,471202,,12197850,7544860
2022-09-23,22950,726,603,1418,35139307,12669478,471320,,12198158,7546023
2022-09-24,21691,737,689,1499,35160998,12669920,471364,,12198556,7547286
2022-09-25,11319,595,702,1356,35172317,12670233,471251,,12198982,7548405
2022-09-26,4563,192,218,594,35176880,12670135,471219,,12198916,7548756
2022-09-27,37653,497,365,1497,35214533,12670361,471347,,12199014,7550025
2022-09-28,50969,731,670,1901,35265502,12670823,471407,,12199416,7551700
2022-09-29,48007,637,740,1837,35313509,12671139,471296,,12199843,7553260
2022-09-30,47270,677,806,2003,35360779,12671488,471165,,12200323,7554981
2022-10-01,34450,527,633,1547,35395229,12671706,471057,,12200649,7556261
2022-10-02,24245,736,1028,1711,35419474,12672146,470762,,12201384,7557719
2022-10-03,10870,238,230,613,35430344,12672092,470766,,12201326,7558094
2022-10-04,32197,477,459,1169,35462541,12672250,470780,,12201470,7558987
2022-10-05,40439,631,740,1561,35502980,12672563,470664,,12201899,7560286
2022-10-06,38695,610,653,1567,35541675,12672868,470619,,12202249,7561591
2022-10-07,42243,661,852,1742,35583918,12673182,470420,,12202762,7563032
2022-10-08,37397,784,1145,2120,35621315,12673635,470053,,12203582,7564877
2022-10-09,18814,549,727,1556,35640129,12673905,469872,,12204033,7566194
2022-10-10,6865,168,370,565,35646994,12673773,469667,,12204106,7566497
2022-10-11,4994,124,111,318,35651988,12673601,469675,,12203926,7566576
2022-10-12,35117,579,685,1428,35687105,12673847,469567,,12204280,7567715
2022-10-13,36759,643,858,1620,35723864,12674124,469348,,12204776,7569026
2022-10-14,36977,621,753,1541,35760841,12674413,469213,,12205200,7570287
2022-10-15,35453,714,1013,1628,35796294,12674834,468911,,12205923,7571665
2022-10-16,20662,654,1024,1592,35816956,12675218,468535,,12206683,7573027
2022-10-17,7356,206,477,541,35824312,12675140,468262,,12206878,7573328
2022-10-18,36426,457,500,1398,35860738,12675277,468214,,12207063,7574453
2022-10-19,49902,619,730,1982,35910640,12675595,468100,,12207495,7576185
2022-10-20,51291,622,649,2050,35961931,12675903,468070,,12207833,7577970
2022-10-21,52850,696,619,1935,36014781,12676272,468141,,12208131,7579637
2022-10-22,50864,749,904,2311,36065645,12676692,467981,,12208711,7581675
2022-10-23,30640,571,785,2122,36096285,12676946,467760,,12209186,7583532
2022-10-24,14133,232,271,978,36110418,12676874,467716,,12209158,7584251
2022-10-25,41371,473,489,1819,36151789,12676996,467697,,12209299,7585772
2022-10-26,51658,615,660,2124,36203447,12677277,467648,,12209629,7587616
2022-10-27,50114,604,768,2163,36253561,12677556,467476,,12210080,7589509
2022-10-28,49798,590,675,2095,36303359,12677789,467386,,12210403,7591297
2022-10-29,50599,733,779,2221,36353958,12678173,467336,,12210837,7593217
2022-10-30,28402,661,930,2038,36382360,12678551,467063,,12211488,7595012
2022-10-31,12440,200,234,777,36394800,12678473,467026,,12211447,7595555
2022-11-01,33094,338,197,1220,36427894,12678468,467161,,12211307,7596483
2022-11-02,44290,575,625,1903,36472184,12678711,467107,,12211604,7598087
2022-11-03,44191,540,605,1856,36516375,12678923,467038,,12211885,7599659
2022-11-04,44645,647,527,2030,36561020,12679267,467151,,12212116,7601435
2022-11-05,45205,645,754,2368,36606225,12679612,467039,,12212573,7603537
2022-11-06,26019,558,771,2097,36632244,12679832,466823,,12213009,7605340
2022-11-07,10710,242,235,876,36642954,12679790,466827,,12212963,7605980
2022-11-08,33486,486,397,1586,36676440,12679988,466913,,12213075,7607323
2022-11-09,40530,605,571,1964,36716970,12680278,466945,,12213333,7609019
2022-11-10,39178,620,547,1929,36756148,12680576,467012,,12213564,7610671
2022-11-11,43346,635,641,2209,36799494,12680894,467005,,12213889,7612605
2022-11-12,36851,638,592,2185,36836345,12681208,467043,,12214165,7614507
2022-11-13,24269,558,770,2277,36860614,12681475,466825,,12214650,7616535
2022-11-14,10966,232,204,1024,36871580,12681412,466852,,12214560,7617301
2022-11-15,33628,483,380,1693,36905208,12681531,466949,,12214582,7618687
2022-11-16,43541,798,583,2370,36948749,12682031,467158,,12214873,7620807
2022-11-17,38341,674,647,2241,36987090,12682367,467181,,12215186,7622759
2022-11-18,40627,726,531,2329,37027717,12682749,467372,,12215377,7624789
2022-11-19,39659,1005,1031,3061,37067376,12683410,467340,,12216070,7627547
2022-11-20,22422,658,718,2443,37089798,12683789,467276,,12216513,7629761
2022-11-21,8921,197,193,967,37098719,12683722,467275,,12216447,7630521
2022-11-22,26440,481,369,1513,37125159,12683842,467383,,12216459,7631719
2022-11-23,32087,685,669,2069,37157246,12684198,467397,,12216801,7633509
2022-11-24,31912,664,752,2085,37189158,12684549,467307,,12217242,7635332
2022-11-25,30753,763,827,1953,37219911,12685001,467237,,12217764,7637023
2022-11-26,30291,908,1192,2698,37250202,12685570,466944,,12218626,7639432
2022-11-27,18675,608,942,2087,37268877,12685876,466605,,12219271,7641263
2022-11-28,7540,190,282,787,37276417,12685772,466505,,12219267,7641794
2022-11-29,21024,421,454,1292,37297441,12685864,466468,,12219396,7642808
2022-11-30,27892,643,650,1842,37325333,12686191,466459,,12219732,7644375
2022-12-01,24806,593,682,1692,37350139,12686458,466367,,12220091,7645783
2022-12-02,25057,523,630,1775,37375196,12686655,466254,,12220401,7647276
2022-12-03,25558,588,781,1945,37400754,12686924,466051,,12220873,7648961
2022-12-04,15252,494,606,1702,37416006,12687087,465934,,12221153,7650371
2022-12-05,6877,167,157,746,37422883,12686963,465939,,12221024,7650870
2022-12-06,20351,419,352,1379,37443234,12687015,466001,,12221014,7651937
2022-12-07,24781,553,609,1672,37468015,12687251,465938,,12221313,7653337
2022-12-08,23162,563,522,1764,37491177,12687503,465977,,12221526,7654827
2022-12-09,23328,636,575,1632,37514505,12687811,466034,,12221777,7656185
2022-12-10,22575,508,602,1631,37537080,12688002,465937,,12222065,7657539
2022-12-11,14204,548,786,1566,37551284,12688286,465696,,12222590,7658879
2022-12-12,5507,149,156,595,37556791,12688145,465684,,12222461,7659235
2022-12-13,17797,374,370,1125,37574588,12688199,465686,,12222513,7660088
2022-12-14,21322,511,547,1453,37595910,12688420,465644,,12222776,7661301
2022-12-15,21970,530,603,1579,37617880,12688608,465569,,12223039,7662585
2022-12-16,16288,378,451,1031,37634168,12688663,465493,,12223170,7663344
2022-12-17,18699,556,508,1276,37652867,12688896,465539,,12223357,7664335
2022-12-18,12642,530,794,1306,37665509,12689145,465274,,12223871,7665389
2022-12-19,4585,131,116,449,37670094,12688945,465285,,12223660,7665553
2022-12-20,16214,498,449,1110,37686308,12689127,465327,,12223800,7666397
2022-12-21,18474,541,552,1303,37704782,12689368,465312,,12224056,7667437
2022-12-22,18602,574,591,1747,37723384,12689645,465295,,12224350,7668924
2022-12-23,15650,576,601,1716,37739034,12689866,465265,,12224601,7670345
2022-12-24,5339,224,172,674,37744373,12689782,465316,,12224466,7670742
2022-12-25,2444,153,153,480,37746817,12689630,465307,,12224323,7670958
2022-12-26,262,12,7,48,37747079,12689347,465307,,12224040,7670755
2022-12-27,2098,98,36,307,37749177,12689160,465365,,12223795,7670825
2022-12-28,8320,337,168,975,37757497,12689188,465529,,12223659,7671531
2022-12-29,13165,582,529,1601,37770662,12689445,465578,,12223867,7672850
2022-12-30,15823,667,658,1881,37786485,12689809,465584,,12224225,7674461
2022-12-31,11235,460,389,1355,37797720,12689916,465651,,12224265,7675512
2023-01-01,3907,201,219,563,37801627,12689811,465632,,12224179,7675808
2023-01-02,652,36,14,97,37802279,12689563,465653,,12223910,7675658
2023-01-03,8196,297,151,902,37810475,12689580,465793,,12223787,7676323
2023-01-04,14723,574,547,1547,37825198,12689869,465814,,12224055,7677621
2023-01-05,16119,643,535,1796,37841317,12690213,465914,,12224299,7679158
2023-01-06,18833,715,612,2046,37860150,12690636,466014,,12224622,7680951
2023-01-07,18524,701,639,2057,37878674,12691054,466071,,12224983,7682762
2023-01-08,11612,580,608,1632,37890286,12691382,466040,,12225342,7684174
2023-01-09,5299,215,196,664,37895585,12691295,466057,,12225238,7684582
2023-01-10,12161,415,317,786,37907746,12691409,466153,,12225256,7685107
2023-01-11,15544,458,370,1095,37923290,12691547,466237,,12225310,7685931
2023-01-12,14067,444,409,973,37937357,12691684,466271,,12225413,7686642
2023-01-13,14174,421,344,1040,37951531,12691851,466345,,12225506,7687459
2023-01-14,13390,473,451,1078,37964921,12692020,466362,,12225658,7688269
2023-01-15,9046,459,508,1055,37973967,12692209,466312,,12225897,7689096
2023-01-16,3746,146,130,479,37977713,12692083,466328,,12225755,7689332
2023-01-17,8851,267,179,653,37986564,12692013,466412,,12225601,7689701
2023-01-18,10266,349,273,761,37996830,12692068,466485,,12225583,7690197
2023-01-19,10593,315,318,761,38007423,12692090,466477,,12225613,7690710
2023-01-20,9837,318,272,717,38017260,12692123,466521,,12225602,7691175
2023-01-21,11307,355,398,904,38028567,12692181,466477,,12225704,7691829
2023-01-22,7569,343,405,818,38036136,12692263,466413,,12225850,7692414
2023-01-23,3380,143,131,288,38039516,12692174,466424,,12225750,7692497
2023-01-24,8291,226,166,553,38047807,12692094,466482,,12225612,7692782
2023-01-25,10306,346,297,663,38058113,12692171,466527,,12225644,7693218
2023-01-26,6722,236,203,469,38064835,12692119,466558,,12225561,7693443
2023-01-27,6912,237,197,498,38071747,12692055,466595,,12225460,7693684
2023-01-28,9350,312,339,695,38081097,12692080,466563,,12225517,7694130
2023-01-29,5968,234,341,692,38087065,12692037,466451,,12225586,7694576
2023-01-30,1900,88,80,215,38088965,12691844,466457,,12225387,7694545
2023-01-31,5883,156,150,414,38094848,12691694,466460,,12225234,7694686
2023-02-01,7302,248,249,493,38102150,12691688,466456,,12225232,7694960
2023-02-02,6484,296,240,503,38108634,12691716,466509,,12225207,7695245
2023-02-03,6551,197,194,463,38115185,12691652,466508,,12225144,7695479
2023-02-04,6731,233,307,544,38121916,12691622,466428,,12225194,7695799
2023-02-05,4177,199,291,484,38126093,12691543,466331,,12225212,7696054
2023-02-06,1834,90,98,212,38127927,12691344,466320,,12225024,7696012
2023-02-07,4965,161,182,385,38132892,12691206,466297,,12224909,7696148
2023-02-08,5770,212,206,430,38138662,12691144,466301,,12224843,7696338
2023-02-09,6124,211,244,439,38144786,12691091,466267,,12224824,7696555
2023-02-10,5090,159,208,372,38149876,12691026,466216,,12224810,7696729
2023-02-11,6053,186,260,458,38155929,12690928,466138,,12224790,7696931
2023-02-12,4082,219,342,409,38160011,12690903,466012,,12224891,7697122
2023-02-13,1483,57,87,146,38161494,12690717,465980,,12224737,7697065
2023-02-14,3944,131,179,309,38165438,12690570,465930,,12224640,7697126
2023-02-15,4540,119,191,286,38169978,12690423,465855,,12224568,7697183
2023-02-16,4916,175,284,400,38174894,12690331,465742,,12224589,7697352
2023-02-17,4982,180,210,342,38179876,12690265,465709,,12224556,7697484
2023-02-18,5115,232,294,487,38184991,12690235,465645,,12224590,7697747
2023-02-19,3354,132,244,373,38188345,12690109,465529,,12224580,7697904
2023-02-20,1424,63,54,158,38189769,12689924,465535,,12224389,7697851
2023-02-21,913,26,14,107,38190682,12689714,465544,,12224170,7697746
2023-02-22,4135,131,212,370,38194817,12689592,465457,,12224135,7697908
2023-02-23,4282,162,231,392,38199099,12689491,465381,,12224110,7698071
2023-02-24,3034,136,231,274,38202133,12689378,465282,,12224096,7698121
2023-02-25,5024,213,541,386,38207157,12689345,464953,,12224392,7698300
2023-02-26,3472,146,681,384,38210629,12689234,464414,,12224820,7698467
2023-02-27,1074,37,57,97,38211703,12689041,464391,,12224650,7698370
2023-02-28,2729,99,163,232,38214432,12688860,464325,,12224535,7698350
2023-03-01,3850,137,428,336,38218282,12688706,464029,,12224677,7698425
2023-03-02,4594,158,494,330,38222876,12688570,463684,,12224886,7698510
2023-03-03,4367,159,357,334,38227243,12688469,463483,,12224986,7698609
2023-03-04,4968,208,623,350,38232211,12688411,463065,,12225346,7698729
2023-03-05,2536,110,449,251,38234747,12688239,462725,,12225514,7698730
2023-03-06,1156,48,37,114,38235903,12688042,462734,,12225308,7698631
2023-03-07,3221,87,172,225,38239124,12687830,462646,,12225184,7698604
2023-03-08,4317,133,412,284,38243441,12687684,462365,,12225319,7698637
2023-03-09,4615,173,453,312,38248056,12687588,462080,,12225508,7698719
2023-03-10,3942,100,139,254,38251998,12687459,462039,,12225420,7698776
2023-03-11,4064,139,171,286,38256062,12687378,462004,,12225374,7698869
2023-03-12,2883,109,233,301,38258945,12687235,461871,,12225364,7698947
2023-03-13,862,29,32,106,38259807,12687042,461864,,12225178,7698860
2023-03-14,3078,100,109,257,38262885,12686891,461855,,12225036,7698901
2023-03-15,4099,139,163,312,38266984,12686806,461829,,12224977,7699015
2023-03-16,4020,176,234,277,38271004,12686692,461765,,12224927,7699049
2023-03-17,4290,168,202,310,38275294,12686583,461727,,12224856,7699110
2023-03-18,4360,144,194,298,38279654,12686473,461676,,12224797,7699185
2023-03-19,2722,128,233,256,38282376,12686405,461571,,12224834,7699259
2023-03-20,774,31,19,74,38283150,12686198,461583,,12224615,7699128
2023-03-21,2898,70,86,200,38286048,12686040,461563,,12224477,7699131
2023-03-22,3893,130,132,248,38289941,12685926,461558,,12224368,7699160
2023-03-23,3808,118,171,226,38293749,12685808,461500,,12224308,7699182
2023-03-24,3693,102,116,238,38297442,12685694,461485,,12224209,7699235
2023-03-25,4273,108,171,251,38301715,12685576,461417,,12224159,7699289
2023-03-26,2472,112,212,202,38304187,12685478,461314,,12224164,7699307
2023-03-27,915,48,32,68,38305102,12685341,461330,,12224011,7699212
2023-03-28,3104,86,78,202,38308206,12685195,461332,,12223863,7699209
2023-03-29,4170,127,136,224,38312376,12685080,461320,,12223760,7699219
2023-03-30,3838,108,164,211,38316214,12684961,461263,,12223698,7699222
2023-03-31,3987,140,109,222,38320201,12684865,461293,,12223572,7699240
2023-04-01,4191,135,147,225,38324392,12684781,461280,,12223501,7699275
2023-04-02,2180,58,122,173,38326572,12684589,461212,,12223377,7699228
2023-04-03,781,24,12,53,38327353,12684399,461223,,12223176,7699095
2023-04-04,3418,74,74,169,38330771,12684253,461222,,12223031,7699062
2023-04-05,4368,94,108,249,38335139,12684115,461206,,12222909,7699113
2023-04-06,3702,108,109,190,38338841,12684007,461204,,12222803,7699108
2023-04-07,4598,105,115,243,38343439,12683877,461191,,12222686,7699149
2023-04-08,835,22,11,54,38344274,12683704,461198,,12222506,7699036
2023-04-09,2441,81,103,161,38346715,12683612,461174,,12222438,7699048
2023-04-10,360,9,6,20,38347075,12683423,461171,,12222252,7698904
2023-04-11,2771,34,28,121,38349846,12683211,461176,,12222035,7698803
2023-04-12,6345,104,96,188,38356191,12683111,461182,,12221929,7698818
2023-04-13,6997,105,128,207,38363188,12682994,461156,,12221838,7698827
2023-04-14,6514,88,103,206,38369702,12682867,461138,,12221729,7698848
2023-04-15,6949,107,149,230,38376651,12682762,461094,,12221668,7698895
2023-04-16,3274,83,144,165,38379925,12682626,461031,,12221595,7698871
2023-04-17,864,12,13,49,38380789,12682453,461027,,12221426,7698762
2023-04-18,4783,101,77,160,38385572,12682336,461049,,12221287,7698730
2023-04-19,6566,117,98,177,38392138,12682228,461066,,12221162,7698708
2023-04-20,6383,100,152,210,38398521,12682117,461013,,12221104,7698729
2023-04-21,5773,85,75,133,38404294,12681987,461021,,12220966,7698673
2023-04-22,6388,92,91,180,38410682,12681868,461019,,12220849,7698677
2023-04-23,3301,119,147,170,38413983,12681792,460991,,12220801,7698675
2023-04-24,955,4,12,59,38414938,12681613,460982,,12220631,7698583
2023-04-25,4809,69,70,187,38419747,12681480,460981,,12220499,7698585
2023-04-26,6591,108,93,208,38426338,12681394,460996,,12220398,7698622
2023-04-27,6898,118,152,207,38433236,12681300,460958,,12220342,7698644
2023-04-28,6637,86,86,185,38439873,12681170,460957,,12220213,7698631
2023-04-29,6529,124,110,197,38446402,12681088,460970,,12220118,7698647
2023-04-30,2642,94,129,145,38449044,12680994,460934,,12220060,7698625
2023-05-01,1030,20,17,30,38450074,12680817,460935,,12219882,7698478
2023-05-02,4347,67,55,105,38454421,12680678,460943,,12219735,7698403
2023-05-03,5608,108,107,176,38460029,12680580,460941,,12219639,7698403
2023-05-04,8085,87,85,134,38468114,12680455,460942,,12219513,7698360
2023-05-05,13048,90,98,168,38481162,12680347,460931,,12219416,7698350
2023-05-06,15641,114,96,154,38496803,12680279,460948,,12219331,7698339
2023-05-07,6066,56,95,106,38502869,12680147,460905,,12219242,7698280
2023-05-08,2165,16,4,37,38505034,12679987,460915,,12219072,7698161
2023-05-09,12560,55,49,129,38517594,12679847,460918,,12218929,7698126
2023-05-10,14768,70,79,157,38532362,12679727,460907,,12218820,7698115
2023-05-11,13363,77,71,154,38545725,12679628,460912,,12218716,7698116
2023-05-12,13485,86,79,176,38559210,12679531,460917,,12218614,7698121
2023-05-13,11444,80,74,147,38570654,12679395,460919,,12218476,7698077
2023-05-14,4184,67,95,93,38574838,12679279,460890,,12218389,7698014
2023-05-15,1055,9,6,38,38575893,12679113,460887,,12218226,7697907
2023-05-16,8948,56,47,93,38584841,12678969,460891,,12218078,7697829
2023-05-17,11122,99,83,141,38595963,12678860,460904,,12217956,7697777
2023-05-18,10837,81,69,144,38606800,12678735,460915,,12217820,7697737
2023-05-19,10410,96,96,151,38617210,12678630,460913,,12217717,7697706
2023-05-20,9360,90,88,163,38626570,12678512,460914,,12217598,7697677
2023-05-21,3084,48,86,95,38629654,12678395,460874,,12217521,7697622
2023-05-22,970,14,11,30,38630624,12678234,460877,,12217357,7697497
2023-05-23,754,8,3,16,38631378,12678067,460882,,12217185,7697361
2023-05-24,8017,57,80,105,38639395,12677920,460858,,12217062,7697279
2023-05-25,9343,74,93,163,38648738,12677809,460837,,12216972,7697279
2023-05-26,7993,67,70,123,38656731,12677709,460834,,12216875,7697253
2023-05-27,8140,108,76,125,38664871,12677650,460864,,12216786,7697236
2023-05-28,2905,56,72,101,38667776,12677552,460845,,12216707,7697195
2023-05-29,972,13,11,30,38668748,12677399,460845,,12216554,7697072
2023-05-30,6045,60,50,112,38674793,12677275,460854,,12216421,7697017
2023-05-31,8168,91,94,122,38682961,12677184,460849,,12216335,7696979
2023-06-01,7339,71,95,121,38690300,12677075,460823,,12216252,7696941
2023-06-02,6323,50,48,121,38696623,12676953,460824,,12216129,7696907
2023-06-03,5485,71,63,122,38702108,12676856,460832,,12216024,7696882
2023-06-04,2048,47,78,77,38704156,12676767,460800,,12215967,7696835
2023-06-05,598,11,6,18,38704754,12676628,460804,,12215824,7696720
2023-06-06,4448,39,38,78,38709202,12676517,460802,,12215715,7696663
2023-06-07,5784,62,65,120,38714986,12676445,460796,,12215649,7696667
2023-06-08,5740,57,68,111,38720726,12676389,460784,,12215605,7696682
2023-06-09,6169,76,81,122,38726895,12676321,460779,,12215542,7696674
2023-06-10,5321,77,95,115,38732216,12676245,460760,,12215485,7696652
2023-06-11,2009,55,62,105,38734225,12676175,460751,,12215424,7696647
2023-06-12,690,11,7,38,38734915,12676094,460754,,12215340,7696603
2023-06-13,4176,55,58,102,38739091,12676008,460750,,12215258,7696588
2023-06-14,5469,72,83,118,38744560,12675939,460738,,12215201,7696585
2023-06-15,5098,70,76,121,38749658,12675870,460731,,12215139,7696581
2023-06-16,5672,71,64,120,38755330,12675819,460736,,12215083,7696598
2023-06-17,4054,63,62,111,38759384,12675774,460737,,12215037,7696611
2023-06-18,1557,42,61,97,38760941,12675707,460717,,12214990,7696617
2023-06-19,371,7,2,15,38761312,12675628,460721,,12214907,7696556
2023-06-20,3143,52,42,88,38764455,12675572,460730,,12214842,7696547
2023-06-21,3615,41,56,86,38768070,12675522,460714,,12214808,7696551
2023-06-22,3924,75,73,115,38771994,12675498,460716,,12214782,7696581
2023-06-23,4423,57,44,87,38776417,12675472,460728,,12214744,7696597
2023-06-24,3673,50,61,72,38780090,12675422,460715,,12214707,7696582
2023-06-25,1511,31,50,92,38781601,12675389,460696,,12214693,7696616
2023-06-26,506,12,9,21,38782107,12675349,460698,,12214651,7696592
2023-06-27,3036,80,46,90,38785143,12675375,460731,,12214644,7696637
2023-06-28,3995,74,57,89,38789138,12675414,460748,,12214666,7696692
2023-06-29,3892,65,72,80,38793030,12675450,460740,,12214710,7696747
2023-06-30,3651,75,60,124,38796681,12675511,460755,,12214756,7696858
2023-07-01,3070,53,87,114,38799751,12675563,460721,,12214842,7696971
2023-07-02,266,10,4,15,38800017,12675573,460727,,12214846,7696986
2023-07-03,350,6,4,26,38800367,12675579,460729,,12214850,7697012
2023-07-04,1220,16,11,48,38801587,12675595,460734,,12214861,7697060
2023-07-05,2345,53,40,70,38803932,12675648,460747,,12214901,7697130
2023-07-06,2327,39,65,81,38806259,12675687,460721,,12214966,7697211
