"report_date","previous_day_total_doses_administered","previous_day_at_least_one","previous_day_fully_vaccinated","previous_day_3doses","total_doses_administered","total_individuals_at_least_one","total_individuals_partially_vaccinated","total_doses_in_fully_vaccinated_individuals","total_individuals_fully_vaccinated","total_individuals_3doses"
2021-01-01,6251,6241,2,,32185,32130,32119,22,11,
2021-01-02,4613,4601,6,,36798,36679,36666,26,13,
2021-01-03,5393,5386,3,,42191,42065,42049,32,16,
2021-01-04,5994,5992,0,,48185,48056,48041,30,15,
2021-01-05,9681,9657,19,,57866,57711,57678,66,33,
2021-01-06,12792,12327,450,,70658,70034,69555,958,479,
2021-01-07,16216,15504,697,,86874,85537,84361,2352,1176,
2021-01-08,18035,17020,1002,,104909,102557,100379,4356,2178,
2021-01-09,19499,18422,1064,,124408,120978,117736,6484,3242,
2021-01-10,11367,11328,37,,135775,132297,129019,6556,3278,
2021-01-11,11710,11661,48,,147485,143958,140632,6652,3326,
2021-01-12,14466,14160,297,,161951,158110,154487,7246,3623,
2021-01-13,15433,13811,1593,,177384,171907,166693,10428,5214,
2021-01-14,19180,16730,2435,,196564,188631,180983,15296,7648,
2021-01-15,20046,17990,2037,,216610,206610,196925,19370,9685,
2021-01-16,17115,15932,1170,,233725,222526,211671,21710,10855,
2021-01-17,11254,10011,1236,,244979,232522,220433,24178,12089,
2021-01-18,6789,6708,71,,251768,239207,227050,24314,12157,
2021-01-19,11823,9715,2094,,263591,248901,234650,28502,14251,
2021-01-20,10799,7210,3572,,274390,256088,238266,35644,17822,
2021-01-21,10968,6850,4091,,285358,262922,241009,43826,21913,
2021-01-22,9035,4318,4698,,294393,267203,240594,53218,26609,
2021-01-23,7447,3031,4388,,301840,270204,239208,61992,30996,
2021-01-24,4381,1825,2536,,306221,272011,238479,67064,33532,
2021-01-25,5318,1046,4263,,311539,273025,235231,75588,37794,
2021-01-26,9378,2855,6495,,320917,275848,231560,88576,44288,
2021-01-27,9893,2861,7004,,330810,278680,227389,102582,51291,
2021-01-28,13105,5731,7332,,343915,284378,225755,117246,58623,
2021-01-29,10683,3270,7379,,354598,287617,221616,132002,66001,
2021-01-30,9183,2724,6422,,363781,290299,217879,144840,72420,
2021-01-31,3371,1560,1767,,367152,291825,217639,148372,74186,
2021-02-01,2121,484,1609,,369273,292275,216484,151582,75791,
2021-02-02,4403,1350,2995,,373676,293587,214805,157564,78782,
2021-02-03,6231,1712,4457,,379907,295258,212026,166464,83232,
2021-02-04,9072,1704,7289,,388979,296919,206404,181030,90515,
2021-02-05,8436,1463,6902,,397415,298342,200931,194822,97411,
2021-02-06,10656,1862,8735,,408071,300149,194012,212274,106137,
2021-02-07,7567,1724,5795,,415638,301833,189913,223840,111920,
2021-02-08,8215,3093,5080,,423853,304878,187891,233974,116987,
2021-02-09,14997,3852,11079,,438850,308688,180638,256100,128050,
2021-02-10,15501,4923,10518,,454351,313559,175016,277086,138543,
2021-02-11,16357,3895,12407,,470708,317402,166483,301838,150919,
2021-02-12,17648,2093,15505,,488356,319457,153052,332810,166405,
2021-02-13,16200,2438,13746,,504556,321850,141718,360264,180132,
2021-02-14,12874,917,11925,,517430,322719,130692,384054,192027,
2021-02-15,7859,483,7328,,525289,323154,123825,398658,199329,
2021-02-16,5989,1040,4899,,531278,324151,119946,408410,204205,
2021-02-17,10159,1603,8522,,541437,325710,113011,425398,212699,
2021-02-18,13865,2951,10870,,555302,328613,105074,447078,223539,
2021-02-19,18484,6211,12206,,573786,334772,99058,471428,235714,
2021-02-20,22618,11127,11439,,596404,345836,98721,494230,247115,
2021-02-21,17229,10373,6821,,613633,356149,102255,507788,253894,
2021-02-22,13575,8749,4775,,627208,364828,106209,517238,258619,
2021-02-23,17853,11117,6665,,645061,375889,110641,530496,265248,
2021-02-24,18565,13606,4878,,663626,389439,119355,540168,270084,
2021-02-25,20799,16483,4259,,684425,405856,131561,548590,274295,
2021-02-26,24881,21826,2995,,709306,427622,150369,554506,277253,
2021-02-27,27447,23572,3834,,736753,451130,170091,562078,281039,
2021-02-28,20578,19139,1405,,757331,470215,187813,564804,282402,
2021-03-01,18214,17021,1148,,775545,487174,203671,567006,283503,
2021-03-02,24670,22268,2318,,800215,509381,223606,571550,285775,
2021-03-03,30583,27955,2575,,830798,537285,248968,576634,288317,
2021-03-04,34679,32453,2142,,865477,569672,279263,580818,290409,
2021-03-05,39973,38147,1778,,905450,607771,315618,584306,292153,
2021-03-06,44131,41929,2164,,949581,649645,355369,588552,294276,
2021-03-07,32724,31548,1172,,982305,681119,385729,590780,295390,
2021-03-08,24035,22161,1861,,1006340,703212,406015,594394,297197,
2021-03-09,33276,29830,3418,,1039616,732976,432407,601138,300569,
2021-03-10,38321,34061,4214,,1077937,766963,462228,609470,304735,
2021-03-11,43964,40693,3232,,1121901,807590,499675,615830,307915,
2021-03-12,47690,45978,1688,,1169591,853504,543951,619106,309553,
2021-03-13,57896,55025,2843,,1227487,908458,596116,624684,312342,
2021-03-14,43389,42157,1216,,1270876,950532,637042,626980,313490,
2021-03-15,32796,31100,1681,,1303672,981573,666445,630256,315128,
2021-03-16,53933,51641,2276,,1357605,1033149,715788,634722,317361,
2021-03-17,61046,58513,2491,,1418651,1091596,771794,639604,319802,
2021-03-18,61519,59066,2428,,1480170,1150590,828413,644354,322177,
2021-03-19,64445,61126,3266,,1544615,1211638,886248,650780,325390,
2021-03-20,62550,59966,2553,,1607165,1271548,943653,655790,327895,
2021-03-21,43979,42462,1531,,1651144,1313945,984556,658778,329389,
2021-03-22,30990,30028,974,,1682134,1343885,1013578,660614,330307,
2021-03-23,54598,51823,2724,,1736732,1395613,1062645,665936,332968,
2021-03-24,76408,73228,3132,,1813140,1468751,1132708,672086,336043,
2021-03-25,82893,80316,2530,,1896033,1548988,1210472,677032,338516,
2021-03-26,86984,83455,3490,,1983017,1632362,1290408,683908,341954,
2021-03-27,80834,77886,2864,,2063851,1710145,1365392,689506,344753,
2021-03-28,66978,65392,1553,,2130829,1775447,1429198,692498,346249,
2021-03-29,51725,49040,2651,,2182554,1824407,1475553,697708,348854,
2021-03-30,73557,70153,3346,,2256111,1894483,1542324,704318,352159,
2021-03-31,93136,89492,3577,,2349247,1983877,1628194,711366,355683,
2021-04-01,89292,85424,3831,,2438539,2069203,1709742,718922,359461,
2021-04-02,93062,88840,4206,,2531601,2157957,1794342,727230,363615,
2021-04-03,60975,59304,1729,,2592576,2217170,1851877,730586,365293,
2021-04-04,72319,70669,1646,,2664895,2287728,1920847,733762,366881,
2021-04-05,53726,53257,469,,2718621,2340901,1973599,734604,367302,
2021-04-06,79566,77704,1882,,2798187,2418504,2049373,738262,369131,
2021-04-07,107988,104927,3053,,2906175,2523306,2151180,744252,372126,
2021-04-08,114059,110096,4020,,3020234,2633291,2257201,752180,376090,
2021-04-09,109822,105607,4289,,3130056,2738780,2358466,760628,380314,
2021-04-10,109212,105464,3842,,3239268,2844116,2460026,768180,384090,
2021-04-11,98605,95496,3253,,3337873,2939487,2552203,774568,387284,
2021-04-12,76055,74995,1153,,3413928,3014334,2625965,776738,388369,
2021-04-13,99449,96077,3394,,3513377,3110302,2718587,783430,391715,
2021-04-14,117026,113268,3647,,3630403,3223452,2828130,790644,395322,
2021-04-15,113544,109492,3894,,3743947,3332818,2933659,798318,399159,
2021-04-16,118097,113729,4191,,3862044,3446437,3043131,806612,403306,
2021-04-17,112394,107813,4442,,3974438,3554116,3146427,815378,407689,
2021-04-18,88729,86498,2099,,4063167,3640491,3230757,819468,409734,
2021-04-19,68956,67430,1447,,4132123,3707791,3296661,822260,411130,
2021-04-20,101906,98586,3116,,4234029,3806215,3392034,828362,414181,
2021-04-21,141972,137710,4028,,4376001,3943751,3525610,836282,418141,
2021-04-22,139452,135314,3901,,4515453,4078936,3656950,843972,421986,
2021-04-23,138180,131783,6154,,4653633,4210565,3782483,856164,428082,
2021-04-24,130262,126214,3878,,4783895,4336631,3904727,863808,431904,
2021-04-25,102000,98599,3174,,4885895,4435082,4000071,870022,435011,
2021-04-26,70991,69290,1554,,4956886,4504241,4067736,873010,436505,
2021-04-27,98481,95410,2883,,5055367,4599490,4160165,878650,439325,
2021-04-28,120554,115942,4422,,5175921,4715264,4271589,887350,443675,
2021-04-29,124461,119272,5043,,5300382,4834369,4385720,897298,448649,
2021-04-30,115791,110552,5005,,5416173,4944748,4491171,907154,453577,
2021-05-01,111265,107414,3636,,5527438,5051981,4594845,914272,457136,
2021-05-02,79124,76153,2859,,5606562,5127977,4668048,919858,459929,
2021-05-03,56778,55114,1593,,5663340,5182937,4721475,922924,461462,
2021-05-04,91909,88543,3281,,5755249,5271302,4806636,929332,464666,
2021-05-05,137971,133275,4612,,5893220,5404408,4935193,938430,469215,
2021-05-06,141819,136871,4810,,6035039,5541095,5067132,947926,473963,
2021-05-07,150245,145223,4825,,6185284,5686158,5207429,957458,478729,
2021-05-08,142430,137753,4429,,6327714,5823716,5340637,966158,483079,
2021-05-09,124786,121142,3477,,6452500,5944694,5458202,972984,486492,
2021-05-10,97786,95812,1874,,6550286,6040317,5552018,976598,488299,
2021-05-11,113493,108833,4481,,6663779,6148948,5656239,985418,492709,
2021-05-12,145005,137992,6867,,6808784,6286761,5787251,999020,499510,
2021-05-13,142636,135293,7198,,6951420,6421879,5915245,1013268,506634,
2021-05-14,148859,138756,9935,,7100279,6560447,6043943,1033008,516504,
2021-05-15,159697,149667,9854,,7259976,6709927,6183644,1052566,526283,
2021-05-16,144342,136075,8063,,7404318,6845834,6311568,1068532,534266,
2021-05-17,114957,110863,3941,,7519275,6956508,6418377,1076262,538131,
2021-05-18,111293,100438,10655,,7630568,7056750,6508026,1097448,548724,
2021-05-19,149844,133448,16221,,7780412,7190046,6625175,1129742,564871,
2021-05-20,151524,131547,19767,,7931936,7321404,6736835,1169138,584569,
2021-05-21,165342,140848,24239,,8097278,7462071,6853340,1217462,608731,
2021-05-22,199389,172211,26952,,8296667,7634085,6998483,1271204,635602,
2021-05-23,139801,127435,12222,,8436468,7761342,7113580,1295524,647762,
2021-05-24,100277,93308,6825,,8536745,7854477,7199960,1309034,654517,
2021-05-25,90423,82945,7269,,8627168,7937259,7275540,1323438,661719,
2021-05-26,139740,112980,26496,,8766908,8050052,7361907,1376290,688145,
2021-05-27,152032,123017,28763,,8918940,8172912,7456073,1433678,716839,
2021-05-28,163827,132282,31241,,9082767,8305021,7557000,1496042,748021,
2021-05-29,153348,117096,36021,,9236115,8421968,7637982,1567972,783986,
2021-05-30,149692,118995,30473,,9385807,8540793,7726396,1628794,814397,
2021-05-31,99190,79797,19202,,9484997,8620420,7786885,1667070,833535,
2021-06-01,124152,90583,33237,,9609149,8710808,7844111,1733394,866697,
2021-06-02,145271,102120,42903,,9754420,8812747,7903216,1819062,909531,
2021-06-03,155326,99886,55164,,9909746,8912449,7947825,1929248,964624,
2021-06-04,181678,115512,65898,,10091424,9027762,7997328,2060868,1030434,
2021-06-05,171977,103403,68299,,10263401,9130967,8032319,2197296,1098648,
2021-06-06,163355,91835,71239,,10426756,9222624,8052807,2339634,1169817,
2021-06-07,119543,63036,56290,,10546299,9285463,8059431,2452064,1226032,
2021-06-08,161864,72427,89000,,10708163,9357701,8042749,2629904,1314952,
2021-06-09,181429,70783,110183,,10889592,9428307,8003253,2850108,1425054,
2021-06-10,185546,66402,118659,,11075138,9494506,7950884,3087244,1543622,
2021-06-11,204748,67492,136504,,11279886,9561812,7881768,3360088,1680044,
2021-06-12,199684,62647,136439,,11479570,9624277,7807886,3632782,1816391,
2021-06-13,190296,58859,130911,,11669866,9682961,7735739,3894444,1947222,
2021-06-14,137667,38680,98593,,11807533,9721445,7675735,4091420,2045710,
2021-06-15,189177,42582,146244,,11996710,9763809,7571952,4383714,2191857,
2021-06-16,206098,42415,163044,,12202808,9806028,7451230,4709596,2354798,
2021-06-17,210375,37918,171881,,12413183,9843731,7317144,5053174,2526587,
2021-06-18,217115,35338,181177,,12630298,9878879,7171207,5415344,2707672,
2021-06-19,215830,35473,179691,,12846128,9914146,7026895,5774502,2887251,
2021-06-20,186227,35541,150111,,13032355,9949489,6912235,6074508,3037254,
2021-06-21,120414,20818,99099,,13152769,9970112,6833851,6272522,3136261,
2021-06-22,204894,27487,176657,,13357663,9997405,6684596,6625618,3312809,
2021-06-23,230484,28608,201143,,13588147,10025813,6511969,7027688,3513844,
2021-06-24,227650,26658,200245,,13815797,10052275,6338296,7427958,3713979,
2021-06-25,251068,27960,222365,,14066865,10080034,6143808,7872452,3936226,
2021-06-26,261251,29986,230564,,14328116,10109795,5943145,8333300,4166650,
2021-06-27,204967,27771,176594,,14533083,10137384,5794250,8686268,4343134,
2021-06-28,199228,20949,177722,,14732311,10158135,5637404,9041462,4520731,
2021-06-29,250078,24476,224878,,14982389,10182370,5436915,9490910,4745455,
2021-06-30,275501,24163,250772,,15257890,10206330,5210232,9992196,4996098,
2021-07-01,271945,25294,246099,,15529835,10231406,4989348,10484116,5242058,
2021-07-02,144697,11577,132896,,15674532,10242809,4867957,10749704,5374852,
2021-07-03,216867,19915,196721,,15891399,10262502,4691078,11142848,5571424,
2021-07-04,196134,19393,176519,,16087533,10281709,4533885,11495648,5747824,
2021-07-05,148705,12435,136129,,16236238,10293955,4410129,11767652,5883826,
2021-07-06,219998,19980,199805,,16456236,10313719,4230234,12166970,6083485,
2021-07-07,246585,22959,223389,,16702821,10336452,4029726,12613452,6306726,
2021-07-08,231168,21339,209620,,16933989,10357585,3841374,13032422,6516211,
2021-07-09,226963,21497,205300,,17160952,10378880,3657501,13442758,6721379,
2021-07-10,209035,20528,188354,,17369987,10399204,3489608,13819192,6909596,
2021-07-11,171645,17564,153957,,17541632,10416567,3353161,14126812,7063406,
2021-07-12,123115,11441,111578,,17664747,10427819,3252972,14349694,7174847,
2021-07-13,178456,19009,159305,,17843203,10446606,3112609,14667994,7333997,
2021-07-14,180005,19289,160560,,18023208,10465680,2971286,14988788,7494394,
2021-07-15,167170,19577,147421,,18190378,10485046,2843395,15283302,7641651,
2021-07-16,169311,19881,149278,,18359689,10504725,2713949,15581552,7790776,
2021-07-17,172961,20247,152589,,18532650,10524723,2581550,15886346,7943173,
2021-07-18,133603,15917,117548,,18666253,10540456,2479883,16121146,8060573,
2021-07-19,91956,10408,81442,,18758209,10550651,2408811,16283680,8141840,
2021-07-20,133509,16935,116516,,18891718,10567346,2309166,16516360,8258180,
2021-07-21,140062,16975,123017,,19031780,10584106,2203071,16762070,8381035,
2021-07-22,125565,17620,107810,,19157345,10601502,2112834,16977336,8488668,
2021-07-23,120228,16977,103044,,19277573,10618238,2026725,17183026,8591513,
2021-07-24,126657,18318,108102,,19404230,10636353,1936901,17398904,8699452,
2021-07-25,103608,14844,88635,,19507838,10650973,1863067,17575812,8787906,
2021-07-26,66670,9878,56700,,19574508,10660633,1816208,17688850,8844425,
2021-07-27,92351,15309,76881,,19666859,10675681,1754592,17842178,8921089,
2021-07-28,93902,16442,77386,,19760761,10691888,1693604,17996568,8998284,
2021-07-29,89362,16691,72510,,19850123,10708347,1637741,18141212,9070606,
2021-07-30,84023,16086,67825,,19934146,10724205,1585962,18276486,9138243,
2021-07-31,83808,15690,67966,,20017954,10739677,1533658,18412038,9206019,
2021-08-01,61846,11306,50359,,20079800,10750757,1494570,18512374,9256187,
2021-08-02,42460,7397,34945,,20122260,10757956,1466990,18581932,9290966,
2021-08-03,33261,5943,27149,,20155521,10763666,1445761,18635810,9317905,
2021-08-04,61284,12359,48734,,20216805,10775790,1409349,18732882,9366441,
2021-08-05,59418,12521,46743,,20276223,10788103,1375083,18826040,9413020,
2021-08-06,55985,11840,43929,,20332208,10799683,1342963,18913440,9456720,
2021-08-07,62339,12117,50025,,20394547,10811539,1305012,19013054,9506527,
2021-08-08,48636,9240,39209,,20443183,10820551,1275020,19091062,9545531,
2021-08-09,30837,5928,24735,,20474020,10826265,1256186,19140158,9570079,
2021-08-10,49216,10493,38426,,20523236,10836478,1228219,19216518,9608259,
2021-08-11,48690,10753,37695,,20571926,10846984,1201246,19291476,9645738,
2021-08-12,49206,11177,37806,,20621132,10857910,1174575,19366670,9683335,
2021-08-13,49587,11715,37601,,20670719,10869384,1148659,19441450,9720725,
2021-08-14,51179,12120,38853,,20721898,10881254,1121900,19518708,9759354,
2021-08-15,41725,9832,31673,,20763623,10890884,1100029,19581710,9790855,
2021-08-16,26713,6169,20389,,20790336,10896830,1085783,19622094,9811047,
2021-08-17,40466,11037,29168,,20830802,10907617,1067628,19679978,9839989,
2021-08-18,41867,11954,29672,,20872669,10919329,1049878,19738902,9869451,
2021-08-19,45852,16510,29081,,20918521,10935588,1037279,19796618,9898309,
2021-08-20,46402,16268,29720,,20964923,10951600,1023800,19855600,9927800,
2021-08-21,47918,15131,32417,,21012841,10966471,1006481,19919980,9959990,
2021-08-22,34361,10795,23300,,21047202,10977020,993952,19966136,9983068,
2021-08-23,23206,6998,15991,,21070408,10983783,984938,19997690,9998845,
2021-08-24,37623,13359,23809,,21108031,10996888,974465,20044846,10022423,
2021-08-25,41296,14397,26295,,21149327,11011029,962548,20096962,10048481,
2021-08-26,39238,13546,24950,,21188565,11024299,951109,20146380,10073190,
2021-08-27,37625,12910,23673,,21226190,11036968,940319,20193298,10096649,
2021-08-28,40079,13404,25500,,21266269,11050094,928199,20243790,10121895,
2021-08-29,30518,10235,19931,,21296787,11060097,918484,20283226,10141613,
2021-08-30,18223,6135,11839,,21315010,11065984,912751,20306466,10153233,
2021-08-31,32684,11929,19607,,21347694,11077645,905045,20345200,10172600,
2021-09-01,36203,12928,21933,,21383897,11090340,896024,20388632,10194316,
2021-09-02,37730,15626,19646,,21421627,11105714,891979,20427470,10213735,
2021-09-03,46828,21063,22417,,21468455,11126529,890606,20471846,10235923,
2021-09-04,46848,20579,24756,,21515303,11146862,886406,20520912,10260456,
2021-09-05,33046,14197,18563,,21548349,11160815,882020,20557590,10278795,
2021-09-06,21687,9476,12024,,21570036,11170042,879455,20581174,10290587,
2021-09-07,14970,6713,8076,,21585006,11176498,878075,20596846,10298423,
2021-09-08,41113,17100,20922,,21626119,11193334,874235,20638198,10319099,
2021-09-09,41416,16959,19661,,21667535,11210016,871508,20677016,10338508,
2021-09-10,39604,15493,18979,,21707139,11225247,868004,20714486,10357243,
2021-09-11,42345,15924,23321,,21749484,11240892,860586,20760612,10380306,
2021-09-12,29940,11524,17856,,21779424,11252122,854224,20795796,10397898,
2021-09-13,16062,6395,9171,,21795486,11258283,851433,20813700,10406850,
2021-09-14,29877,11549,15276,,21825363,11269531,847679,20843704,10421852,
2021-09-15,39251,14011,19410,,21864614,11283283,842265,20882036,10441018,
2021-09-16,39321,13974,19233,,21903935,11297022,836983,20920078,10460039,
2021-09-17,38887,13594,19316,,21942822,11310373,831249,20958248,10479124,
2021-09-18,41191,14073,23498,,21984013,11324173,821803,21004740,10502370,
2021-09-19,30626,10820,18964,,22014639,11334734,813646,21042176,10521088,
2021-09-20,16722,6100,10170,,22031361,11340580,809553,21062054,10531027,
2021-09-21,31331,11203,16976,,22062692,11351518,803764,21095508,10547754,
2021-09-22,41784,14810,22909,,22104476,11366032,795644,21140776,10570388,
2021-09-23,47194,16126,26012,,22151670,11381895,785739,21192312,10596156,
2021-09-24,46271,15626,26627,,22197941,11397260,774719,21245082,10622541,
2021-09-25,48166,15245,29931,,22246107,11412252,760014,21304476,10652238,
2021-09-26,37471,12412,24468,,22283578,11424389,747937,21352904,10676452,
2021-09-27,19143,6527,12311,,22302721,11430662,742137,21377050,10688525,
2021-09-28,30926,11282,17863,,22333647,11441685,735544,21412282,10706141,
2021-09-29,37854,12465,21708,,22371501,11453879,726281,21455196,10727598,
2021-09-30,37306,11643,21356,,22408807,11465263,716549,21497428,10748714,
2021-10-01,30848,9803,18394,,22439655,11474840,707945,21533790,10766895,
2021-10-02,37110,11150,23569,,22476765,11485720,695508,21580424,10790212,
2021-10-03,27195,8160,18319,,22503960,11493639,685336,21616606,10808303,
2021-10-04,14864,4744,9801,,22518824,11498137,680261,21635752,10817876,
2021-10-05,26789,8584,15850,,22545613,11506460,672980,21666960,10833480,
2021-10-06,31638,9631,18493,,22577251,11515832,664110,21703444,10851722,
2021-10-07,30326,9387,17108,,22607577,11524968,656376,21737184,10868592,
2021-10-08,32811,10735,18837,,22640388,11535433,648261,21774344,10887172,
2021-10-09,34112,10653,20999,,22674500,11545823,637901,21815844,10907922,
2021-10-10,23390,7653,15073,,22697890,11553225,630469,21845512,10922756,
2021-10-11,11994,3837,7861,,22709884,11556812,626429,21860766,10930383,
2021-10-12,5090,1621,3256,,22714974,11558155,624779,21866752,10933376,
2021-10-13,29084,9187,18069,,22744058,11567052,615881,21902342,10951171,
2021-10-14,28994,8899,17738,,22773052,11575676,607032,21937288,10968644,
2021-10-15,29067,8819,18153,,22802119,11584232,597685,21973094,10986547,
2021-10-16,31125,8982,19863,,22833244,11592923,586792,22012262,11006131,
2021-10-17,23683,7253,15360,,22856927,11599922,578672,22042500,11021250,
2021-10-18,12300,3747,8144,,22869227,11603388,574263,22058250,11029125,
2021-10-19,21245,6618,12617,,22890472,11609724,568251,22082946,11041473,
2021-10-20,25625,7534,14896,,22916097,11617011,560876,22112270,11056135,
2021-10-21,23152,6674,13019,,22939249,11623416,554520,22137792,11068896,
2021-10-22,26085,7301,15091,,22965334,11630395,546714,22167362,11083681,
2021-10-23,28157,7599,17145,,22993491,11637732,537161,22201142,11100571,
2021-10-24,19334,5731,12584,,23012825,11643207,530296,22225822,11112911,
2021-10-25,9921,2710,6472,,23022746,11645648,526526,22238244,11119122,
2021-10-26,18880,5382,11087,,23041626,11650752,520812,22259880,11129940,
2021-10-27,22821,6069,13192,,23064447,11656566,513675,22285782,11142891,
2021-10-28,22283,5791,12631,,23086730,11662069,506824,22310490,11155245,
2021-10-29,22791,5727,13037,,23109521,11667495,499500,22335990,11167995,
2021-10-30,24080,6031,14597,,23133601,11673254,490922,22364664,11182332,
2021-10-31,16457,4590,10584,,23150058,11677550,484923,22385254,11192627,
2021-11-01,7863,2078,5053,,23157921,11679348,481935,22394826,11197413,
2021-11-02,15610,4362,7734,,23173531,11683419,478552,22409734,11204867,
2021-11-03,18601,5065,9594,,23192132,11688181,474013,22428336,11214168,
2021-11-04,19479,4865,10017,,23211611,11692770,468846,22447848,11223924,
2021-11-05,21438,4396,9509,,23233049,11696877,463719,22466316,11233158,
2021-11-06,25314,5199,12148,,23258363,11701807,456753,22490108,11245054,
2021-11-07,21430,4020,8909,,23279793,11705547,451852,22507390,11253695,
2021-11-08,11986,2109,4728,,23291779,11707361,449217,22516288,11258144,
2021-11-09,24097,3845,7630,,23315876,11710885,445422,22530926,11265463,
2021-11-10,28448,4503,8976,,23344324,11715110,440935,22548350,11274175,
2021-11-11,28732,4297,9082,,23373056,11719111,436141,22565940,11282970,
2021-11-12,26720,4161,8218,,23399776,11722981,432070,22581822,11290911,
2021-11-13,34277,5072,11393,,23434053,11727747,425740,22604014,11302007,
2021-11-14,23202,3897,8593,,23457255,11731381,421037,22620688,11310344,
2021-11-15,12693,2185,4489,,23469948,11733306,418725,22629162,11314581,
2021-11-16,26152,3924,7467,,23496100,11736973,415178,22643590,11321795,
2021-11-17,31137,4046,7792,,23527237,11740737,411422,22658630,11329315,
2021-11-18,32468,3854,7506,,23559705,11744285,407756,22673058,11336529,
2021-11-19,35440,3856,7736,,23595145,11747841,403864,22687954,11343977,
2021-11-20,40095,4380,8807,,23635240,11751942,399428,22705028,11352514,
2021-11-21,28096,3431,6939,,23663336,11755111,395906,22718410,11359205,
2021-11-22,14885,1949,3888,,23678221,11756784,393961,22725646,11362823,
2021-11-23,33040,3271,6002,,23711261,11759775,391222,22737106,11368553,
2021-11-24,42619,3750,6786,,23753880,11763221,388175,22750092,11375046,
2021-11-25,46011,3929,6551,,23799891,11766875,385550,22762650,11381325,
2021-11-26,52814,11342,6604,,23852705,11777947,390281,22775332,11387666,
2021-11-27,63490,22348,7023,,23916195,11800014,405596,22788836,11394418,
2021-11-28,51442,27735,5307,,23967637,11827457,428012,22798890,11399445,
2021-11-29,33514,18931,2874,,24001151,11846127,444058,22804138,11402069,
2021-11-30,55989,20669,5114,,24057140,11866515,459603,22813824,11406912,
2021-12-01,69511,26235,5619,,24126651,11892444,480205,22824478,11412239,
2021-12-02,71598,26483,5022,,24198249,11918629,501653,22833952,11416976,
2021-12-03,73387,25096,5152,,24271636,11943429,521591,22843676,11421838,
2021-12-04,81126,27783,6055,47269,24352762,11970919,543310,,11427609,807339
2021-12-05,62609,31926,4397,26266,24415371,12002550,570831,,11431719,833501
2021-12-06,38616,19140,2708,16753,24453987,12021401,587256,,11434145,850176
2021-12-07,60253,14846,4453,40942,24514240,12035976,597639,,11438337,891044
2021-12-08,73423,19053,4671,49697,24587663,12054752,612011,,11442741,940663
2021-12-09,74471,18270,4331,51851,24662134,12072713,625942,,11446771,992429
2021-12-10,77448,17586,4636,55218,24739582,12090018,638887,,11451131,1047566
2021-12-11,83151,20403,5813,56923,24822733,12110132,653463,,11456669,1104403
2021-12-12,60736,22694,4148,33852,24883469,12132546,672003,,11460543,1138166
2021-12-13,34912,11595,2402,20893,24918381,12143844,681186,,11462658,1158964
2021-12-14,101942,8997,3852,89050,25020323,12152531,686316,,11466215,1247894
2021-12-15,127663,12427,4498,110703,25147986,12164654,694235,,11470419,1358497
2021-12-16,139305,12449,4234,122610,25287291,12176817,702440,,11474377,1481008
2021-12-17,159131,12397,4502,142210,25446422,12188939,710326,,11478613,1623121
2021-12-18,175550,13521,4914,157072,25621972,12202166,718921,,11483245,1780098
2021-12-19,140406,18154,3926,118293,25762378,12220019,733141,,11486878,1898280
2021-12-20,106807,10305,2742,93715,25869185,12230056,740694,,11489362,1991897
2021-12-21,215198,12961,4305,197911,26084383,12242701,749343,,11493358,2189687
2021-12-22,237186,14419,5189,217693,26321569,12256822,758559,,11498263,2407263
2021-12-23,257390,11711,5075,240511,26578959,12268229,765189,,11503040,2647668
2021-12-24,223369,9443,4554,209310,26802328,12277375,770074,,11507301,2856862
2021-12-25,89687,3884,2500,83315,26892015,12280984,771453,,11509531,2940070
2021-12-26,11891,387,354,11140,26903906,12281079,771478,,11509601,2951080
2021-12-27,46923,1493,1111,44290,26950829,12282327,771853,,11510474,2995250
2021-12-28,144741,6098,3995,134588,27095570,12288131,773945,,11514186,3129707
2021-12-29,175443,9374,4569,161429,27271013,12297210,778746,,11518464,3291009
2021-12-30,200021,10126,5338,184515,27471034,12307033,783519,,11523514,3475390
2021-12-31,195174,10007,5792,179125,27666208,12316751,787725,,11529026,3654389
2022-01-01,96928,5376,3874,87353,27763136,12321819,789219,,11532600,3741594
2022-01-02,19433,937,923,17444,27782569,12322465,789224,,11533241,3758892
2022-01-03,88241,4773,4590,78797,27870810,12326928,789399,,11537529,3837536
2022-01-04,146335,5995,5309,134991,28017145,12332595,790072,,11542523,3972371
2022-01-05,177447,7614,7292,162369,28194592,12339855,790383,,11549472,4134580
2022-01-06,191489,7198,6780,176986,28386081,12346734,790790,,11555944,4311411
2022-01-07,191203,7948,6983,175462,28577284,12354338,791743,,11562595,4486700
2022-01-08,181615,8613,6628,165188,28758899,12362619,793715,,11568904,4651732
2022-01-09,131077,9859,7175,113952,28889976,12372156,796394,,11575762,4765524
2022-01-10,90547,5106,4489,80825,28980523,12376940,797001,,11579939,4846196
2022-01-11,138839,6148,6560,125425,29119362,12382741,796576,,11586165,4971431
2022-01-12,156985,8155,8043,138667,29276347,12390567,796683,,11593884,5109930
2022-01-13,162634,9205,9205,141516,29438981,12399410,796669,,11602741,5251263
2022-01-14,159816,10743,10366,136017,29598797,12409792,797041,,11612751,5387082
2022-01-15,161172,11005,11665,135867,29759969,12420427,796370,,11624057,5522756
2022-01-16,109754,9283,9670,89446,29869723,12429349,795976,,11633373,5611985
2022-01-17,65764,5933,6560,52630,29935487,12434948,795339,,11639609,5664431
2022-01-18,36087,2002,2123,31139,29971574,12436595,795207,,11641388,5695374
2022-01-19,101289,5578,6711,85940,30072863,12441773,794056,,11647717,5781087
2022-01-20,103570,6322,6997,85716,30176433,12447711,793373,,11654338,5866580
2022-01-21,102072,6227,8051,82481,30278505,12453534,791535,,11661999,5948833
2022-01-22,102552,8710,12064,78101,30381057,12461855,788174,,11673681,6026706
2022-01-23,76671,7305,13984,54782,30457728,12468817,781488,,11687329,6081266
2022-01-24,42251,3193,7934,30735,30499979,12471646,776729,,11694917,6111794
2022-01-25,62551,3756,8363,48114,30562530,12475023,772107,,11702916,6159690
2022-01-26,77866,4912,13165,55682,30640396,12479558,763849,,11715709,6215130
2022-01-27,78053,4893,13244,56031,30718449,12484079,755488,,11728591,6270924
2022-01-28,77261,4671,13671,53879,30795710,12488392,746475,,11741917,6324584
2022-01-29,84793,5526,17702,58102,30880503,12493555,734292,,11759263,6382442
2022-01-30,66488,5024,20622,40148,30946991,12498237,718680,,11779557,6422365
2022-01-31,34734,2174,9876,22344,30981725,12500092,710969,,11789123,6444520
2022-02-01,51337,3267,9657,36518,31033062,12503006,704569,,11798437,6480813
2022-02-02,57692,3843,12388,38675,31090754,12506519,696009,,11810510,6519289
2022-02-03,52570,3610,11506,34296,31143324,12509752,688101,,11821651,6553334
2022-02-04,43069,2944,10555,27274,31186393,12512386,680480,,11831906,6580414
2022-02-05,58702,3737,14467,37559,31245095,12515791,669738,,11846053,6617760
2022-02-06,49852,3638,16113,29571,31294947,12519106,657258,,11861848,6647107
2022-02-07,23224,1690,7806,13436,31318171,12520470,651129,,11869341,6660319
2022-02-08,33369,2353,7238,21963,31351540,12522493,646237,,11876256,6682049
2022-02-09,38865,2781,8911,24406,31390405,12524916,640101,,11884815,6706203
2022-02-10,37524,2763,8830,22548,31427929,12527344,634030,,11893314,6728522
2022-02-11,39428,2719,10285,22999,31467357,12529717,626455,,11903262,6751283
2022-02-12,42030,2954,11451,25308,31509387,12532337,617947,,11914390,6776367
2022-02-13,36303,2800,13137,19938,31545690,12534850,607607,,11927243,6796107
2022-02-14,16963,1175,6115,9465,31562653,12535750,602659,,11933091,6805372
2022-02-15,19334,1382,4743,11870,31581987,12536809,599288,,11937521,6817015
2022-02-16,26008,1765,7724,14945,31607995,12538278,593325,,11944953,6831760
2022-02-17,26748,1681,7518,14980,31634743,12539604,587479,,11952125,6846485
2022-02-18,23928,1353,6604,13671,31658671,12540640,582216,,11958424,6859947
2022-02-19,37828,1902,8333,26050,31696499,12542211,575780,,11966431,6885756
2022-02-20,32562,1493,7959,22802,31729061,12543404,569306,,11974098,6908354
2022-02-21,17496,912,3676,12755,31746557,12544021,566533,,11977488,6920898
2022-02-22,9093,428,1546,6950,31755650,12544160,565410,,11978750,6927638
2022-02-23,25321,1327,4786,17289,31780971,12545177,561944,,11983233,6944691
2022-02-24,24557,1396,5233,15473,31805528,12546253,558103,,11988150,6959922
2022-02-25,23088,1386,5133,14503,31828616,12547345,554349,,11992996,6974199
2022-02-26,25217,1383,5907,16549,31853833,12548418,549818,,11998600,6990522
2022-02-27,26946,1369,7366,17697,31880779,12549518,543810,,12005708,7008024
2022-02-28,10125,593,2528,6744,31890904,12549858,541867,,12007991,7014585
2022-03-01,13181,943,3145,8161,31904085,12550496,539655,,12010841,7022529
2022-03-02,15406,1162,3575,9614,31919491,12551397,537235,,12014162,7031966
2022-03-03,14291,1076,3224,8686,31933782,12552162,535080,,12017082,7040421
2022-03-04,14462,989,3441,8313,31948244,12552830,532624,,12020206,7048481
2022-03-05,18525,1276,4996,11180,31966769,12553797,528893,,12024904,7059437
2022-03-06,16506,1087,5521,9602,31983275,12554605,524453,,12030152,7068832
2022-03-07,5943,464,1858,3509,31989218,12554784,523052,,12031732,7072124
2022-03-08,7351,697,1934,4158,31996569,12555203,521808,,12033395,7076083
2022-03-09,11150,906,2735,6402,32007719,12555833,519973,,12035860,7082283
2022-03-10,12750,1044,3251,6832,32020469,12556600,517759,,12038841,7088902
2022-03-11,12880,902,3405,6861,32033349,12557213,515248,,12041965,7095547
2022-03-12,14676,1045,4178,8309,32048025,12557986,512112,,12045874,7103652
2022-03-13,14740,1089,4997,8329,32062765,12558784,508200,,12050584,7111744
2022-03-14,6328,448,2227,3497,32069093,12558962,506418,,12052544,7115027
2022-03-15,10194,791,2623,5972,32079287,12559463,504574,,12054889,7120785
2022-03-16,13049,932,3660,6950,32092336,12560107,501843,,12058264,7127505
2022-03-17,13175,1045,3956,6754,32105511,12560865,498925,,12061940,7134040
2022-03-18,11899,911,3144,6430,32117410,12561474,496682,,12064792,7140247
2022-03-19,14432,1002,4159,7899,32131842,12562197,493523,,12068674,7147928
2022-03-20,11734,989,3952,6367,32143576,12562915,490555,,12072360,7154087
2022-03-21,5055,414,1589,2813,32148631,12563070,489376,,12073694,7156697
2022-03-22,6700,551,1556,3886,32155331,12563335,488366,,12074969,7160368
2022-03-23,9962,784,2296,5191,32165293,12563804,486851,,12076953,7165318
2022-03-24,9283,723,2374,4606,32174576,12564263,485191,,12079072,7169720
2022-03-25,9213,781,2151,4744,32183789,12564781,483813,,12080968,7174252
2022-03-26,10917,932,2831,5502,32194706,12565436,481912,,12083524,7179535
2022-03-27,10220,909,3536,5298,32204926,12566086,479281,,12086805,7184622
2022-03-28,3577,319,1107,1986,32208503,12566166,478490,,12087676,7186415
2022-03-29,5334,498,1208,2687,32213837,12566381,477774,,12088607,7188881
2022-03-30,7847,747,1833,4120,32221684,12566850,476683,,12090167,7192777
2022-03-31,8646,689,1924,4412,32230330,12567250,475442,,12091808,7196967
2022-04-01,9298,801,1911,4885,32239628,12567759,474323,,12093436,7201613
2022-04-02,10426,887,2208,5565,32250054,12568359,472990,,12095369,7206961
2022-04-03,9196,878,2567,5063,32259250,12568983,471295,,12097688,7211825
2022-04-04,4194,386,1005,2405,32263444,12569108,470673,,12098435,7214027
2022-04-05,6060,598,1033,3049,32269504,12569367,470232,,12099135,7216802
2022-04-06,8367,715,1478,4373,32277871,12569792,469464,,12100328,7220949
2022-04-07,10330,732,1683,4835,32288201,12570225,468508,,12101717,7225542
2022-04-08,23983,811,1578,4834,32312184,12570758,467735,,12103023,7230160
2022-04-09,30473,968,1972,5893,32342657,12571429,466722,,12104707,7235831
2022-04-10,24847,976,2386,5331,32367504,12572148,465306,,12106842,7240962
2022-04-11,12568,385,874,2432,32380072,12572284,464813,,12107471,7243193
2022-04-12,28105,691,1016,3533,32408177,12572673,464481,,12108192,7246494
2022-04-13,37769,851,1556,4926,32445946,12573225,463772,,12109453,7251190
2022-04-14,37881,761,1610,4909,32483827,12573675,462920,,12110755,7255847
2022-04-15,43393,1230,2101,6726,32527220,12574607,462045,,12112562,7262336
2022-04-16,8087,358,650,1736,32535307,12574705,461751,,12112954,7263856
2022-04-17,21004,870,1923,4314,32556311,12575291,460691,,12114600,7267947
2022-04-18,5456,305,462,1288,32561767,12575310,460529,,12114781,7268995
2022-04-19,22645,615,770,3101,32584412,12575644,460365,,12115279,7271877
2022-04-20,40322,1063,1393,4617,32624734,12576381,460032,,12116349,7276230
2022-04-21,38744,941,1601,4677,32663478,12577027,459364,,12117663,7280673
2022-04-22,35608,1011,1428,4263,32699086,12577764,458940,,12118824,7284716
2022-04-23,34638,1004,1732,4711,32733724,12578486,458209,,12120277,7289190
2022-04-24,20805,1022,1882,3777,32754529,12579258,457346,,12121912,7292773
2022-04-25,8299,453,691,1707,32762828,12579442,457107,,12122335,7294264
2022-04-26,24599,732,941,3136,32787427,12579882,456892,,12122990,7297163
2022-04-27,33590,955,1367,3933,32821017,12580562,456472,,12124090,7300880
2022-04-28,32827,927,1411,3928,32853844,12581216,455979,,12125237,7304585
2022-04-29,32047,1098,1375,3908,32885891,12582017,455695,,12126322,7308265
2022-04-30,30271,923,1533,4020,32916162,12582643,455078,,12127565,7312049
2022-05-01,16745,768,1576,2969,32932907,12583115,454265,,12128850,7314776
2022-05-02,5933,309,524,1097,32938840,12583128,454046,,12129082,7315646
2022-05-03,20920,588,828,2345,32959760,12583411,453800,,12129611,7317752
2022-05-04,29410,800,1091,3294,32989170,12583902,453504,,12130398,7320797
2022-05-05,29088,870,1160,3124,33018258,12584461,453204,,12131257,7323678
2022-05-06,29080,1146,1279,2981,33047338,12585320,453066,,12132254,7326433
2022-05-07,28482,868,1260,3111,33075820,12585898,452669,,12133229,7329320
2022-05-08,15996,896,1309,2322,33091816,12586537,452254,,12134283,7331441
2022-05-09,5896,292,474,943,33097712,12586564,452066,,12134498,7332175
2022-05-10,21218,695,717,2118,33118930,12586942,452037,,12134905,7334034
2022-05-11,28940,836,1079,2654,33147870,12587447,451790,,12135657,7336416
2022-05-12,28229,800,1081,2509,33176099,12587950,451505,,12136445,7338684
2022-05-13,27589,878,1116,2468,33203688,12588518,451263,,12137255,7340895
2022-05-14,25683,808,1096,2607,33229371,12589010,450968,,12138042,7343247
2022-05-15,14843,751,1273,2054,33244214,12589491,450439,,12139052,7345084
2022-05-16,6381,325,532,1047,33250595,12589579,450228,,12139351,7345945
2022-05-17,19592,584,775,1740,33270187,12589849,450030,,12139819,7347437
2022-05-18,26538,877,1097,2272,33296725,12590462,449805,,12140657,7349494
2022-05-19,24427,681,1155,2158,33321152,12590876,449324,,12141552,7351435
2022-05-20,24260,800,1136,2215,33345412,12591409,448984,,12142425,7353433
2022-05-21,22394,691,1165,2345,33367806,12591792,448501,,12143291,7355537
2022-05-22,10554,551,888,1485,33378360,12592082,448159,,12143923,7356805
2022-05-23,4560,241,462,784,33382920,12592065,447936,,12144129,7357381
2022-05-24,2609,118,176,431,33385529,12591930,447876,,12144054,7357603
2022-05-25,19353,656,945,1951,33404882,12592321,447577,,12144744,7359345
2022-05-26,20635,662,948,1908,33425517,12592710,447285,,12145425,7361031
2022-05-27,21749,816,1056,2073,33447266,12593240,447042,,12146198,7362873
2022-05-28,19396,722,1163,2144,33466662,12593693,446598,,12147095,7364804
2022-05-29,12105,759,1280,1725,33478767,12594217,446070,,12148147,7366337
2022-05-30,4578,311,548,751,33483345,12594282,445830,,12148452,7366890
2022-05-31,13544,572,749,1665,33496889,12594552,445647,,12148905,7368315
2022-06-01,16606,702,970,1876,33513495,12594950,445377,,12149573,7369937
2022-06-02,14593,556,864,1671,33528088,12595195,445062,,12150133,7371367
2022-06-03,16094,697,1093,1812,33544182,12595616,444660,,12150956,7372962
2022-06-04,13315,648,1162,1842,33557497,12596008,444142,,12151866,7374603
2022-06-05,7865,587,1109,1431,33565362,12596346,443616,,12152730,7375842
2022-06-06,3293,206,444,641,33568655,12596306,443375,,12152931,7376284
2022-06-07,11209,474,725,1367,33579864,12596481,443119,,12153362,7377407
2022-06-08,14054,666,1012,1608,33593918,12596889,442768,,12154121,7378797
2022-06-09,13367,662,921,1673,33607285,12597263,442504,,12154759,7380238
2022-06-10,13844,684,1066,1693,33621129,12597661,442114,,12155547,7381701
2022-06-11,12975,613,1031,1863,33634104,12597989,441694,,12156295,7383342
2022-06-12,8093,644,1236,1499,33642197,12598377,441098,,12157279,7384636
2022-06-13,3186,284,422,709,33645383,12598396,440955,,12157441,7385137
2022-06-14,10124,511,666,1262,33655507,12598618,440794,,12157824,7386161
2022-06-15,13498,470,828,1620,33669005,12598796,440434,,12158362,7387546
2022-06-16,12533,492,855,1616,33681538,12598984,440066,,12158918,7388916
2022-06-17,11686,479,815,1652,33693224,12599178,439723,,12159455,7390334
2022-06-18,11441,435,873,1859,33704665,12599344,439282,,12160062,7391970
2022-06-19,6998,482,896,1420,33711663,12599579,438867,,12160712,7393181
2022-06-20,2286,147,301,643,33713949,12599506,438707,,12160799,7393656
2022-06-21,9537,358,614,1381,33723486,12599577,438446,,12161131,7394789
2022-06-22,13606,406,724,1702,33737092,12599711,438121,,12161590,7396266
2022-06-23,13693,400,772,1680,33750785,12599849,437746,,12162103,7397735
2022-06-24,15359,435,811,1670,33766144,12600026,437366,,12162660,7399191
2022-06-25,14464,424,851,1711,33780608,12600192,436928,,12163264,7400696
2022-06-26,8156,432,885,1280,33788764,12600366,436468,,12163898,7401762
2022-06-27,3210,171,363,593,33791974,12600289,436272,,12164017,7402149
2022-06-28,9613,370,555,1222,33801587,12600374,436083,,12164291,7403139
2022-06-29,13302,412,727,1628,33814889,12600497,435766,,12164731,7404528
2022-06-30,12222,482,845,1575,33827111,12600696,435401,,12165295,7405871
2022-07-01,13033,548,969,1946,33840144,12600989,434975,,12166014,7407612
2022-07-02,1609,110,115,362,33841753,12600823,434968,,12165855,7407742
2022-07-03,5157,261,492,958,33846910,12600829,434728,,12166101,7408486
2022-07-04,2756,131,279,614,33849666,12600715,434579,,12166136,7408905
2022-07-05,11139,372,598,1572,33860805,12600793,434345,,12166448,7410232
2022-07-06,15951,545,855,2007,33876756,12601044,434029,,12167015,7411998
2022-07-07,15655,521,831,1921,33892411,12601278,433718,,12167560,7413667
2022-07-08,17873,552,870,2242,33910284,12601527,433399,,12168128,7415661
2022-07-09,14132,449,596,1841,33924416,12601703,433251,,12168452,7417269
2022-07-10,8738,472,752,1500,33933154,12601930,432970,,12168960,7418565
2022-07-11,4093,199,331,870,33937247,12601865,432835,,12169030,7419216
2022-07-12,12101,413,522,1653,33949348,12601980,432721,,12169259,7420616
2022-07-13,16708,562,770,2141,33966056,12602248,432507,,12169741,7422516
2022-07-14,16854,486,674,2021,33982910,12602430,432308,,12170122,7424299
2022-07-15,28885,600,822,2179,34011795,12602731,432085,,12170646,7426238
2022-07-16,30283,583,771,2323,34042078,12603003,431889,,12171114,7428311
2022-07-17,22917,537,635,1880,34064995,12603304,431788,,12171516,7429998
2022-07-18,11387,187,254,852,34076382,12603223,431716,,12171507,7430628
2022-07-19,28943,593,590,2131,34105325,12603544,431716,,12171828,7432529
2022-07-20,37621,841,922,2584,34142946,12604108,431630,,12172478,7434878
2022-07-21,36343,733,808,2802,34179289,12604557,431548,,12173009,7437443
2022-07-22,35791,826,888,2681,34215080,12605099,431480,,12173619,7439889
2022-07-23,35133,819,913,2824,34250213,12605607,431378,,12174229,7442459
2022-07-24,21727,602,804,1768,34271940,12605948,431173,,12174775,7444004
2022-07-25,11930,308,310,1080,34283870,12605976,431166,,12174810,7444857
2022-07-26,26082,621,600,2207,34309952,12606316,431186,,12175130,7446822
2022-07-27,32459,810,844,2646,34342411,12606871,431150,,12175721,7449260
2022-07-28,31531,726,884,2601,34373942,12607304,430988,,12176316,7451614
2022-07-29,29985,1791,874,2640,34403927,12608805,431901,,12176904,7454005
2022-07-30,25819,2524,745,2431,34429746,12611056,433678,,12177378,7456209
2022-07-31,14289,1069,540,1559,34444035,12611860,434203,,12177657,7457543
2022-08-01,5910,335,223,681,34449945,12611937,434313,,12177624,7458001
2022-08-02,4472,305,135,599,34454417,12611972,434479,,12177493,7458378
2022-08-03,22927,2635,736,2234,34477344,12614335,436374,,12177961,7460380
2022-08-04,22221,2479,676,2128,34499565,12616490,438171,,12178319,7462247
2022-08-05,21787,2755,742,2063,34521352,12618966,440176,,12178790,7464084
2022-08-06,19640,2877,657,1990,34540992,12621535,442390,,12179145,7465819
2022-08-07,12694,2236,618,1415,34553686,12623499,444002,,12179497,7467019
2022-08-08,4764,570,188,603,34558450,12623787,444377,,12179410,7467390
2022-08-09,14000,1464,555,1588,34572450,12624967,445280,,12179687,7468739
2022-08-10,19119,2363,716,1987,34591569,12627058,446925,,12180133,7470499
2022-08-11,17072,2044,718,1849,34608641,12628829,448249,,12180580,7472118
2022-08-12,16977,2049,733,1849,34625618,12630592,449564,,12181028,7473740
2022-08-13,15940,2222,759,1803,34641558,12632535,451025,,12181510,7475307
2022-08-14,9521,1621,618,1079,34651079,12633869,452024,,12181845,7476152
2022-08-15,3867,388,268,476,34654946,12634007,452141,,12181866,7476422
2022-08-16,10800,1073,514,1355,34665746,12634783,452698,,12182085,7477529
2022-08-17,16089,1832,737,1778,34681835,12636329,453792,,12182537,7479072
2022-08-18,14919,1639,747,1685,34696754,12637647,454680,,12182967,7480489
2022-08-19,15302,1847,747,1542,34712056,12639220,455776,,12183444,7481799
2022-08-20,14276,1640,739,1543,34726332,12640572,456671,,12183901,7483105
2022-08-21,9894,1533,658,1162,34736226,12641845,457542,,12184303,7484054
2022-08-22,4161,481,269,561,34740387,12642030,457751,,12184279,7484362
2022-08-23,11126,1248,553,1491,34751513,12642973,458443,,12184530,7485601
2022-08-24,14749,1806,868,2184,34766262,12644511,459381,,12185130,7487557
2022-08-25,14026,1719,780,2119,34780288,12645946,460313,,12185633,7489434
2022-08-26,13923,1688,815,2089,34794211,12647345,461179,,12186166,7491278
2022-08-27,12409,1484,877,1996,34806620,12648506,461780,,12186726,7493010
2022-08-28,7920,1258,619,1396,34814540,12649510,462417,,12187093,7494191
2022-08-29,3394,504,283,681,34817934,12649742,462633,,12187109,7494646
2022-08-30,9902,1169,649,1853,34827836,12650558,463147,,12187411,7496200
2022-08-31,13505,1626,944,2310,34841341,12651901,463825,,12188076,7498273
2022-09-01,12898,1720,910,2138,34854239,12653330,464631,,12188699,7500169
2022-09-02,15038,1614,990,4918,34869277,12654675,465247,,12189428,7504867
2022-09-03,14707,1526,919,5512,34883984,12655930,465851,,12190079,7510154
2022-09-04,8660,1010,675,3234,34892644,12656684,466178,,12190506,7513172
2022-09-05,3549,321,229,1382,34896193,12656744,466267,,12190477,7514334
2022-09-06,2459,157,113,1126,34898652,12656655,466308,,12190347,7515257
2022-09-07,10919,1018,587,3490,34909571,12657383,466737,,12190646,7518501
2022-09-08,10863,1021,523,2790,34920434,12658083,467232,,12190851,7521021
2022-09-09,9579,1014,487,2500,34930013,12658812,467754,,12191058,7523288
2022-09-10,10628,1266,551,3162,34940641,12659808,468463,,12191345,7526222
2022-09-11,9400,983,667,3732,34950041,12660548,468773,,12191775,7529749
2022-09-12,3124,295,203,1079,34953165,12660567,468859,,12191708,7530596
2022-09-13,6009,542,281,1130,34959174,12660832,469111,,12191721,7531492
2022-09-14,14474,799,430,1843,34973648,12661323,469476,,12191847,7533077
2022-09-15,15741,780,408,1533,34989389,12661791,469844,,12191947,7534345
2022-09-16,17746,766,445,1690,35007135,12662305,470159,,12192146,7535820
2022-09-17,17604,723,456,1664,35024739,12662733,470422,,12192311,7537236
2022-09-18,11207,776,451,1684,35035946,12663255,470745,,12192510,7538703
2022-09-19,4976,402,288,670,35040922,12663395,470856,,12192539,7539163
2022-09-20,13749,438,327,941,35054671,12663526,470965,,12192561,7539844
2022-09-21,23021,643,406,1496,35077692,12663878,471197,,12192681,7541099
2022-09-22,22897,640,394,1377,35100589,12664220,471437,,12192783,7542221
2022-09-23,22933,726,599,1415,35123522,12664656,471560,,12193096,7543390
2022-09-24,21673,733,689,1497,35145195,12665100,471600,,12193500,7544654
2022-09-25,11310,595,702,1355,35156505,12665423,471488,,12193935,7545780
2022-09-26,4561,192,218,594,35161066,12665334,471456,,12193878,7546135
2022-09-27,37644,499,364,1498,35198710,12665573,471587,,12193986,7547413
2022-09-28,50952,730,670,1901,35249662,12666045,471646,,12194399,7549098
2022-09-29,47989,637,739,1835,35297651,12666374,471537,,12194837,7550666
2022-09-30,47264,679,806,2000,35344915,12666734,471408,,12195326,7552392
2022-10-01,34431,527,632,1545,35379346,12666963,471301,,12195662,7553680
2022-10-02,24234,738,1023,1710,35403580,12667419,471013,,12196406,7555148
2022-10-03,10861,239,231,610,35414441,12667379,471017,,12196362,7555530
2022-10-04,32178,478,458,1168,35446619,12667548,471033,,12196515,7556432
2022-10-05,40415,624,739,1559,35487034,12667871,470913,,12196958,7557739
2022-10-06,38675,609,652,1567,35525709,12668191,470868,,12197323,7559056
2022-10-07,42226,660,849,1743,35567935,12668519,470672,,12197847,7560509
2022-10-08,37379,787,1145,2119,35605314,12668997,470308,,12198689,7562371
2022-10-09,18811,549,727,1557,35624125,12669285,470127,,12199158,7563706
2022-10-10,6861,170,370,568,35630986,12669172,469925,,12199247,7564028
2022-10-11,4986,124,111,318,35635972,12669018,469933,,12199085,7564116
2022-10-12,35095,581,682,1425,35671067,12669279,469830,,12199449,7565265
2022-10-13,36748,644,857,1621,35707815,12669580,469615,,12199965,7566594
2022-10-14,36956,622,752,1539,35744771,12669889,469482,,12200407,7567865
2022-10-15,35440,716,1009,1624,35780211,12670337,469186,,12201151,7569261
2022-10-16,20660,654,1024,1594,35800871,12670737,468810,,12201927,7570635
2022-10-17,7349,206,477,538,35808220,12670673,468538,,12202135,7570943
2022-10-18,36409,459,498,1397,35844629,12670825,468495,,12202330,7572078
2022-10-19,49873,620,729,1982,35894502,12671156,468383,,12202773,7573819
2022-10-20,51261,623,648,2047,35945763,12671482,468356,,12203126,7575615
2022-10-21,52834,699,618,1938,35998597,12671870,468434,,12203436,7577294
2022-10-22,50850,752,905,2305,36049447,12672305,468276,,12204029,7579333
2022-10-23,30621,578,782,2118,36080068,12672584,468068,,12204516,7581197
2022-10-24,14129,232,270,979,36094197,12672532,468025,,12204507,7581931
2022-10-25,41338,473,487,1815,36135535,12672682,468009,,12204673,7583471
2022-10-26,51614,618,660,2122,36187149,12672981,467963,,12205018,7585325
2022-10-27,50090,610,768,2161,36237239,12673281,467799,,12205482,7587227
2022-10-28,49753,591,673,2092,36286992,12673533,467714,,12205819,7589025
2022-10-29,50578,738,778,2217,36337570,12673945,467670,,12206275,7590962
2022-10-30,28385,663,930,2034,36365955,12674351,467401,,12206950,7592770
2022-10-31,12436,200,234,776,36378391,12674295,467364,,12206931,7593330
2022-11-01,33064,342,196,1219,36411455,12674311,467504,,12206807,7594273
2022-11-02,44265,575,622,1904,36455720,12674580,467455,,12207125,7595899
2022-11-03,44171,540,604,1856,36499891,12674822,467388,,12207434,7597495
2022-11-04,44621,652,527,2022,36544512,12675192,467507,,12207685,7599280
2022-11-05,45188,648,755,2368,36589700,12675566,467397,,12208169,7601405
2022-11-06,26011,560,771,2095,36615711,12675809,467184,,12208625,7603224
2022-11-07,10710,243,235,876,36626421,12675804,467189,,12208615,7603894
2022-11-08,33462,488,395,1584,36659883,12676026,467279,,12208747,7605253
2022-11-09,40519,605,569,1965,36700402,12676347,467314,,12209033,7606977
2022-11-10,39153,626,547,1924,36739555,12676687,467390,,12209297,7608652
2022-11-11,43321,637,641,2205,36782876,12677042,467385,,12209657,7610614
2022-11-12,36830,640,592,2185,36819706,12677381,467425,,12209956,7612537
2022-11-13,24256,560,770,2274,36843962,12677676,467210,,12210466,7614584
2022-11-14,10961,233,204,1023,36854923,12677644,467238,,12210406,7615374
2022-11-15,33579,485,379,1690,36888502,12677802,467340,,12210462,7616787
2022-11-16,43516,802,581,2368,36932018,12678340,467558,,12210782,7618931
2022-11-17,38314,674,646,2241,36970332,12678699,467582,,12211117,7620904
2022-11-18,40599,725,530,2326,37010931,12679108,467773,,12211335,7622954
2022-11-19,39638,1015,1030,3076,37050569,12679813,467754,,12212059,7625757
2022-11-20,22409,663,716,2440,37072978,12680240,467700,,12212540,7627999
2022-11-21,8918,197,192,970,37081896,12680202,467701,,12212501,7628783
2022-11-22,26429,480,368,1512,37108325,12680371,467810,,12212561,7630022
2022-11-23,32052,686,666,2069,37140377,12680761,467828,,12212933,7631838
2022-11-24,31888,664,750,2080,37172265,12681145,467741,,12213404,7633680
2022-11-25,30743,765,829,1948,37203008,12681639,467671,,12213968,7635401
2022-11-26,30268,913,1190,2694,37233276,12682253,467387,,12214866,7637835
2022-11-27,18670,611,944,2087,37251946,12682599,467050,,12215549,7639691
2022-11-28,7535,191,280,786,37259481,12682528,466956,,12215572,7640243
2022-11-29,21013,421,451,1291,37280494,12682671,466923,,12215748,7641291
2022-11-30,27876,645,646,1840,37308370,12683042,466920,,12216122,7642892
2022-12-01,24790,594,681,1689,37333160,12683357,466831,,12216526,7644338
2022-12-02,25044,524,630,1771,37358204,12683601,466719,,12216882,7645863
2022-12-03,25537,588,779,1944,37383741,12683914,466521,,12217393,7647585
2022-12-04,15245,499,606,1699,37398986,12684131,466410,,12217721,7649032
2022-12-05,6869,168,156,743,37405855,12684048,466417,,12217631,7649560
2022-12-06,20332,421,351,1375,37426187,12684162,466486,,12217676,7650669
2022-12-07,24752,554,609,1667,37450939,12684463,466429,,12218034,7652116
2022-12-08,23147,563,523,1760,37474086,12684768,466468,,12218300,7653646
2022-12-09,23315,636,575,1631,37497401,12685141,466528,,12218613,7655054
2022-12-10,22564,512,601,1626,37519965,12685409,466438,,12218971,7656466
2022-12-11,14197,551,785,1567,37534162,12685755,466202,,12219553,7657851
2022-12-12,5506,150,157,593,37539668,12685673,466191,,12219482,7658250
2022-12-13,17784,378,367,1125,37557452,12685789,466202,,12219587,7659148
2022-12-14,21308,511,547,1451,37578760,12686089,466162,,12219927,7660412
2022-12-15,21948,530,600,1578,37600708,12686351,466091,,12220260,7661757
2022-12-16,16271,378,450,1030,37616979,12686476,466019,,12220457,7662570
2022-12-17,18686,559,505,1272,37635665,12686787,466072,,12220715,7663611
2022-12-18,12633,530,794,1303,37648298,12687093,465807,,12221286,7664711
2022-12-19,4585,133,115,448,37652883,12686972,465821,,12221151,7664932
2022-12-20,16200,501,449,1105,37669083,12687232,465870,,12221362,7665826
2022-12-21,18457,546,548,1298,37687540,12687552,465865,,12221687,7666923
2022-12-22,18582,577,587,1741,37706122,12687902,465855,,12222047,7668464
2022-12-23,15628,580,597,1713,37721750,12688206,465833,,12222373,7669946
2022-12-24,5328,222,171,671,37727078,12688188,465884,,12222304,7670398
2022-12-25,2441,153,152,480,37729519,12688108,465878,,12222230,7670674
2022-12-26,262,12,7,48,37729781,12687886,465879,,12222007,7670515
2022-12-27,2089,99,35,303,37731870,12687785,465941,,12221844,7670642
2022-12-28,8313,336,167,975,37740183,12687873,466108,,12221765,7671393
2022-12-29,13153,584,524,1601,37753336,12688212,466165,,12222047,7672778
2022-12-30,15811,671,658,1876,37769147,12688642,466175,,12222467,7674438
2022-12-31,11224,462,387,1353,37780371,12688828,466246,,12222582,7675547
2023-01-01,3906,204,219,561,37784277,12688796,466231,,12222565,7675900
2023-01-02,652,37,15,96,37784929,12688619,466253,,12222366,7675806
2023-01-03,8185,300,152,896,37793114,12688694,466396,,12222298,7676513
2023-01-04,14708,576,547,1544,37807822,12689051,466419,,12222632,7677865
2023-01-05,16100,656,533,1790,37823922,12689468,466539,,12222929,7679445
2023-01-06,18813,718,607,2043,37842735,12689968,466647,,12223321,7681293
2023-01-07,18504,708,638,2052,37861239,12690454,466714,,12223740,7683149
2023-01-08,11609,582,608,1630,37872848,12690839,466687,,12224152,7684602
2023-01-09,5296,216,196,664,37878144,12690836,466705,,12224131,7685076
2023-01-10,12155,421,315,780,37890299,12691022,466811,,12224211,7685645
2023-01-11,15534,459,370,1092,37905833,12691243,466898,,12224345,7686529
2023-01-12,14054,455,407,971,37919887,12691456,466945,,12224511,7687285
2023-01-13,14156,426,345,1033,37934043,12691693,467025,,12224668,7688143
2023-01-14,13357,479,452,1075,37947400,12691956,467049,,12224907,7689021
2023-01-15,9039,465,506,1049,37956439,12692222,467007,,12225215,7689900
2023-01-16,3744,148,130,479,37960183,12692158,467025,,12225133,7690185
2023-01-17,8842,271,179,651,37969025,12692165,467117,,12225048,7690610
2023-01-18,10237,352,273,756,37979262,12692297,467196,,12225101,7691163
2023-01-19,10566,318,318,760,37989828,12692387,467192,,12225195,7691725
2023-01-20,9821,321,272,714,37999649,12692495,467240,,12225255,7692244
2023-01-21,11301,358,398,905,38010950,12692646,467200,,12225446,7692970
2023-01-22,7564,346,404,816,38018514,12692786,467140,,12225646,7693595
2023-01-23,3376,144,131,288,38021890,12692753,467153,,12225600,7693728
2023-01-24,8276,228,165,547,38030166,12692750,467214,,12225536,7694073
2023-01-25,10306,349,296,660,38040472,12692893,467266,,12225627,7694552
2023-01-26,6720,236,203,469,38047192,12692919,467299,,12225620,7694842
2023-01-27,6900,242,197,490,38054092,12692945,467343,,12225602,7695146
2023-01-28,9328,312,337,692,38063420,12693043,467314,,12225729,7695650
2023-01-29,5955,235,341,689,38069375,12693073,467204,,12225869,7696154
2023-01-30,1897,90,79,215,38071272,12692971,467213,,12225758,7696195
2023-01-31,5866,157,150,411,38077138,12692911,467219,,12225692,7696409
2023-02-01,7288,252,248,488,38084426,12692982,467223,,12225759,7696739
2023-02-02,6461,294,239,499,38090887,12693107,467276,,12225831,7697098
2023-02-03,6539,197,191,462,38097426,12693127,467281,,12225846,7697402
2023-02-04,6704,230,305,539,38104130,12693188,467201,,12225987,7697797
2023-02-05,4173,199,290,483,38108303,12693200,467109,,12226091,7698124
2023-02-06,1834,91,98,211,38110137,12693101,467100,,12226001,7698160
2023-02-07,4956,162,181,383,38115093,12693066,467079,,12225987,7698374
2023-02-08,5766,214,206,429,38120859,12693120,467086,,12226034,7698658
2023-02-09,6110,215,243,437,38126969,12693175,467058,,12226117,7698958
2023-02-10,5071,159,205,368,38132040,12693205,467010,,12226195,7699210
2023-02-11,6032,183,256,455,38138072,12693214,466933,,12226281,7699506
2023-02-12,4071,215,342,408,38142143,12693272,466803,,12226469,7699769
2023-02-13,1480,56,87,146,38143623,12693186,466772,,12226414,7699794
2023-02-14,3932,131,178,308,38147555,12693139,466724,,12226415,7699944
2023-02-15,4537,119,191,285,38152092,12693101,466652,,12226449,7700086
2023-02-16,4911,174,285,399,38157003,12693118,466540,,12226578,7700344
2023-02-17,4974,180,210,342,38161977,12693163,466509,,12226654,7700565
2023-02-18,5103,230,295,486,38167080,12693242,466442,,12226800,7700919
2023-02-19,3349,133,244,373,38170429,12693231,466330,,12226901,7701172
2023-02-20,1416,62,54,157,38171845,12693167,466336,,12226831,7701223
2023-02-21,911,25,14,106,38172756,12693090,466347,,12226743,7701235
2023-02-22,4124,131,213,367,38176880,12693092,466261,,12226831,7701494
2023-02-23,4250,163,231,389,38181130,12693108,466187,,12226921,7701754
2023-02-24,3024,138,229,273,38184154,12693127,466094,,12227033,7701917
2023-02-25,5008,213,539,384,38189162,12693221,465768,,12227453,7702200
2023-02-26,3472,146,681,384,38192634,12693250,465233,,12228017,7702486
2023-02-27,1064,36,56,97,38193698,12693176,465210,,12227966,7702491
2023-02-28,2713,97,163,231,38196411,12693125,465142,,12227983,7702590
2023-03-01,3843,138,427,332,38200254,12693124,464852,,12228272,7702793
2023-03-02,4567,160,494,323,38204821,12693162,464518,,12228644,7703017
2023-03-03,4354,160,356,332,38209175,12693208,464320,,12228888,7703244
2023-03-04,4946,206,621,346,38214121,12693311,463904,,12229407,7703498
2023-03-05,2531,110,448,251,38216652,12693337,463565,,12229772,7703675
2023-03-06,1157,53,37,114,38217809,12693304,463579,,12229725,7703712
2023-03-07,3176,92,171,218,38220985,12693286,463498,,12229788,7703835
2023-03-08,4287,131,412,282,38225272,12693340,463217,,12230123,7704048
2023-03-09,4587,169,451,310,38229859,12693435,462932,,12230503,7704295
2023-03-10,3884,105,136,253,38233743,12693483,462901,,12230582,7704498
2023-03-11,4007,144,161,278,38237750,12693575,462884,,12230691,7704729
2023-03-12,2853,111,232,294,38240603,12693646,462762,,12230884,7704987
2023-03-13,849,32,32,103,38241452,12693654,462761,,12230893,7705072
2023-03-14,3012,100,107,249,38244464,12693747,462754,,12230993,7705314
2023-03-15,4010,146,160,299,38248474,12693893,462740,,12231153,7705613
2023-03-16,3769,173,231,255,38252243,12694066,462682,,12231384,7705868
