"report_date","previous_day_total_doses_administered","previous_day_at_least_one","previous_day_fully_vaccinated","previous_day_3doses","total_doses_administered","total_individuals_at_least_one","total_individuals_partially_vaccinated","total_doses_in_fully_vaccinated_individuals","total_individuals_fully_vaccinated","total_individuals_3doses"
2021-01-01,6252,6242,2,,32208,32153,32142,22,11,
2021-01-02,4614,4602,6,,36822,36703,36690,26,13,
2021-01-03,5395,5388,3,,42217,42091,42075,32,16,
2021-01-04,5995,5993,0,,48212,48083,48068,30,15,
2021-01-05,9687,9662,21,,57899,57743,57708,70,35,
2021-01-06,12793,12328,450,,70692,70068,69586,964,482,
2021-01-07,16219,15508,697,,86911,85575,84396,2358,1179,
2021-01-08,18038,17023,1002,,104949,102598,100417,4362,2181,
2021-01-09,19500,18423,1064,,124449,121020,117775,6490,3245,
2021-01-10,11372,11332,38,,135821,132344,129061,6566,3283,
2021-01-11,11712,11661,48,,147533,144005,140674,6662,3331,
2021-01-12,14467,14160,298,,162000,158157,154528,7258,3629,
2021-01-13,15437,13813,1594,,177437,171956,166735,10442,5221,
2021-01-14,19192,16740,2436,,196629,188690,181034,15312,7656,
2021-01-15,20075,18017,2038,,216704,206696,197002,19388,9694,
2021-01-16,17119,15935,1171,,233823,222615,211750,21730,10865,
2021-01-17,11259,10015,1237,,245082,232615,220515,24200,12100,
2021-01-18,6794,6712,72,,251876,239304,227135,24338,12169,
2021-01-19,11829,9721,2094,,263705,249004,234741,28526,14263,
2021-01-20,10804,7215,3572,,274509,256196,238362,35668,17834,
2021-01-21,10975,6855,4092,,285484,263035,241109,43852,21926,
2021-01-22,9038,4321,4697,,294522,267319,240698,53242,26621,
2021-01-23,7461,3044,4389,,301983,270333,239324,62018,31009,
2021-01-24,4386,1829,2536,,306369,272144,238599,67090,33545,
2021-01-25,5322,1049,4264,,311691,273161,235353,75616,37808,
2021-01-26,9394,2867,6499,,321085,275996,231690,88612,44306,
2021-01-27,9898,2866,7004,,330983,278833,227524,102618,51309,
2021-01-28,13120,5743,7335,,344103,284543,225899,117288,58644,
2021-01-29,10698,3285,7379,,354801,287797,221775,132044,66022,
2021-01-30,9191,2730,6424,,363992,290485,218042,144886,72443,
2021-01-31,3383,1570,1768,,367375,292021,217811,148420,74210,
2021-02-01,2124,487,1609,,369499,292474,216659,151630,75815,
2021-02-02,4416,1363,2996,,373915,293799,214992,157614,78807,
2021-02-03,6237,1717,4458,,380152,295475,212217,166516,83258,
2021-02-04,9085,1714,7292,,389237,297146,206602,181088,90544,
2021-02-05,8446,1468,6904,,397683,298574,201132,194884,97442,
2021-02-06,10667,1870,8737,,408350,300389,194219,212340,106170,
2021-02-07,7576,1729,5796,,415926,302078,190124,223908,111954,
2021-02-08,8221,3096,5081,,424147,305126,188104,234044,117022,
2021-02-09,15010,3860,11082,,439157,308944,180856,256176,128088,
2021-02-10,15511,4932,10518,,454668,313824,175243,277162,138581,
2021-02-11,16366,3899,12409,,471034,317671,166712,301918,150959,
2021-02-12,17676,2098,15527,,488710,319730,153264,332932,166466,
2021-02-13,16213,2446,13752,,504923,322131,141932,360398,180199,
2021-02-14,12881,924,11925,,517804,323007,130913,384188,192094,
2021-02-15,7862,486,7328,,525666,323445,124049,398792,199396,
2021-02-16,5995,1042,4903,,531661,324444,120168,408552,204276,
2021-02-17,10168,1609,8525,,541829,326009,113236,425546,212773,
2021-02-18,13870,2955,10871,,555699,328916,105302,447228,223614,
2021-02-19,18490,6213,12210,,574189,335077,99284,471586,235793,
2021-02-20,22630,11133,11444,,596819,346147,98948,494398,247199,
2021-02-21,17241,10385,6822,,614060,356472,102493,507958,253979,
2021-02-22,13586,8759,4775,,627646,365162,106457,517410,258705,
2021-02-23,17868,11126,6671,,645514,376232,110892,530680,265340,
2021-02-24,18576,13611,4884,,664090,389787,119605,540364,270182,
2021-02-25,20810,16489,4264,,684900,406210,131812,548796,274398,
2021-02-26,24901,21836,3004,,709801,427986,150621,554730,277365,
2021-02-27,27465,23582,3840,,737266,451504,170347,562314,281157,
2021-02-28,20585,19144,1406,,757851,470594,188073,565042,282521,
2021-03-01,18227,17030,1148,,776078,487562,203940,567244,283622,
2021-03-02,24691,22280,2326,,800769,509781,223879,571804,285902,
2021-03-03,30597,27965,2578,,831366,537695,249248,576894,288447,
2021-03-04,34694,32462,2146,,866060,570091,279548,581086,290543,
2021-03-05,40001,38167,1785,,906061,608210,315916,584588,292294,
2021-03-06,44156,41948,2170,,950217,650103,355680,588846,294423,
2021-03-07,32734,31555,1175,,982951,681584,386044,591080,295540,
2021-03-08,24038,22162,1861,,1006989,703678,406331,594694,297347,
2021-03-09,33295,29844,3423,,1040284,733456,432732,601448,300724,
2021-03-10,38346,34083,4218,,1078630,767465,462571,609788,304894,
2021-03-11,43981,40708,3234,,1122611,808107,500031,616152,308076,
2021-03-12,47713,46001,1689,,1170324,854044,544329,619430,309715,
2021-03-13,57934,55058,2849,,1228258,909031,596521,625020,312510,
2021-03-14,43419,42179,1222,,1271677,951127,637463,627328,313664,
2021-03-15,32814,31116,1682,,1304491,982184,666881,630606,315303,
2021-03-16,53958,51659,2282,,1358449,1033778,716236,635084,317542,
2021-03-17,61066,58525,2497,,1419515,1092237,772248,639978,319989,
2021-03-18,61553,59095,2430,,1481068,1151260,828894,644732,322366,
2021-03-19,64476,61144,3274,,1545544,1212326,886739,651174,325587,
2021-03-20,62569,59979,2559,,1608113,1272249,944151,656196,328098,
2021-03-21,44004,42478,1539,,1652117,1314662,985062,659200,329600,
2021-03-22,31002,30035,978,,1683119,1344609,1014087,661044,330522,
2021-03-23,54623,51849,2723,,1737742,1396363,1063181,666364,333182,
2021-03-24,76434,73253,3133,,1814176,1469526,1133268,672516,336258,
2021-03-25,82916,80335,2534,,1897092,1549782,1211047,677470,338735,
2021-03-26,87016,83486,3490,,1984108,1633187,1291014,684346,342173,
2021-03-27,80864,77910,2868,,2064972,1710994,1366018,689952,344976,
2021-03-28,66998,65408,1555,,2131970,1776312,1429838,692948,346474,
2021-03-29,51740,49050,2651,,2183710,1825282,1476203,698158,349079,
2021-03-30,73586,70174,3350,,2257296,1895379,1542991,704776,352388,
2021-03-31,93154,89502,3586,,2350450,1984783,1628862,711842,355921,
2021-04-01,89320,85441,3840,,2439770,2070126,1710418,719416,359708,
2021-04-02,93088,88862,4210,,2532858,2158902,1795036,727732,363866,
2021-04-03,61009,59329,1736,,2593867,2218140,1852589,731102,365551,
2021-04-04,72330,70677,1650,,2666197,2288706,1921563,734286,367143,
2021-04-05,53731,53260,470,,2719928,2341882,1974317,735130,367565,
2021-04-06,79581,77713,1887,,2799509,2419493,2050095,738796,369398,
2021-04-07,108010,104944,3055,,2907519,2524312,2151917,744790,372395,
2021-04-08,114079,110105,4028,,3021598,2634306,2257939,752734,376367,
2021-04-09,109853,105624,4300,,3131451,2739812,2359210,761204,380602,
2021-04-10,109243,105481,3852,,3240694,2845165,2460777,768776,384388,
2021-04-11,98629,95511,3259,,3339323,2940551,2552963,775176,387588,
2021-04-12,76068,75004,1157,,3415391,3015407,2626730,777354,388677,
2021-04-13,99474,96090,3401,,3514865,3111388,2719358,784060,392030,
2021-04-14,117050,113285,3650,,3631915,3224555,2828915,791280,395640,
2021-04-15,113559,109503,3898,,3745474,3333932,2934451,798962,399481,
2021-04-16,118090,113716,4194,,3863564,3447538,3043907,807262,403631,
2021-04-17,112421,107830,4451,,3975985,3555234,3147211,816046,408023,
2021-04-18,88747,86510,2102,,4064732,3641621,3231550,820142,410071,
2021-04-19,68976,67441,1453,,4133708,3708932,3297459,822946,411473,
2021-04-20,102112,98788,3119,,4235820,3807558,3393031,829054,414527,
2021-04-21,142049,137771,4042,,4377869,3945155,3526654,837002,418501,
2021-04-22,139505,135352,3911,,4517374,4080378,3658022,844712,422356,
2021-04-23,138220,131798,6174,,4655594,4212022,3783550,856944,428472,
2021-04-24,130295,126232,3888,,4785889,4338106,3905802,864608,432304,
2021-04-25,102019,98608,3179,,4887908,4436566,4001150,870832,435416,
2021-04-26,71007,69301,1558,,4958915,4505736,4068822,873828,436914,
2021-04-27,98514,95424,2897,,5057429,4600999,4161251,879496,439748,
2021-04-28,120581,115954,4434,,5178010,4716785,4272675,888220,444110,
2021-04-29,124487,119291,5047,,5302497,4835909,4386821,898176,449088,
2021-04-30,115825,110568,5015,,5418322,4946304,4492278,908052,454026,
2021-05-01,111305,107433,3651,,5529627,5053556,4595956,915200,457600,
2021-05-02,79144,76168,2863,,5608771,5129567,4669170,920794,460397,
2021-05-03,56793,55123,1597,,5665564,5184535,4722601,923868,461934,
2021-05-04,91933,88563,3282,,5757497,5272920,4807781,930278,465139,
2021-05-05,138003,133295,4620,,5895500,5406046,4936350,939392,469696,
2021-05-06,141838,136882,4817,,6037338,5542744,5068293,948902,474451,
2021-05-07,150289,145247,4837,,6187627,5687831,5208602,958458,479229,
2021-05-08,142470,137779,4440,,6330097,5825415,5341825,967180,483590,
2021-05-09,124812,121162,3481,,6454909,5946413,5459406,974014,487007,
2021-05-10,97808,95823,1881,,6552717,6042047,5553226,977642,488821,
2021-05-11,113540,108858,4494,,6666257,6150703,5657459,986488,493244,
2021-05-12,145052,138023,6881,,6811309,6288547,5788488,1000118,500059,
2021-05-13,142713,135321,7238,,6954022,6423693,5916470,1014446,507223,
2021-05-14,148869,138778,9920,,7102891,6562283,6045205,1034156,517078,
2021-05-15,159743,149695,9867,,7262634,6711791,6184921,1053740,526870,
2021-05-16,144360,136091,8062,,7406994,6847714,6312862,1069704,534852,
2021-05-17,114983,110885,3944,,7521977,6958410,6419690,1077440,538720,
2021-05-18,111338,100472,10664,,7633315,7058686,6509364,1098644,549322,
2021-05-19,149886,133473,16236,,7783201,7192007,6626523,1130968,565484,
2021-05-20,151574,131580,19777,,7934775,7323398,6738206,1170384,585192,
2021-05-21,165398,140890,24249,,8100173,7464107,6854743,1218728,609364,
2021-05-22,199447,172247,26972,,8299620,7636156,6999901,1272510,636255,
2021-05-23,139836,127467,12224,,8439456,7763445,7115028,1296834,648417,
2021-05-24,100298,93325,6828,,8539754,7856597,7201422,1310350,655175,
2021-05-25,90474,82988,7276,,8630228,7939422,7277038,1324768,662384,
2021-05-26,139788,113018,26506,,8770016,8052253,7363433,1377640,688820,
2021-05-27,152067,123047,28767,,8922083,8175143,7457625,1435036,717518,
2021-05-28,163873,132318,31248,,9085956,8307288,7558581,1497414,748707,
2021-05-29,153393,117131,36029,,9239349,8424269,7639589,1569360,784680,
2021-05-30,149727,119020,30479,,9389076,8543119,7728022,1630194,815097,
2021-05-31,99217,79822,19202,,9488293,8622771,7788536,1668470,834235,
2021-06-01,124207,90618,33250,,9612500,8713194,7845784,1734820,867410,
2021-06-02,145326,102159,42916,,9757826,8815172,7904915,1820514,910257,
2021-06-03,155375,99919,55175,,9913201,8914906,7949545,1930722,965361,
2021-06-04,181728,115543,65913,,10094929,9030250,7999064,2062372,1031186,
2021-06-05,172037,103440,68314,,10266966,9133492,8034077,2198830,1099415,
2021-06-06,163397,91872,71245,,10430363,9225186,8054596,2341180,1170590,
2021-06-07,119564,63058,56288,,10549927,9288047,8061244,2453606,1226803,
2021-06-08,161898,72454,89004,,10711825,9360312,8044585,2631454,1315727,
2021-06-09,181470,70811,110189,,10893295,9430946,8005111,2851670,1425835,
2021-06-10,185585,66427,118667,,11078880,9497170,7952759,3088822,1544411,
2021-06-11,204798,67521,136516,,11283678,9564505,7883660,3361690,1680845,
2021-06-12,199742,62682,136458,,11483420,9627005,7809794,3634422,1817211,
2021-06-13,190350,58897,130921,,11673770,9685727,7737675,3896104,1948052,
2021-06-14,137692,38699,98594,,11811462,9724230,7677689,4093082,2046541,
2021-06-15,189561,42623,146580,,12001023,9766634,7573610,4386048,2193024,
2021-06-16,206265,42437,163182,,12207288,9808875,7452772,4712206,2356103,
2021-06-17,210478,37945,171947,,12417766,9846605,7318647,5055916,2527958,
2021-06-18,217201,35363,181234,,12634967,9881778,7172678,5418200,2709100,
2021-06-19,215903,35503,179723,,12850870,9917075,7028364,5777422,2888711,
2021-06-20,186280,35574,150127,,13037150,9952451,6913721,6077460,3038730,
2021-06-21,120437,20831,99103,,13157587,9973087,6835346,6275482,3137741,
2021-06-22,204952,27527,176668,,13362539,10000420,6686120,6628600,3314300,
2021-06-23,230548,28637,201163,,13593087,10028857,6513502,7030710,3515355,
2021-06-24,227706,26678,200270,,13820793,10055339,6339824,7431030,3715515,
2021-06-25,251130,27997,222382,,14071923,10083134,6145356,7875556,3937778,
2021-06-26,261314,30015,230591,,14333237,10112923,5944695,8336456,4168228,
2021-06-27,205006,27790,176608,,14538243,10140531,5795805,8689452,4344726,
2021-06-28,199256,20957,177730,,14737499,10161290,5638959,9044662,4522331,
2021-06-29,250121,24496,224890,,14987620,10185545,5438478,9494134,4747067,
2021-06-30,275550,24181,250801,,15263170,10209523,5211784,9995478,4997739,
2021-07-01,271979,25313,246111,,15535149,10234618,4990907,10487422,5243711,
2021-07-02,144737,11594,132913,,15679886,10246038,4869516,10753044,5376522,
2021-07-03,216903,19935,196737,,15896789,10265751,4692641,11146220,5573110,
2021-07-04,196217,19454,176538,,16093006,10285019,4535490,11499058,5749529,
2021-07-05,148723,12446,136134,,16241729,10297275,4411740,11771070,5885535,
2021-07-06,220044,20000,199827,,16461773,10317059,4231843,12170432,6085216,
2021-07-07,246618,22968,223407,,16708391,10339801,4031326,12616950,6308475,
2021-07-08,231224,21367,209644,,16939615,10360962,3842978,13035968,6517984,
2021-07-09,227006,21513,205324,,17166621,10382273,3659097,13446352,6723176,
2021-07-10,209068,20541,188370,,17375689,10402610,3491201,13822818,6911409,
2021-07-11,171686,17589,153969,,17547375,10419998,3354767,14130462,7065231,
2021-07-12,123137,11445,111593,,17670512,10431254,3254567,14353374,7176687,
2021-07-13,178517,19034,159339,,17849029,10450066,3114195,14671742,7335871,
2021-07-14,180046,19307,160582,,18029075,10469158,2972868,14992580,7496290,
2021-07-15,167210,19586,147449,,18196285,10488533,2844958,15287150,7643575,
2021-07-16,169366,19915,149300,,18365651,10508246,2715524,15585444,7792722,
2021-07-17,173022,20273,152619,,18538673,10528270,2583121,15890298,7945149,
2021-07-18,133640,15939,117563,,18672313,10544025,2481461,16125128,8062564,
2021-07-19,91988,10421,81459,,18764301,10554233,2410385,16287696,8143848,
2021-07-20,133547,16955,116536,,18897848,10570948,2310740,16520416,8260208,
2021-07-21,140090,16988,123032,,19037938,10587721,2204643,16766156,8383078,
2021-07-22,125630,17653,107839,,19163568,10605150,2114410,16981480,8490740,
2021-07-23,120280,16995,103078,,19283848,10621904,2028285,17187238,8593619,
2021-07-24,126704,18336,108130,,19410552,10640037,1938451,17403172,8701586,
2021-07-25,103652,14869,88652,,19514204,10654682,1864625,17580114,8790057,
2021-07-26,66696,9892,56710,,19580900,10664356,1817770,17693172,8846586,
2021-07-27,92390,15320,76908,,19673290,10679415,1756138,17846554,8923277,
2021-07-28,93949,16469,77409,,19767239,10695649,1695154,18000990,9000495,
2021-07-29,89403,16705,72536,,19856642,10712122,1639279,18145686,9072843,
2021-07-30,84069,16105,67848,,19940711,10727999,1587496,18281006,9140503,
2021-07-31,83868,15733,67989,,20024579,10743514,1535212,18416604,9208302,
2021-08-01,61880,11324,50371,,20086459,10754612,1496130,18516964,9258482,
2021-08-02,42496,7420,34956,,20128955,10761834,1468562,18586544,9293272,
2021-08-03,33300,5959,27168,,20162255,10767560,1447330,18640460,9320230,
2021-08-04,61328,12376,48761,,20223583,10779701,1410908,18737586,9368793,
2021-08-05,59460,12550,46759,,20283043,10792043,1376655,18830776,9415388,
2021-08-06,56029,11859,43953,,20339072,10803642,1344530,18918224,9459112,
2021-08-07,62381,12137,50049,,20401453,10815518,1306575,19017886,9508943,
2021-08-08,48697,9277,39228,,20450150,10824567,1276601,19095932,9547966,
2021-08-09,30859,5937,24744,,20481009,10830290,1257767,19145046,9572523,
2021-08-10,49266,10515,38448,,20530275,10840525,1229800,19221450,9610725,
2021-08-11,48728,10767,37710,,20579003,10851045,1202826,19296438,9648219,
2021-08-12,49260,11205,37824,,20628263,10861999,1176165,19371668,9685834,
2021-08-13,49638,11735,37628,,20677901,10873493,1150242,19446502,9723251,
2021-08-14,51227,12137,38880,,20729128,10885380,1123473,19523814,9761907,
2021-08-15,41774,9855,31694,,20770902,10895033,1101604,19586858,9793429,
2021-08-16,26742,6188,20404,,20797644,10900998,1087362,19627272,9813636,
2021-08-17,40509,11061,29181,,20838153,10911809,1069218,19685182,9842591,
2021-08-18,41902,11974,29684,,20880055,10923541,1051476,19744130,9872065,
2021-08-19,45902,16539,29100,,20925957,10939829,1038887,19801884,9900942,
2021-08-20,46455,16297,29744,,20972412,10955870,1025413,19860914,9930457,
2021-08-21,47961,15151,32442,,21020373,10970761,1008089,19925344,9962672,
2021-08-22,34398,10807,23320,,21054771,10981322,995552,19971540,9985770,
2021-08-23,23223,7005,16000,,21077994,10988092,986536,20003112,10001556,
2021-08-24,37653,13374,23822,,21115647,11001212,976065,20050294,10025147,
2021-08-25,41360,14424,26325,,21157007,11015380,964145,20102470,10051235,
2021-08-26,39273,13555,24976,,21196280,11028659,952689,20151940,10075970,
2021-08-27,37678,12944,23688,,21233958,11041362,941918,20198888,10099444,
2021-08-28,40127,13425,25523,,21274085,11054508,929796,20249424,10124712,
2021-08-29,30563,10257,19945,,21304648,11064533,920089,20288888,10144444,
2021-08-30,18237,6140,11846,,21322885,11070425,914354,20312142,10156071,
2021-08-31,32718,11940,19624,,21355603,11082097,906642,20350910,10175455,
2021-09-01,36252,12949,21959,,21391855,11094813,897616,20394394,10197197,
2021-09-02,37783,15646,19671,,21429638,11110207,893566,20433282,10216641,
2021-09-03,46891,21096,22444,,21476529,11131054,892199,20477710,10238855,
2021-09-04,46884,20589,24779,,21523413,11151397,887986,20526822,10263411,
2021-09-05,33080,14206,18580,,21556493,11165359,883592,20563534,10281767,
2021-09-06,21718,9491,12035,,21578211,11174601,881031,20587140,10293570,
2021-09-07,15013,6728,8099,,21593224,11181072,879643,20602858,10301429,
2021-09-08,41152,17116,20938,,21634376,11197924,875803,20644242,10322121,
2021-09-09,41456,16980,19680,,21675832,11214627,873078,20683098,10341549,
2021-09-10,39656,15511,19012,,21715488,11229875,869559,20720632,10360316,
2021-09-11,42386,15936,23340,,21757874,11245532,862134,20766796,10383398,
2021-09-12,29970,11533,17869,,21787844,11256771,855768,20802006,10401003,
2021-09-13,16091,6406,9187,,21803935,11262943,852972,20819942,10409971,
2021-09-14,29911,11561,15293,,21833846,11274202,849213,20849978,10424989,
2021-09-15,39285,14025,19425,,21873131,11287967,843797,20888340,10444170,
2021-09-16,39353,13988,19250,,21912484,11301720,838512,20926416,10463208,
2021-09-17,38934,13612,19341,,21951418,11315089,832771,20964636,10482318,
2021-09-18,41259,14088,23547,,21992677,11328904,823291,21011226,10505613,
2021-09-19,30664,10829,18985,,22023341,11339474,815122,21048704,10524352,
2021-09-20,16731,6098,10177,,22040072,11345318,811020,21068596,10534298,
2021-09-21,31366,11215,16996,,22071438,11356268,805223,21102090,10551045,
2021-09-22,41818,14818,22929,,22113256,11370790,797091,21147398,10573699,
2021-09-23,47234,16138,26034,,22160490,11386663,787176,21198974,10599487,
2021-09-24,46318,15637,26657,,22206808,11402040,776137,21251806,10625903,
2021-09-25,48202,15257,29950,,22255010,11417044,761425,21311238,10655619,
2021-09-26,37515,12424,24496,,22292525,11429193,749332,21359722,10679861,
2021-09-27,19159,6530,12322,,22311684,11435469,743524,21383890,10691945,
2021-09-28,30961,11295,17883,,22342645,11446505,736924,21419162,10709581,
2021-09-29,37891,12476,21729,,22380536,11458710,727651,21462118,10731059,
2021-09-30,37347,11655,21375,,22417883,11470106,717912,21504388,10752194,
2021-10-01,30883,9811,18415,,22448766,11479691,709295,21540792,10770396,
2021-10-02,37141,11159,23589,,22485907,11490580,696847,21587466,10793733,
2021-10-03,27208,8165,18324,,22513115,11498504,686675,21623658,10811829,
2021-10-04,14868,4746,9803,,22527983,11503003,681600,21642806,10821403,
2021-10-05,26834,8597,15877,,22554817,11511339,674305,21674068,10837034,
2021-10-06,31667,9638,18513,,22586484,11520718,665422,21710592,10855296,
2021-10-07,30351,9398,17120,,22616835,11529865,657687,21744356,10872178,
2021-10-08,32845,10744,18855,,22649680,11540338,649562,21781552,10890776,
2021-10-09,34147,10668,21017,,22683827,11550743,639199,21823088,10911544,
2021-10-10,23416,7661,15088,,22707243,11558153,631760,21852786,10926393,
2021-10-11,12004,3839,7866,,22719247,11561742,627717,21868050,10934025,
2021-10-12,5114,1627,3270,,22724361,11563091,626059,21874064,10937032,
2021-10-13,29119,9192,18095,,22753480,11571993,617140,21909706,10954853,
2021-10-14,29019,8905,17751,,22782499,11580622,608284,21944676,10972338,
2021-10-15,29105,8832,18173,,22811604,11589191,598930,21980522,10990261,
2021-10-16,31141,8986,19872,,22842745,11597886,588032,22019708,11009854,
2021-10-17,23717,7263,15382,,22866462,11604895,579900,22049990,11024995,
2021-10-18,12307,3747,8147,,22878769,11608361,575488,22065746,11032873,
2021-10-19,21279,6629,12637,,22900048,11614707,569467,22090480,11045240,
2021-10-20,25673,7541,14925,,22925721,11622001,562070,22119862,11059931,
2021-10-21,23182,6684,13032,,22948903,11628416,555711,22145410,11072705,
2021-10-22,26128,7314,15119,,22975031,11635407,547890,22175034,11087517,
2021-10-23,28186,7605,17162,,23003217,11642750,538326,22208848,11104424,
2021-10-24,19354,5728,12604,,23022571,11648222,531438,22233568,11116784,
2021-10-25,9931,2710,6476,,23032502,11650663,527664,22245998,11122999,
2021-10-26,18921,5392,11104,,23051423,11655777,521943,22267668,11133834,
2021-10-27,22861,6081,13216,,23074284,11661603,514794,22293618,11146809,
2021-10-28,22306,5791,12646,,23096590,11667106,507928,22318356,11159178,
2021-10-29,22815,5731,13051,,23119405,11672535,500593,22343884,11171942,
2021-10-30,24119,6047,14617,,23143524,11678310,492011,22372598,11186299,
2021-10-31,16485,4595,10603,,23160009,11682611,485998,22393226,11196613,
2021-11-01,7871,2081,5055,,23167880,11684412,483011,22402802,11201401,
2021-11-02,15627,4364,7747,,23183507,11688487,479617,22417740,11208870,
2021-11-03,18631,5069,9605,,23202138,11693253,475071,22436364,11218182,
2021-11-04,19509,4875,10034,,23221647,11697852,469897,22455910,11227955,
2021-11-05,21473,4405,9524,,23243120,11701968,464764,22474408,11237204,
2021-11-06,25335,5207,12156,,23268455,11706906,457798,22498216,11249108,
2021-11-07,21453,4025,8924,,23289908,11710650,452887,22515526,11257763,
2021-11-08,11991,2110,4732,,23301899,11712465,450249,22524432,11262216,
2021-11-09,24129,3851,7652,,23326028,11715995,446438,22539114,11269557,
2021-11-10,28478,4508,8997,,23354506,11720227,441935,22556584,11278292,
2021-11-11,28764,4308,9099,,23383270,11724238,437135,22574206,11287103,
2021-11-12,26749,4166,8243,,23410019,11728113,433044,22590138,11295069,
2021-11-13,34319,5081,11416,,23444338,11732888,426700,22612376,11306188,
2021-11-14,23224,3899,8609,,23467562,11736524,421983,22629082,11314541,
2021-11-15,12702,2185,4495,,23480264,11738449,419665,22637568,11318784,
2021-11-16,26181,3932,7484,,23506445,11742125,416109,22652032,11326016,
2021-11-17,31175,4047,7825,,23537620,11745890,412321,22667138,11333569,
2021-11-18,32509,3868,7529,,23570129,11749452,408646,22681612,11340806,
2021-11-19,35481,3864,7758,,23605610,11753015,404740,22696550,11348275,
2021-11-20,40114,4381,8818,,23645724,11757115,400294,22713642,11356821,
2021-11-21,28126,3439,6951,,23673850,11760292,396768,22727048,11363524,
2021-11-22,14899,1951,3894,,23688749,11761966,394819,22734294,11367147,
2021-11-23,33055,3277,6010,,23721804,11764963,392078,22745770,11372885,
2021-11-24,42666,3760,6809,,23764470,11768419,389018,22758802,11379401,
2021-11-25,46047,3933,6577,,23810517,11772077,386371,22771412,11385706,
2021-11-26,52867,11348,6615,,23863384,11783154,391097,22784114,11392057,
2021-11-27,63522,22356,7038,,23926906,11805229,406405,22797648,11398824,
2021-11-28,51460,27742,5316,,23978366,11832678,428819,22807718,11403859,
2021-11-29,33528,18933,2883,,24011894,11851350,444858,22812984,11406492,
2021-11-30,56044,20687,5137,,24067938,11871756,460398,22822716,11411358,
2021-12-01,69542,26243,5638,,24137480,11897693,480989,22833408,11416704,
2021-12-02,71637,26488,5039,,24209117,11923883,502425,22842916,11421458,
2021-12-03,73425,25096,5171,,24282542,11948683,522344,22852678,11426339,
2021-12-04,81161,27784,6075,47282,24363703,11976174,544044,,11432130,807720
2021-12-05,62637,31932,4415,26268,24426340,12007811,571553,,11436258,833884
2021-12-06,38629,19144,2713,16757,24464969,12026666,587977,,11438689,850563
2021-12-07,60295,14852,4481,40948,24525264,12041246,598338,,11442908,891437
2021-12-08,73453,19056,4681,49713,24598717,12060025,612703,,11447322,941072
2021-12-09,74506,18274,4347,51865,24673223,12077990,626622,,11451368,992852
2021-12-10,77508,17590,4658,55249,24750731,12095299,639549,,11455750,1048020
2021-12-11,83191,20406,5834,56939,24833922,12115416,654107,,11461309,1104873
2021-12-12,60758,22699,4158,33858,24894680,12137835,672642,,11465193,1138642
2021-12-13,34938,11603,2412,20900,24929618,12149141,681823,,11467318,1159447
2021-12-14,101988,9002,3875,89067,25031606,12157832,686935,,11470897,1248394
2021-12-15,127704,12429,4515,110722,25159310,12169957,694839,,11475118,1359016
2021-12-16,139368,12468,4254,122630,25298678,12182139,703043,,11479096,1481547
2021-12-17,159180,12403,4524,142231,25457858,12194267,710913,,11483354,1623681
2021-12-18,175591,13523,4924,157098,25633449,12207496,719500,,11487996,1780684
2021-12-19,140443,18160,3933,118313,25773892,12225355,733719,,11491636,1898886
2021-12-20,106824,10305,2746,93726,25880716,12235392,741268,,11494124,1992514
2021-12-21,215397,12966,4318,198091,26096113,12248042,749909,,11498133,2190484
2021-12-22,237263,14427,5204,217749,26333376,12262169,759118,,11503051,2408115
2021-12-23,257786,11731,5090,240867,26591162,12273595,765753,,11507842,2648876
2021-12-24,223639,9465,4575,209532,26814801,12282763,770639,,11512124,2858292
2021-12-25,89734,3889,2513,83344,26904535,12286377,772010,,11514367,2941529
2021-12-26,11900,388,360,11142,26916435,12286473,772030,,11514443,2952541
2021-12-27,46945,1491,1116,44307,26963380,12287719,772398,,11515321,2996728
2021-12-28,144788,6100,4012,134613,27108168,12293525,774475,,11519050,3131210
2021-12-29,175474,9378,4584,161442,27283642,12302607,779265,,11523342,3292524
2021-12-30,200073,10135,5351,184545,27483715,12312439,784034,,11528405,3476935
2021-12-31,195214,10008,5805,179148,27678929,12322158,788228,,11533930,3655957
2022-01-01,96957,5383,3883,87364,27775886,12327232,789720,,11537512,3743172
2022-01-02,19449,943,930,17446,27795335,12327884,789724,,11538160,3760472
2022-01-03,88257,4773,4593,78810,27883592,12332347,789896,,11542451,3839129
2022-01-04,146375,6001,5319,135015,28029967,12338020,790565,,11547455,3973988
2022-01-05,177518,7633,7298,162413,28207485,12345299,790889,,11554410,4136241
2022-01-06,191548,7214,6790,177017,28399033,12352194,791302,,11560892,4313103
2022-01-07,191305,7968,7006,175517,28590338,12359818,792252,,11567566,4488447
2022-01-08,181685,8629,6642,165225,28772023,12368115,794226,,11573889,4653516
2022-01-09,131105,9866,7187,113959,28903128,12377659,796900,,11580759,4767315
2022-01-10,90561,5107,4489,80834,28993689,12382443,797508,,11584935,4847996
2022-01-11,138901,6161,6583,125452,29132590,12388257,797073,,11591184,4973258
2022-01-12,157041,8164,8060,138694,29289631,12396092,797172,,11598920,5111784
2022-01-13,162690,9214,9217,141549,29452321,12404944,797155,,11607789,5253150
2022-01-14,159897,10755,10385,136065,29612218,12415337,797520,,11617817,5389017
2022-01-15,161213,11013,11677,135889,29773431,12425978,796845,,11629133,5524713
2022-01-16,109791,9294,9678,89457,29883222,12434910,796454,,11638456,5613952
2022-01-17,65789,5939,6567,52642,29949011,12440513,795816,,11644697,5666409
2022-01-18,36119,2004,2135,31156,29985130,12442162,795674,,11646488,5697369
2022-01-19,101328,5585,6721,85961,30086458,12447347,794520,,11652827,5783103
2022-01-20,103608,6325,7007,85738,30190066,12453288,793830,,11659458,5868618
2022-01-21,102118,6234,8059,82512,30292184,12459118,791991,,11667127,5950902
2022-01-22,102590,8716,12076,78119,30394774,12467445,788624,,11678821,6028793
2022-01-23,76705,7308,13999,54799,30471479,12474410,781926,,11692484,6083370
2022-01-24,42267,3197,7935,30746,30513746,12477243,777170,,11700073,6113909
2022-01-25,62571,3759,8373,48119,30576317,12480622,772541,,11708081,6161809
2022-01-26,77894,4918,13172,55693,30654211,12485163,764282,,11720881,6217260
2022-01-27,78082,4896,13246,56054,30732293,12489687,755922,,11733765,6273077
2022-01-28,77292,4676,13677,53900,30809585,12494005,746908,,11747097,6326758
2022-01-29,84830,5531,17717,58119,30894415,12499172,734715,,11764457,6384632
2022-01-30,66514,5025,20632,40160,30960929,12503855,719094,,11784761,6424567
2022-01-31,34753,2176,9887,22351,30995682,12505712,711374,,11794338,6446729
2022-02-01,51354,3266,9664,36529,31047036,12508625,704966,,11803659,6483033
2022-02-02,57716,3848,12401,38681,31104752,12512142,696398,,11815744,6521514
2022-02-03,52584,3611,11512,34301,31157336,12515376,688485,,11826891,6555564
2022-02-04,43100,2946,10567,27286,31200436,12518011,680854,,11837157,6582656
2022-02-05,58729,3747,14473,37566,31259165,12521426,670116,,11851310,6620009
2022-02-06,49866,3642,16120,29574,31309031,12524745,657633,,11867112,6649359
2022-02-07,23240,1691,7811,13445,31332271,12526110,651500,,11874610,6662580
2022-02-08,33405,2360,7255,21972,31365676,12528140,646598,,11881542,6684319
2022-02-09,38890,2785,8923,24410,31404566,12530566,640454,,11890112,6708477
2022-02-10,37541,2765,8838,22552,31442107,12532994,634377,,11898617,6730798
2022-02-11,39453,2726,10295,23006,31481560,12535373,626798,,11908575,6753566
2022-02-12,42054,2959,11457,25321,31523614,12537998,618289,,11919709,6778663
2022-02-13,36327,2802,13146,19943,31559941,12540513,607942,,11932571,6798408
2022-02-14,16985,1176,6124,9475,31576926,12541414,602986,,11938428,6807683
2022-02-15,19365,1386,4758,11879,31596291,12542476,599604,,11942872,6819335
2022-02-16,26026,1767,7735,14949,31622317,12543946,593632,,11950314,6834083
2022-02-17,26770,1684,7527,14986,31649087,12545275,587780,,11957495,6848814
2022-02-18,23950,1354,6614,13679,31673037,12546312,582508,,11963804,6862284
2022-02-19,37838,1903,8338,26055,31710875,12547883,576068,,11971815,6888097
2022-02-20,32579,1499,7963,22807,31743454,12549081,569596,,11979485,6910699
2022-02-21,17502,913,3678,12757,31760956,12549698,566822,,11982876,6923244
2022-02-22,9112,430,1555,6957,31770068,12549838,565692,,11984146,6929990
2022-02-23,25341,1327,4796,17298,31795409,12550855,562216,,11988639,6947052
2022-02-24,24576,1401,5233,15485,31819985,12551934,558379,,11993555,6962294
2022-02-25,23111,1396,5138,14509,31843096,12553036,554630,,11998406,6976577
2022-02-26,25237,1386,5910,16560,31868333,12554112,550099,,12004013,6992911
2022-02-27,26962,1371,7372,17705,31895295,12555214,544087,,12011127,7010421
2022-02-28,10130,594,2531,6745,31905425,12555555,542142,,12013413,7016983
2022-03-01,13204,949,3152,8167,31918629,12556199,539929,,12016270,7024933
2022-03-02,15419,1164,3578,9620,31934048,12557101,537508,,12019593,7034375
2022-03-03,14302,1079,3228,8689,31948350,12557868,535351,,12022517,7042833
2022-03-04,14479,993,3445,8318,31962829,12558540,532895,,12025645,7050898
2022-03-05,18536,1278,4998,11184,31981365,12559508,529164,,12030344,7061858
2022-03-06,16519,1088,5526,9607,31997884,12560315,524720,,12035595,7071258
2022-03-07,5950,469,1861,3509,32003834,12560499,523321,,12037178,7074550
2022-03-08,7368,701,1944,4159,32011202,12560922,522071,,12038851,7078510
2022-03-09,11177,908,2739,6407,32022379,12561554,520234,,12041320,7084715
2022-03-10,12769,1046,3258,6842,32035148,12562323,518015,,12044308,7091344
2022-03-11,12893,905,3410,6866,32048041,12562939,515502,,12047437,7097994
2022-03-12,14690,1049,4187,8310,32062731,12563716,512361,,12051355,7106100
2022-03-13,14751,1091,4999,8335,32077482,12564516,508449,,12056067,7114198
2022-03-14,6333,450,2228,3499,32083815,12564695,506668,,12058027,7117483
2022-03-15,10200,793,2625,5974,32094015,12565198,504824,,12060374,7123243
2022-03-16,13067,935,3668,6953,32107082,12565843,502088,,12063755,7129965
2022-03-17,13199,1049,3963,6758,32120281,12566604,499167,,12067437,7136503
2022-03-18,11909,915,3147,6433,32132190,12567216,496925,,12070291,7142712
2022-03-19,14444,1005,4163,7903,32146634,12567941,493765,,12074176,7150396
2022-03-20,11753,992,3960,6373,32158387,12568662,490792,,12077870,7156561
2022-03-21,5059,415,1589,2814,32163446,12568818,489614,,12079204,7159172
2022-03-22,6716,552,1559,3894,32170162,12569082,488601,,12080481,7162850
2022-03-23,9971,785,2300,5195,32180133,12569551,487083,,12082468,7167804
2022-03-24,9297,723,2377,4613,32189430,12570010,485420,,12084590,7172213
2022-03-25,9228,781,2156,4753,32198658,12570528,484037,,12086491,7176754
2022-03-26,10931,937,2837,5506,32209589,12571188,482135,,12089053,7182041
2022-03-27,10227,911,3538,5301,32219816,12571839,479504,,12092335,7187131
2022-03-28,3584,322,1109,1987,32223400,12571920,478714,,12093206,7188923
2022-03-29,5351,499,1216,2692,32228751,12572134,477991,,12094143,7191393
2022-03-30,7856,748,1838,4123,32236607,12572603,476896,,12095707,7195291
2022-03-31,8655,689,1926,4414,32245262,12573003,475653,,12097350,7199483
2022-04-01,9315,802,1917,4889,32254577,12573513,474529,,12098984,7204133
2022-04-02,10447,887,2215,5572,32265024,12574113,473189,,12100924,7209488
2022-04-03,9212,880,2569,5067,32274236,12574736,471494,,12103242,7214353
2022-04-04,4204,388,1006,2407,32278440,12574862,470873,,12103989,7216556
2022-04-05,6082,601,1037,3054,32284522,12575123,470431,,12104692,7219335
2022-04-06,8382,715,1479,4384,32292904,12575547,469662,,12105885,7223492
2022-04-07,10349,733,1688,4837,32303253,12575980,468702,,12107278,7228086
2022-04-08,23997,812,1584,4836,32327250,12576514,467924,,12108590,7232706
2022-04-09,30498,969,1975,5894,32357748,12577185,466909,,12110276,7238377
2022-04-10,24869,976,2393,5335,32382617,12577902,465486,,12112416,7243510
2022-04-11,12575,386,877,2432,32395192,12578038,464991,,12113047,7245740
2022-04-12,28132,693,1021,3537,32423324,12578427,464656,,12113771,7249044
2022-04-13,37784,853,1561,4927,32461108,12578981,463944,,12115037,7253741
2022-04-14,37905,760,1616,4915,32499013,12579428,463085,,12116343,7258403
2022-04-15,43404,1234,2104,6725,32542417,12580364,462211,,12118153,7264891
2022-04-16,8095,357,650,1741,32550512,12580461,461916,,12118545,7266416
2022-04-17,21026,871,1925,4319,32571538,12581048,460855,,12120193,7270512
2022-04-18,5461,306,463,1290,32576999,12581067,460693,,12120374,7271561
2022-04-19,22657,615,773,3103,32599656,12581399,460526,,12120873,7274444
2022-04-20,40343,1063,1401,4620,32639999,12582136,460185,,12121951,7278800
2022-04-21,38757,943,1600,4683,32678756,12582783,459519,,12123264,7283249
2022-04-22,35636,1017,1436,4268,32714392,12583528,459093,,12124435,7287299
2022-04-23,34659,1005,1740,4714,32749051,12584249,458355,,12125894,7291774
2022-04-24,20816,1021,1889,3777,32769867,12585020,457484,,12127536,7295357
2022-04-25,8299,453,691,1707,32778166,12585204,457245,,12127959,7296848
2022-04-26,24624,733,948,3145,32802790,12585645,457024,,12128621,7299756
2022-04-27,33603,955,1369,3939,32836393,12586323,456602,,12129721,7303477
2022-04-28,32841,928,1417,3931,32869234,12586978,456104,,12130874,7307185
2022-04-29,32062,1098,1379,3909,32901296,12587778,455816,,12131962,7310865
2022-04-30,30290,925,1538,4025,32931586,12588405,455196,,12133209,7314654
2022-05-01,16755,769,1579,2970,32948341,12588876,454381,,12134495,7317380
2022-05-02,5936,309,526,1098,32954277,12588889,454160,,12134729,7318251
2022-05-03,20932,588,834,2347,32975209,12589172,453908,,12135264,7320359
2022-05-04,29418,800,1093,3291,33004627,12589662,453610,,12136052,7323401
2022-05-05,29100,872,1165,3125,33033727,12590221,453307,,12136914,7326281
2022-05-06,29100,1147,1286,2987,33062827,12591080,453163,,12137917,7329041
2022-05-07,28493,870,1266,3113,33091320,12591660,452762,,12138898,7331930
2022-05-08,16000,895,1309,2322,33107320,12592298,452346,,12139952,7334051
2022-05-09,5897,293,474,943,33113217,12592324,452158,,12140166,7334784
2022-05-10,21231,697,723,2120,33134448,12592703,452125,,12140578,7336644
2022-05-11,28954,837,1086,2656,33163402,12593208,451872,,12141336,7339029
2022-05-12,28244,799,1087,2514,33191646,12593710,451580,,12142130,7341302
2022-05-13,27598,878,1119,2469,33219244,12594277,451334,,12142943,7343514
2022-05-14,25694,807,1100,2610,33244938,12594770,451034,,12143736,7345870
2022-05-15,14851,751,1276,2058,33259789,12595249,450502,,12144747,7347709
2022-05-16,6385,326,532,1048,33266174,12595337,450292,,12145045,7348570
2022-05-17,19607,590,781,1743,33285781,12595611,450094,,12145517,7350064
2022-05-18,26548,877,1101,2277,33312329,12596223,449865,,12146358,7352125
2022-05-19,24444,684,1158,2164,33336773,12596640,449384,,12147256,7354072
2022-05-20,24271,801,1140,2218,33361044,12597171,449041,,12148130,7356070
2022-05-21,22406,691,1167,2351,33383450,12597552,448556,,12148996,7358178
2022-05-22,10561,549,891,1489,33394011,12597840,448209,,12149631,7359450
2022-05-23,4574,242,465,793,33398585,12597822,447984,,12149838,7360034
2022-05-24,2629,120,182,442,33401214,12597686,447920,,12149766,7360265
2022-05-25,19369,656,949,1954,33420583,12598075,447617,,12150458,7362008
2022-05-26,20649,664,951,1912,33441232,12598465,447324,,12151141,7363697
2022-05-27,21764,818,1062,2078,33462996,12598995,447077,,12151918,7365542
2022-05-28,19416,722,1167,2151,33482412,12599445,446629,,12152816,7367477
2022-05-29,12112,760,1283,1726,33494524,12599970,446099,,12153871,7369011
2022-05-30,4580,311,550,751,33499104,12600035,445857,,12154178,7369564
2022-05-31,13552,573,753,1667,33512656,12600306,445671,,12154635,7370991
2022-06-01,16614,704,972,1879,33529270,12600708,445401,,12155307,7372617
2022-06-02,14609,557,867,1677,33543879,12600953,445084,,12155869,7374053
2022-06-03,16112,699,1097,1818,33559991,12601372,444680,,12156692,7375651
2022-06-04,13325,647,1166,1845,33573316,12601761,444156,,12157605,7377294
2022-06-05,7869,587,1112,1432,33581185,12602099,443627,,12158472,7378534
2022-06-06,3295,207,446,641,33584480,12602057,443385,,12158672,7378973
2022-06-07,11225,476,728,1372,33595705,12602233,443128,,12159105,7380101
2022-06-08,14069,668,1013,1611,33609774,12602640,442778,,12159862,7381492
2022-06-09,13380,663,926,1676,33623154,12603015,442510,,12160505,7382936
2022-06-10,13856,686,1069,1698,33637010,12603414,442118,,12161296,7384404
2022-06-11,12986,616,1031,1846,33649996,12603744,441701,,12162043,7386027
2022-06-12,8098,643,1236,1504,33658094,12604129,441104,,12163025,7387324
2022-06-13,3190,284,422,713,33661284,12604145,440961,,12163184,7387827
2022-06-14,10131,512,666,1265,33671415,12604368,440801,,12163567,7388854
2022-06-15,13511,473,832,1621,33684926,12604545,440440,,12164105,7390237
2022-06-16,12548,495,857,1618,33697474,12604733,440072,,12164661,7391608
2022-06-17,11693,479,818,1653,33709167,12604925,439726,,12165199,7393025
2022-06-18,11454,437,876,1860,33720621,12605091,439284,,12165807,7394661
2022-06-19,7004,483,899,1420,33727625,12605321,438867,,12166454,7395866
2022-06-20,2287,147,301,643,33729912,12605244,438707,,12166537,7396339
2022-06-21,9547,358,616,1386,33739459,12605315,438444,,12166871,7397477
2022-06-22,13616,408,728,1704,33753075,12605451,438117,,12167334,7398956
2022-06-23,13705,402,775,1683,33766780,12605586,437741,,12167845,7400425
2022-06-24,15367,436,812,1675,33782147,12605762,437361,,12168401,7401885
2022-06-25,14471,427,852,1713,33796618,12605927,436925,,12169002,7403388
2022-06-26,8159,432,886,1280,33804777,12606097,436464,,12169633,7404451
2022-06-27,3212,171,365,594,33807989,12606019,436266,,12169753,7404838
2022-06-28,9621,369,559,1226,33817610,12606102,436072,,12170030,7405831
2022-06-29,13318,415,731,1632,33830928,12606227,435754,,12170473,7407223
2022-06-30,12234,482,848,1581,33843162,12606424,435386,,12171038,7408570
2022-07-01,13041,550,972,1950,33856203,12606716,434959,,12171757,7410314
2022-07-02,1617,110,116,365,33857820,12606550,434951,,12171599,7410447
2022-07-03,5164,260,494,962,33862984,12606552,434708,,12171844,7411193
2022-07-04,2757,132,279,614,33865741,12606437,434560,,12171877,7411610
2022-07-05,11146,372,600,1576,33876887,12606511,434324,,12172187,7412938
2022-07-06,15961,549,859,2010,33892848,12606764,434008,,12172756,7414705
2022-07-07,15668,521,832,1927,33908516,12606996,433696,,12173300,7416379
2022-07-08,17888,555,869,2246,33926404,12607246,433381,,12173865,7418376
2022-07-09,14151,451,597,1851,33940555,12607418,433234,,12174184,7419989
2022-07-10,8751,475,755,1505,33949306,12607643,432953,,12174690,7421286
2022-07-11,4094,199,331,871,33953400,12607576,432818,,12174758,7421936
2022-07-12,12111,410,525,1659,33965511,12607687,432698,,12174989,7423341
2022-07-13,16722,564,773,2144,33982233,12607953,432483,,12175470,7425240
2022-07-14,16861,483,675,2024,33999094,12608130,432280,,12175850,7427024
2022-07-15,28902,598,823,2187,34027996,12608428,432054,,12176374,7428970
2022-07-16,30302,586,774,2328,34058298,12608699,431857,,12176842,7431045
2022-07-17,22936,538,636,1894,34081234,12608998,431756,,12177242,7432743
2022-07-18,11398,189,255,857,34092632,12608919,431685,,12177234,7433378
2022-07-19,28960,592,592,2138,34121592,12609235,431682,,12177553,7435284
2022-07-20,37645,839,924,2597,34159237,12609793,431592,,12178201,7437642
2022-07-21,36358,734,812,2809,34195595,12610239,431507,,12178732,7440210
2022-07-22,35807,824,893,2688,34231402,12610773,431431,,12179342,7442660
2022-07-23,35155,821,913,2836,34266557,12611279,431331,,12179948,7445240
2022-07-24,21740,599,804,1779,34288297,12611615,431123,,12180492,7446794
2022-07-25,11938,308,311,1082,34300235,12611637,431115,,12180522,7447644
2022-07-26,26096,619,605,2214,34326331,12611971,431128,,12180843,7449614
2022-07-27,32476,808,848,2653,34358807,12612520,431086,,12181434,7452055
2022-07-28,31544,724,884,2611,34390351,12612946,430922,,12182024,7454414
2022-07-29,29996,1790,875,2647,34420347,12614443,431833,,12182610,7456810
2022-07-30,25839,2525,747,2440,34446186,12616686,433609,,12183077,7459016
2022-07-31,14318,1069,541,1570,34460504,12617485,434133,,12183352,7460357
2022-08-01,5916,337,223,683,34466420,12617562,434245,,12183317,7460817
2022-08-02,4487,306,138,606,34470907,12617597,434409,,12183188,7461200
2022-08-03,22944,2638,738,2241,34493851,12619958,436305,,12183653,7463205
2022-08-04,22238,2482,681,2134,34516089,12622112,438100,,12184012,7465075
2022-08-05,21800,2755,747,2071,34537889,12624585,440100,,12184485,7466917
2022-08-06,19650,2875,657,1998,34557539,12627148,442312,,12184836,7468656
2022-08-07,12709,2236,621,1423,34570248,12629109,443921,,12185188,7469861
2022-08-08,4766,570,188,603,34575014,12629390,444296,,12185094,7470226
2022-08-09,14017,1468,558,1595,34589031,12630569,445200,,12185369,7471579
2022-08-10,19133,2364,718,1994,34608164,12632658,446844,,12185814,7473343
2022-08-11,17080,2041,718,1858,34625244,12634423,448165,,12186258,7474968
2022-08-12,16985,2048,734,1852,34642229,12636182,449478,,12186704,7476591
2022-08-13,15956,2223,766,1809,34658185,12638118,450933,,12187185,7478157
2022-08-14,9531,1621,619,1087,34667716,12639449,451931,,12187518,7479008
2022-08-15,3873,388,271,479,34671589,12639581,452045,,12187536,7479277
2022-08-16,10810,1075,516,1356,34682399,12640354,452602,,12187752,7480381
2022-08-17,16102,1834,739,1783,34698501,12641899,453696,,12188203,7481927
2022-08-18,14935,1642,749,1697,34713436,12643216,454585,,12188631,7483352
2022-08-19,15319,1847,749,1552,34728755,12644784,455679,,12189105,7484670
2022-08-20,14286,1640,740,1547,34743041,12646132,456573,,12189559,7485978
2022-08-21,9906,1533,660,1165,34752947,12647400,457442,,12189958,7486926
2022-08-22,4165,481,271,563,34757112,12647576,457649,,12189927,7487229
2022-08-23,11141,1248,556,1500,34768253,12648515,458337,,12190178,7488476
2022-08-24,14761,1808,871,2187,34783014,12650051,459274,,12190777,7490431
2022-08-25,14028,1716,780,2123,34797042,12651477,460203,,12191274,7492307
2022-08-26,13929,1687,816,2094,34810971,12652866,461067,,12191799,7494151
2022-08-27,12419,1486,877,2001,34823390,12654024,461670,,12192354,7495885
2022-08-28,7926,1259,622,1398,34831316,12655021,462305,,12192716,7497062
2022-08-29,3400,502,286,684,34834716,12655241,462516,,12192725,7497511
2022-08-30,9908,1169,652,1855,34844624,12656052,463027,,12193025,7499063
2022-08-31,13514,1626,946,2315,34858138,12657384,463703,,12193681,7501132
2022-09-01,12907,1720,913,2142,34871045,12658807,464505,,12194302,7503027
2022-09-02,15045,1616,991,4917,34886090,12660147,465122,,12195025,7507717
2022-09-03,14719,1525,923,5516,34900809,12661385,465721,,12195664,7512996
2022-09-04,8667,1009,676,3237,34909476,12662127,466044,,12196083,7516011
2022-09-05,3556,321,229,1387,34913032,12662181,466133,,12196048,7517175
2022-09-06,2469,157,116,1132,34915501,12662082,466171,,12195911,7518098
2022-09-07,10926,1019,587,3492,34926427,12662801,466599,,12196202,7521337
2022-09-08,10871,1022,527,2791,34937298,12663494,467091,,12196403,7523851
2022-09-09,9583,1011,488,2504,34946881,12664216,467609,,12196607,7526118
2022-09-10,10636,1264,552,3168,34957517,12665200,468314,,12196886,7529050
2022-09-11,9411,982,667,3737,34966928,12665931,468623,,12197308,7532576
2022-09-12,3127,295,205,1079,34970055,12665942,468706,,12197236,7533417
2022-09-13,6018,544,283,1132,34976073,12666196,468958,,12197238,7534303
2022-09-14,14482,797,434,1844,34990555,12666674,469317,,12197357,7535881
2022-09-15,15758,781,411,1533,35006313,12667134,469682,,12197452,7537142
2022-09-16,17759,766,447,1693,35024072,12667638,469995,,12197643,7538612
2022-09-17,17622,722,458,1669,35041694,12668054,470255,,12197799,7540025
2022-09-18,11214,773,451,1688,35052908,12668565,470575,,12197990,7541489
2022-09-19,4979,404,288,670,35057887,12668695,470686,,12198009,7541944
2022-09-20,13772,442,332,948,35071659,12668822,470794,,12198028,7542629
2022-09-21,23043,647,410,1499,35094702,12669157,471026,,12198131,7543871
2022-09-22,22918,636,398,1381,35117620,12669483,471258,,12198225,7544989
2022-09-23,22952,727,604,1418,35140572,12669906,471376,,12198530,7546149
2022-09-24,21691,737,689,1499,35162263,12670348,471420,,12198928,7547412
2022-09-25,11320,595,702,1357,35173583,12670660,471307,,12199353,7548531
2022-09-26,4563,192,218,594,35178146,12670560,471275,,12199285,7548880
2022-09-27,37653,497,365,1497,35215799,12670786,471403,,12199383,7550149
2022-09-28,50969,731,670,1901,35266768,12671248,471463,,12199785,7551824
2022-09-29,48008,637,741,1837,35314776,12671562,471351,,12200211,7553383
2022-09-30,47271,677,806,2003,35362047,12671911,471220,,12200691,7555104
2022-10-01,34452,527,633,1548,35396499,12672128,471112,,12201016,7556384
2022-10-02,24245,736,1028,1711,35420744,12672566,470817,,12201749,7557841
2022-10-03,10871,238,231,613,35431615,12672511,470820,,12201691,7558215
2022-10-04,32198,477,459,1170,35463813,12672666,470834,,12201832,7559106
2022-10-05,40440,632,741,1561,35504253,12672975,470718,,12202257,7560401
2022-10-06,38695,610,653,1567,35542948,12673280,470673,,12202607,7561706
2022-10-07,42243,661,852,1741,35585191,12673594,470474,,12203120,7563146
2022-10-08,37397,782,1145,2120,35622588,12674043,470105,,12203938,7564990
2022-10-09,18814,549,727,1556,35641402,12674313,469924,,12204389,7566307
2022-10-10,6865,168,370,565,35648267,12674181,469719,,12204462,7566610
2022-10-11,4994,124,111,318,35653261,12674008,469727,,12204281,7566688
2022-10-12,35117,579,685,1428,35688378,12674251,469619,,12204632,7567824
2022-10-13,36761,643,858,1620,35725139,12674525,469400,,12205125,7569133
2022-10-14,36977,621,753,1541,35762116,12674810,469264,,12205546,7570392
2022-10-15,35454,714,1013,1628,35797570,12675231,468962,,12206269,7571770
2022-10-16,20663,654,1024,1593,35818233,12675614,468586,,12207028,7573132
2022-10-17,7356,206,477,541,35825589,12675533,468313,,12207220,7573432
2022-10-18,36428,458,501,1398,35862017,12675669,468265,,12207404,7574556
2022-10-19,49902,619,730,1982,35911919,12675985,468150,,12207835,7576287
2022-10-20,51292,622,649,2050,35963211,12676291,468120,,12208171,7578070
2022-10-21,52851,696,619,1935,36016062,12676658,468191,,12208467,7579736
2022-10-22,50864,749,904,2311,36066926,12677074,468031,,12209043,7581770
2022-10-23,30641,571,786,2122,36097567,12677327,467809,,12209518,7583627
2022-10-24,14134,232,271,978,36111701,12677254,467765,,12209489,7584345
2022-10-25,41374,473,489,1820,36153075,12677374,467746,,12209628,7585865
2022-10-26,51658,615,660,2124,36204733,12677652,467697,,12209955,7587707
2022-10-27,50119,603,768,2164,36254852,12677925,467524,,12210401,7589597
2022-10-28,49801,591,675,2095,36304653,12678154,467435,,12210719,7591382
2022-10-29,50600,733,779,2222,36355253,12678534,467385,,12211149,7593300
2022-10-30,28402,661,930,2038,36383655,12678906,467112,,12211794,7595091
2022-10-31,12440,200,234,777,36396095,12678823,467075,,12211748,7595631
2022-11-01,33094,338,197,1220,36429189,12678814,467210,,12211604,7596558
2022-11-02,44291,575,625,1903,36473480,12679054,467156,,12211898,7598159
2022-11-03,44192,540,606,1856,36517672,12679262,467086,,12212176,7599727
2022-11-04,44646,647,527,2030,36562318,12679603,467199,,12212404,7601502
2022-11-05,45207,646,754,2368,36607525,12679946,467088,,12212858,7603601
2022-11-06,26020,558,771,2097,36633545,12680160,466872,,12213288,7605398
2022-11-07,10711,242,235,877,36644256,12680107,466876,,12213231,7606031
2022-11-08,33487,486,397,1586,36677743,12680300,466962,,12213338,7607370
2022-11-09,40529,605,571,1964,36718272,12680580,466994,,12213586,7609058
2022-11-10,39178,620,547,1929,36757450,12680877,467061,,12213816,7610709
2022-11-11,43347,635,641,2209,36800797,12681192,467054,,12214138,7612641
2022-11-12,36851,638,592,2185,36837648,12681503,467092,,12214411,7614541
2022-11-13,24269,558,770,2277,36861917,12681761,466874,,12214887,7616561
2022-11-14,10966,232,204,1024,36872883,12681695,466901,,12214794,7617325
2022-11-15,33629,483,380,1693,36906512,12681810,466998,,12214812,7618707
2022-11-16,43541,798,583,2370,36950053,12682302,467207,,12215095,7620820
2022-11-17,38341,674,647,2241,36988394,12682632,467230,,12215402,7622768
2022-11-18,40629,726,531,2331,37029023,12683008,467421,,12215587,7624796
2022-11-19,39659,1005,1031,3061,37068682,12683663,467388,,12216275,7627550
2022-11-20,22423,658,718,2444,37091105,12684038,467324,,12216714,7629761
2022-11-21,8921,196,193,967,37100026,12683966,467322,,12216644,7630518
2022-11-22,26440,481,369,1513,37126466,12684079,467429,,12216650,7631710
2022-11-23,32088,685,668,2069,37158554,12684427,467443,,12216984,7633495
2022-11-24,31912,663,752,2086,37190466,12684769,467352,,12217417,7635313
2022-11-25,30753,763,827,1953,37221219,12685215,467282,,12217933,7636999
2022-11-26,30292,908,1193,2698,37251511,12685777,466988,,12218789,7639401
2022-11-27,18676,608,943,2087,37270187,12686072,466647,,12219425,7641225
2022-11-28,7540,190,282,787,37277727,12685957,466547,,12219410,7641746
2022-11-29,21026,421,454,1292,37298753,12686042,466510,,12219532,7642755
2022-11-30,27892,643,649,1842,37326645,12686358,466502,,12219856,7644313
2022-12-01,24807,593,682,1692,37351452,12686616,466409,,12220207,7645714
2022-12-02,25058,523,630,1776,37376510,12686803,466296,,12220507,7647201
2022-12-03,25558,588,781,1945,37402068,12687060,466093,,12220967,7648875
2022-12-04,15252,494,606,1702,37417320,12687212,465975,,12221237,7650278
2022-12-05,6877,167,157,746,37424197,12687081,465980,,12221101,7650771
2022-12-06,20351,419,352,1379,37444548,12687125,466041,,12221084,7651834
2022-12-07,24782,553,609,1673,37469330,12687352,465977,,12221375,7653229
2022-12-08,23162,563,520,1766,37492492,12687591,466018,,12221573,7654712
2022-12-09,23328,635,575,1632,37515820,12687889,466074,,12221815,7656064
2022-12-10,22576,508,602,1631,37538396,12688070,465977,,12222093,7657411
2022-12-11,14204,548,786,1566,37552600,12688342,465736,,12222606,7658741
2022-12-12,5507,149,156,595,37558107,12688193,465724,,12222469,7659092
2022-12-13,17798,375,371,1125,37575905,12688239,465726,,12222513,7659938
2022-12-14,21324,511,547,1454,37597229,12688447,465684,,12222763,7661140
2022-12-15,21973,530,603,1579,37619202,12688626,465609,,12223017,7662417
2022-12-16,16291,378,451,1031,37635493,12688675,465533,,12223142,7663171
2022-12-17,18701,555,509,1277,37654194,12688901,465577,,12223324,7664159
2022-12-18,12642,530,794,1306,37666836,12689142,465312,,12223830,7665206
2022-12-19,4585,131,116,449,37671421,12688934,465323,,12223611,7665366
2022-12-20,16215,498,449,1110,37687636,12689108,465364,,12223744,7666205
2022-12-21,18476,541,552,1303,37706112,12689340,465349,,12223991,7667239
2022-12-22,18604,574,591,1747,37724716,12689611,465332,,12224279,7668722
2022-12-23,15654,577,602,1716,37740370,12689825,465302,,12224523,7670137
2022-12-24,5339,224,172,674,37745709,12689731,465353,,12224378,7670525
2022-12-25,2445,153,154,480,37748154,12689571,465342,,12224229,7670736
2022-12-26,262,12,7,48,37748416,12689280,465342,,12223938,7670528
2022-12-27,2099,98,37,307,37750515,12689085,465399,,12223686,7670593
2022-12-28,8321,337,168,975,37758836,12689103,465563,,12223540,7671292
2022-12-29,13165,582,529,1601,37772001,12689349,465612,,12223737,7672603
2022-12-30,15823,667,658,1881,37787824,12689702,465618,,12224084,7674204
2022-12-31,11237,459,389,1356,37799061,12689800,465684,,12224116,7675249
2023-01-01,3907,201,219,562,37802968,12689681,465665,,12224016,7675531
2023-01-02,652,36,14,97,37803620,12689426,465686,,12223740,7675377
2023-01-03,8196,297,151,902,37811816,12689433,465826,,12223607,7676034
2023-01-04,14723,574,547,1547,37826539,12689717,465847,,12223870,7677327
2023-01-05,16119,643,535,1796,37842658,12690053,465947,,12224106,7678856
2023-01-06,18835,715,612,2046,37861493,12690464,466047,,12224417,7680639
2023-01-07,18524,701,639,2057,37880017,12690879,466104,,12224775,7682447
2023-01-08,11612,580,608,1632,37891629,12691199,466073,,12225126,7683852
2023-01-09,5299,215,196,664,37896928,12691103,466089,,12225014,7684254
2023-01-10,12162,415,317,786,37909090,12691208,466185,,12225023,7684771
2023-01-11,15544,458,370,1095,37924634,12691339,466269,,12225070,7685590
2023-01-12,14084,444,409,973,37938718,12691471,466303,,12225168,7686297
2023-01-13,14175,419,344,1040,37952893,12691629,466375,,12225254,7687108
2023-01-14,13391,472,451,1079,37966284,12691788,466390,,12225398,7687913
2023-01-15,9046,459,508,1055,37975330,12691962,466340,,12225622,7688727
2023-01-16,3746,146,130,479,37979076,12691831,466356,,12225475,7688960
2023-01-17,8853,267,179,654,37987929,12691754,466440,,12225314,7689324
2023-01-18,10266,349,273,761,37998195,12691801,466513,,12225288,7689816
2023-01-19,10593,315,318,761,38008788,12691815,466505,,12225310,7690322
2023-01-20,9837,318,272,717,38018625,12691839,466549,,12225290,7690779
2023-01-21,11307,354,399,904,38029932,12691887,466503,,12225384,7691425
2023-01-22,7569,343,405,818,38037501,12691965,466438,,12225527,7692009
2023-01-23,3380,143,131,288,38040881,12691866,466449,,12225417,7692083
2023-01-24,8291,226,166,553,38049172,12691776,466507,,12225269,7692360
2023-01-25,10307,346,297,663,38059479,12691847,466552,,12225295,7692793
2023-01-26,6725,236,203,469,38066204,12691786,466582,,12225204,7693011
2023-01-27,6912,237,197,498,38073116,12691713,466619,,12225094,7693245
2023-01-28,9352,313,339,695,38082468,12691733,466588,,12225145,7693687
2023-01-29,5969,234,341,693,38088437,12691686,466476,,12225210,7694130
2023-01-30,1900,88,80,215,38090337,12691485,466482,,12225003,7694092
2023-01-31,5883,156,150,414,38096220,12691330,466485,,12224845,7694229
2023-02-01,7302,248,249,493,38103522,12691321,466481,,12224840,7694501
2023-02-02,6484,296,240,503,38110006,12691340,466534,,12224806,7694779
2023-02-03,6551,197,194,463,38116557,12691272,466533,,12224739,7695010
2023-02-04,6731,233,307,544,38123288,12691234,466453,,12224781,7695323
2023-02-05,4177,199,291,484,38127465,12691150,466356,,12224794,7695573
2023-02-06,1834,90,98,212,38129299,12690942,466345,,12224597,7695523
2023-02-07,4965,161,182,385,38134264,12690792,466321,,12224471,7695648
2023-02-08,5770,212,206,430,38140034,12690725,466324,,12224401,7695834
2023-02-09,6124,211,244,439,38146158,12690663,466290,,12224373,7696042
2023-02-10,5092,159,208,372,38151250,12690590,466237,,12224353,7696212
2023-02-11,6053,186,260,458,38157303,12690484,466159,,12224325,7696406
2023-02-12,4084,220,342,409,38161387,12690450,466033,,12224417,7696590
2023-02-13,1483,57,87,146,38162870,12690251,466001,,12224250,7696521
2023-02-14,3945,131,179,310,38166815,12690095,465951,,12224144,7696574
2023-02-15,4540,119,191,286,38171355,12689938,465876,,12224062,7696625
2023-02-16,4916,175,284,400,38176271,12689835,465763,,12224072,7696785
2023-02-17,4983,179,210,344,38181254,12689759,465728,,12224031,7696912
2023-02-18,5115,232,294,487,38186369,12689718,465664,,12224054,7697167
2023-02-19,3354,132,244,373,38189723,12689580,465547,,12224033,7697314
2023-02-20,1424,63,54,158,38191147,12689385,465553,,12223832,7697254
2023-02-21,914,27,14,107,38192061,12689161,465562,,12223599,7697138
2023-02-22,4135,131,212,370,38196196,12689031,465475,,12223556,7697295
2023-02-23,4282,162,231,392,38200478,12688919,465399,,12223520,7697450
2023-02-24,3034,136,231,274,38203512,12688796,465300,,12223496,7697490
2023-02-25,5024,213,541,386,38208536,12688754,464971,,12223783,7697662
2023-02-26,3472,146,681,384,38212008,12688629,464432,,12224197,7697821
2023-02-27,1074,37,57,97,38213082,12688420,464407,,12224013,7697714
2023-02-28,2729,99,163,232,38215811,12688231,464341,,12223890,7697690
2023-03-01,3850,137,428,336,38219661,12688060,464044,,12224016,7697751
2023-03-02,4595,158,494,330,38224256,12687903,463697,,12224206,7697822
2023-03-03,4367,159,357,334,38228623,12687783,463496,,12224287,7697907
2023-03-04,4968,208,623,350,38233591,12687707,463078,,12224629,7698013
2023-03-05,2537,110,450,251,38236128,12687516,462737,,12224779,7698000
2023-03-06,1156,48,37,114,38237284,12687306,462746,,12224560,7697888
2023-03-07,3221,87,172,225,38240505,12687074,462657,,12224417,7697846
2023-03-08,4317,133,412,284,38244822,12686907,462376,,12224531,7697862
2023-03-09,4615,173,453,312,38249437,12686790,462090,,12224700,7697926
2023-03-10,3942,100,139,254,38253379,12686639,462049,,12224590,7697966
2023-03-11,4064,139,171,286,38257443,12686538,462014,,12224524,7698042
2023-03-12,2883,109,233,301,38260326,12686371,461881,,12224490,7698105
2023-03-13,862,29,32,106,38261188,12686152,461874,,12224278,7697995
2023-03-14,3079,100,109,257,38264267,12685976,461865,,12224111,7698016
2023-03-15,4099,138,163,313,38268366,12685858,461838,,12224020,7698105
2023-03-16,4020,176,234,277,38272386,12685711,461771,,12223940,7698117
2023-03-17,4290,168,202,310,38276676,12685574,461733,,12223841,7698155
2023-03-18,4360,144,194,298,38281036,12685441,461682,,12223759,7698211
2023-03-19,2722,128,233,256,38283758,12685339,461575,,12223764,7698258
2023-03-20,774,31,19,74,38284532,12685101,461585,,12223516,7698100
2023-03-21,2898,70,86,200,38287430,12684910,461564,,12223346,7698077
2023-03-22,3894,130,133,248,38291324,12684751,461558,,12223193,7698067
2023-03-23,3808,118,171,226,38295132,12684581,461499,,12223082,7698047
2023-03-24,3693,102,116,238,38298825,12684429,461483,,12222946,7698070
2023-03-25,4273,108,171,251,38303098,12684273,461413,,12222860,7698093
2023-03-26,2472,112,212,202,38305570,12684128,461308,,12222820,7698076
2023-03-27,915,48,32,68,38306485,12683948,461323,,12222625,7697942
2023-03-28,3105,87,78,202,38309590,12683755,461324,,12222431,7697906
2023-03-29,4170,127,136,224,38313760,12683604,461311,,12222293,7697890
2023-03-30,3838,108,164,211,38317598,12683441,461254,,12222187,7697855
2023-03-31,3987,140,109,222,38321585,12683305,461284,,12222021,7697844
2023-04-01,4192,135,147,225,38325777,12683179,461269,,12221910,7697851
2023-04-02,2180,58,122,172,38327957,12682949,461201,,12221748,7697776
2023-04-03,781,24,12,53,38328738,12682727,461211,,12221516,7697613
2023-04-04,3418,74,74,169,38332156,12682550,461210,,12221340,7697554
2023-04-05,4369,94,109,249,38336525,12682365,461192,,12221173,7697567
2023-04-06,3703,108,109,190,38340228,12682222,461189,,12221033,7697537
2023-04-07,4599,105,115,243,38344827,12682062,461176,,12220886,7697553
2023-04-08,835,22,11,54,38345662,12681843,461183,,12220660,7697399
2023-04-09,2441,81,103,161,38348103,12681708,461158,,12220550,7697375
2023-04-10,360,9,6,20,38348463,12681471,461155,,12220316,7697195
2023-04-11,2771,34,28,121,38351234,12681237,461160,,12220077,7697075
2023-04-12,6345,104,96,188,38357579,12681095,461163,,12219932,7697060
2023-04-13,6997,105,128,207,38364576,12680941,461133,,12219808,7697041
2023-04-14,6514,88,103,206,38371090,12680773,461111,,12219662,7697034
2023-04-15,6949,107,149,230,38378039,12680633,461067,,12219566,7697055
2023-04-16,3274,83,144,165,38381313,12680452,461003,,12219449,7696992
2023-04-17,864,12,13,49,38382177,12680245,460999,,12219246,7696857
2023-04-18,4784,101,77,160,38386961,12680090,461021,,12219069,7696792
2023-04-19,6567,117,98,177,38393528,12679947,461038,,12218909,7696742
2023-04-20,6387,101,153,210,38399915,12679812,460984,,12218828,7696746
2023-04-21,5773,85,75,133,38405688,12679654,460992,,12218662,7696669
2023-04-22,6391,95,91,180,38412079,12679516,460993,,12218523,7696653
2023-04-23,3301,119,147,170,38415380,12679414,460964,,12218450,7696629
2023-04-24,955,4,12,59,38416335,12679206,460954,,12218252,7696513
2023-04-25,4809,69,70,187,38421144,12679045,460953,,12218092,7696494
2023-04-26,6592,108,93,208,38427736,12678932,460968,,12217964,7696506
2023-04-27,6898,118,152,207,38434634,12678819,460930,,12217889,7696512
2023-04-28,6637,86,86,185,38441271,12678681,460928,,12217753,7696493
2023-04-29,6530,123,111,197,38447801,12678593,460939,,12217654,7696504
2023-04-30,2642,94,129,145,38450443,12678484,460903,,12217581,7696469
2023-05-01,1030,20,17,30,38451473,12678295,460904,,12217391,7696311
2023-05-02,4347,67,55,105,38455820,12678142,460911,,12217231,7696224
2023-05-03,5608,108,107,176,38461428,12678036,460909,,12217127,7696217
2023-05-04,8086,87,85,134,38469514,12677901,460910,,12216991,7696165
2023-05-05,13049,90,98,168,38482563,12677787,460899,,12216888,7696151
2023-05-06,15641,114,96,154,38498204,12677708,460915,,12216793,7696130
2023-05-07,6066,56,95,106,38504270,12677566,460872,,12216694,7696063
2023-05-08,2165,16,4,37,38506435,12677394,460882,,12216512,7695934
2023-05-09,12560,55,49,129,38518995,12677243,460885,,12216358,7695889
2023-05-10,14768,70,79,157,38533763,12677107,460874,,12216233,7695865
2023-05-11,13363,77,71,154,38547126,12676998,460879,,12216119,7695856
2023-05-12,13488,86,79,176,38560614,12676893,460884,,12216009,7695856
2023-05-13,11445,80,74,147,38572059,12676749,460887,,12215862,7695805
2023-05-14,4185,67,95,93,38576244,12676621,460858,,12215763,7695734
2023-05-15,1055,9,6,38,38577299,12676446,460855,,12215591,7695618
2023-05-16,8948,56,47,93,38586247,12676290,460859,,12215431,7695528
2023-05-17,11123,99,83,141,38597370,12676168,460872,,12215296,7695463
2023-05-18,10838,81,69,144,38608208,12676030,460883,,12215147,7695412
2023-05-19,10514,96,97,152,38618722,12675912,460878,,12215034,7695372
2023-05-20,9405,91,88,165,38628127,12675782,460880,,12214902,7695333
2023-05-21,3084,48,86,95,38631211,12675652,460840,,12214812,7695269
2023-05-22,970,14,11,30,38632181,12675472,460843,,12214629,7695127
2023-05-23,754,8,3,16,38632935,12675291,460848,,12214443,7694979
2023-05-24,8017,57,80,105,38640952,12675128,460824,,12214304,7694883
2023-05-25,9344,74,93,163,38650296,12675000,460803,,12214197,7694870
2023-05-26,7993,67,70,123,38658289,12674875,460800,,12214075,7694822
2023-05-27,8161,108,76,125,38666450,12674787,460830,,12213957,7694782
2023-05-28,2905,56,72,101,38669355,12674668,460811,,12213857,7694725
2023-05-29,972,13,11,30,38670327,12674485,460811,,12213674,7694575
2023-05-30,6070,61,50,112,38676397,12674337,460821,,12213516,7694499
2023-05-31,8169,91,94,122,38684566,12674223,460815,,12213408,7694442
2023-06-01,7372,72,95,122,38691938,12674094,460790,,12213304,7694384
2023-06-02,6326,50,48,121,38698264,12673948,460791,,12213157,7694326
2023-06-03,5492,70,63,123,38703756,12673815,460797,,12213018,7694272
2023-06-04,2048,47,78,77,38705804,12673688,460763,,12212925,7694193
2023-06-05,600,11,6,18,38706404,12673528,460766,,12212762,7694058
2023-06-06,4465,39,38,79,38710869,12673375,460764,,12212611,7693966
2023-06-07,5810,62,65,121,38716679,12673277,460758,,12212519,7693951
2023-06-08,5755,57,68,112,38722434,12673196,460745,,12212451,7693948
2023-06-09,6185,76,81,122,38728619,12673089,460740,,12212349,7693908
2023-06-10,5343,77,95,115,38733962,12672976,460719,,12212257,7693855
2023-06-11,2010,55,62,105,38735972,12672875,460707,,12212168,7693824
2023-06-12,691,11,7,38,38736663,12672751,460710,,12212041,7693743
2023-06-13,4218,55,58,103,38740881,12672642,460706,,12211936,7693709
2023-06-14,5477,72,83,117,38746358,12672534,460694,,12211840,7693672
2023-06-15,5102,70,76,121,38751460,12672416,460687,,12211729,7693626
2023-06-16,5692,70,64,120,38757152,12672316,460691,,12211625,7693598
2023-06-17,4120,63,62,113,38761272,12672217,460692,,12211525,7693567
2023-06-18,1557,41,61,98,38762829,12672111,460671,,12211440,7693538
2023-06-19,373,7,2,15,38763202,12671982,460674,,12211308,7693437
2023-06-20,3181,52,42,88,38766383,12671869,460682,,12211187,7693377
2023-06-21,3644,42,56,87,38770027,12671765,460665,,12211100,7693332
2023-06-22,3954,75,73,116,38773981,12671688,460665,,12211023,7693318
2023-06-23,4505,56,44,88,38778486,12671615,460676,,12210939,7693293
2023-06-24,3695,49,61,73,38782181,12671493,460662,,12210831,7693220
2023-06-25,1518,31,50,93,38783699,12671405,460642,,12210763,7693207
2023-06-26,510,12,9,23,38784209,12671315,460642,,12210673,7693138
2023-06-27,3102,80,46,91,38787311,12671266,460675,,12210591,7693120
2023-06-28,4072,72,59,89,38791383,12671226,460688,,12210538,7693106
2023-06-29,3962,64,72,82,38795345,12671182,460676,,12210506,7693093
2023-06-30,3823,75,60,127,38799168,12671152,460688,,12210464,7693123
2023-07-01,3204,52,88,116,38802372,12671078,460651,,12210427,7693128
2023-07-02,269,10,4,15,38802641,12670982,460657,,12210325,7693049
2023-07-03,377,6,5,26,38803018,12670893,460658,,12210235,7692992
2023-07-04,1231,16,11,48,38804249,12670804,460663,,12210141,7692947
2023-07-05,2379,54,40,70,38806628,12670765,460675,,12210090,7692939
2023-07-06,2528,38,69,85,38809156,12670697,460642,,12210055,7692935
2023-07-07,2814,53,46,71,38811970,12670672,460648,,12210024,7692937
2023-07-08,2388,63,43,91,38814358,12670633,460668,,12209965,7692937
2023-07-09,912,31,44,37,38815270,12670584,460655,,12209929,7692900
2023-07-10,289,4,2,15,38815559,12670490,460657,,12209833,7692827
2023-07-11,1781,35,20,58,38817340,12670437,460671,,12209766,7692814
2023-07-12,2301,51,52,84,38819641,12670407,460670,,12209737,7692825
2023-07-13,2203,54,68,66,38821844,12670399,460656,,12209743,7692839
2023-07-14,1917,65,48,59,38823761,12670410,460672,,12209738,7692856
2023-07-15,1864,51,55,76,38825625,12670424,460668,,12209756,7692904
2023-07-16,789,35,27,41,38826414,12670425,460676,,12209749,7692914
2023-07-17,187,5,1,9,38826601,12670410,460680,,12209730,7692905
2023-07-18,1298,42,44,56,38827899,12670446,460678,,12209768,7692955
2023-07-19,1747,58,47,56,38829646,12670504,460689,,12209815,7693011
2023-07-20,1411,79,53,45,38831057,12670583,460715,,12209868,7693056
