"report_date","previous_day_total_doses_administered","previous_day_at_least_one","previous_day_fully_vaccinated","previous_day_3doses","total_doses_administered","total_individuals_at_least_one","total_individuals_partially_vaccinated","total_doses_in_fully_vaccinated_individuals","total_individuals_fully_vaccinated","total_individuals_3doses"
2021-01-01,6250,6240,2,,32177,32122,32111,22,11,
2021-01-02,4612,4600,6,,36789,36670,36657,26,13,
2021-01-03,5393,5386,3,,42182,42056,42040,32,16,
2021-01-04,5995,5993,0,,48177,48048,48033,30,15,
2021-01-05,9681,9657,19,,57858,57703,57670,66,33,
2021-01-06,12792,12327,450,,70650,70026,69547,958,479,
2021-01-07,16216,15504,697,,86866,85529,84353,2352,1176,
2021-01-08,18034,17019,1002,,104900,102548,100370,4356,2178,
2021-01-09,19498,18421,1064,,124398,120968,117726,6484,3242,
2021-01-10,11366,11327,36,,135764,132286,129009,6554,3277,
2021-01-11,11710,11661,48,,147474,143947,140622,6650,3325,
2021-01-12,14464,14159,296,,161938,158098,154477,7242,3621,
2021-01-13,15431,13810,1592,,177369,171894,166683,10422,5211,
2021-01-14,19180,16730,2435,,196549,188618,180973,15290,7645,
2021-01-15,20044,17989,2036,,216593,206596,196915,19362,9681,
2021-01-16,17115,15932,1170,,233708,222512,211661,21702,10851,
2021-01-17,11253,10010,1236,,244961,232507,220422,24170,12085,
2021-01-18,6788,6708,70,,251749,239192,227040,24304,12152,
2021-01-19,11822,9714,2094,,263571,248885,234639,28492,14246,
2021-01-20,10798,7209,3572,,274369,256071,238254,35634,17817,
2021-01-21,10964,6848,4089,,285333,262903,240997,43812,21906,
2021-01-22,9033,4317,4697,,294366,267183,240582,53202,26601,
2021-01-23,7443,3028,4387,,301809,270181,239194,61974,30987,
2021-01-24,4379,1823,2536,,306188,271986,238463,67046,33523,
2021-01-25,5317,1045,4263,,311505,272999,235214,75570,37785,
2021-01-26,9375,2852,6495,,320880,275819,231540,88558,44279,
2021-01-27,9892,2860,7004,,330772,278650,227368,102564,51282,
2021-01-28,13103,5729,7332,,343875,284346,225732,117228,58614,
2021-01-29,10680,3268,7378,,354555,287583,221592,131982,65991,
2021-01-30,9180,2721,6422,,363735,290262,217852,144820,72410,
2021-01-31,3370,1560,1767,,367105,291788,217612,148352,74176,
2021-02-01,2118,481,1609,,369223,292235,216454,151562,75781,
2021-02-02,4402,1349,2995,,373625,293546,214774,157544,78772,
2021-02-03,6229,1711,4456,,379854,295216,211995,166442,83221,
2021-02-04,9070,1701,7290,,388924,296874,206369,181010,90505,
2021-02-05,8427,1455,6901,,397351,298289,200889,194800,97400,
2021-02-06,10654,1860,8735,,408005,300094,193968,212252,106126,
2021-02-07,7565,1722,5795,,415570,301777,189867,223820,111910,
2021-02-08,8214,3092,5080,,423784,304821,187844,233954,116977,
2021-02-09,14995,3851,11079,,438779,308630,180590,256080,128040,
2021-02-10,15500,4923,10518,,454279,313501,174968,277066,138533,
2021-02-11,16354,3894,12405,,470633,317343,166436,301814,150907,
2021-02-12,17646,2091,15505,,488279,319396,153003,332786,166393,
2021-02-13,16199,2437,13746,,504478,321788,141668,360240,180120,
2021-02-14,12870,914,11925,,517348,322654,130639,384030,192015,
2021-02-15,7859,483,7328,,525207,323089,123772,398634,199317,
2021-02-16,5989,1040,4899,,531196,324086,119893,408386,204193,
2021-02-17,10160,1604,8522,,541356,325646,112959,425374,212687,
2021-02-18,13862,2950,10868,,555218,328548,105023,447050,223525,
2021-02-19,18482,6210,12206,,573700,334706,99006,471400,235700,
2021-02-20,22613,11126,11436,,596313,345769,98671,494196,247098,
2021-02-21,17227,10373,6820,,613540,356082,102206,507752,253876,
2021-02-22,13573,8748,4774,,627113,364760,106160,517200,258600,
2021-02-23,17843,11110,6662,,644956,375814,110588,530452,265226,
2021-02-24,18559,13602,4876,,663515,389360,119300,540120,270060,
2021-02-25,20795,16480,4258,,684310,405774,131504,548540,274270,
2021-02-26,24873,21821,2992,,709183,427535,150310,554450,277225,
2021-02-27,27447,23573,3834,,736630,451044,170033,562022,281011,
2021-02-28,20577,19138,1405,,757207,470128,187754,564748,282374,
2021-03-01,18213,17020,1148,,775420,487087,203611,566952,283476,
2021-03-02,24665,22265,2316,,800085,509291,223545,571492,285746,
2021-03-03,30579,27951,2575,,830664,537191,248903,576576,288288,
2021-03-04,34672,32446,2142,,865336,569571,279191,580760,290380,
2021-03-05,39963,38141,1775,,905299,607664,315543,584242,292121,
2021-03-06,44125,41924,2163,,949424,649533,355290,588486,294243,
2021-03-07,32720,31545,1171,,982144,681004,385648,590712,295356,
2021-03-08,24033,22159,1861,,1006177,703095,405932,594326,297163,
2021-03-09,33272,29829,3415,,1039449,732858,432326,601064,300532,
2021-03-10,38317,34057,4215,,1077766,766841,462142,609398,304699,
2021-03-11,43961,40690,3232,,1121727,807465,499586,615758,307879,
2021-03-12,47685,45974,1688,,1169412,853375,543858,619034,309517,
2021-03-13,57885,55016,2842,,1227297,908320,596015,624610,312305,
2021-03-14,43381,42151,1214,,1270678,950388,636937,626902,313451,
2021-03-15,32798,31102,1681,,1303476,981431,666342,630178,315089,
2021-03-16,53930,51639,2275,,1357406,1033005,715684,634642,317321,
2021-03-17,61034,58503,2489,,1418440,1091442,771682,639520,319760,
2021-03-18,61513,59062,2426,,1479953,1150432,828299,644266,322133,
2021-03-19,64439,61121,3266,,1544392,1211475,886129,650692,325346,
2021-03-20,62539,59958,2550,,1606931,1271377,943529,655696,327848,
2021-03-21,43976,42460,1530,,1650907,1313772,984431,658682,329341,
2021-03-22,30988,30026,975,,1681895,1343710,1013450,660520,330260,
2021-03-23,54587,51816,2722,,1736482,1395431,1062512,665838,332919,
2021-03-24,76399,73223,3129,,1812881,1468564,1132573,671982,335991,
2021-03-25,82884,80307,2530,,1895765,1548792,1210328,676928,338464,
2021-03-26,86967,83442,3486,,1982732,1632153,1290255,683796,341898,
2021-03-27,80828,77881,2863,,2063560,1709931,1365235,689392,344696,
2021-03-28,66974,65388,1552,,2130534,1775229,1429038,692382,346191,
2021-03-29,51723,49038,2651,,2182257,1824187,1475391,697592,348796,
2021-03-30,73550,70148,3345,,2255807,1894258,1542158,704200,352100,
2021-03-31,93134,89492,3575,,2348941,1983652,1628030,711244,355622,
2021-04-01,89281,85416,3830,,2438222,2068970,1709571,718798,359399,
2021-04-02,93055,88834,4206,,2531277,2157718,1794165,727106,363553,
2021-04-03,60969,59298,1729,,2592246,2216925,1851694,730462,365231,
2021-04-04,72312,70666,1642,,2664558,2287480,1920665,733630,366815,
2021-04-05,53725,53256,469,,2718283,2340652,1973416,734472,367236,
2021-04-06,79563,77701,1881,,2797846,2418252,2049188,738128,369064,
2021-04-07,107983,104923,3052,,2905829,2523050,2150992,744116,372058,
2021-04-08,114052,110090,4020,,3019881,2633029,2257007,752044,376022,
2021-04-09,109815,105603,4288,,3129696,2738514,2358269,760490,380245,
2021-04-10,109200,105456,3841,,3238896,2843842,2459822,768040,384020,
2021-04-11,98598,95490,3253,,3337494,2939207,2551993,774428,387214,
2021-04-12,76054,74994,1153,,3413548,3014053,2625754,776598,388299,
2021-04-13,99445,96073,3394,,3512993,3110017,2718372,783290,391645,
2021-04-14,117016,113258,3648,,3630009,3223157,2827904,790506,395253,
2021-04-15,113536,109487,3892,,3743545,3332518,2933430,798176,399088,
2021-04-16,118096,113732,4189,,3861641,3446140,3042907,806466,403233,
2021-04-17,112385,107807,4439,,3974026,3553813,3146200,815226,407613,
2021-04-18,88717,86491,2095,,4062743,3640181,3230527,819308,409654,
2021-04-19,68953,67428,1446,,4131696,3707479,3296430,822098,411049,
2021-04-20,101897,98579,3115,,4233593,3805896,3391797,828198,414099,
2021-04-21,141967,137707,4028,,4375560,3943429,3525370,836118,418059,
2021-04-22,139443,135306,3900,,4515003,4078606,3656703,843806,421903,
2021-04-23,138160,131774,6146,,4653163,4210226,3782235,855982,427991,
2021-04-24,130252,126211,3872,,4783415,4336289,3904482,863614,431807,
2021-04-25,101999,98599,3173,,4885414,4434740,3999827,869826,434913,
2021-04-26,70986,69288,1552,,4956400,4503897,4067492,872810,436405,
2021-04-27,98477,95409,2880,,5054877,4599145,4159923,878444,439222,
2021-04-28,120548,115937,4422,,5175425,4714914,4271342,887144,443572,
2021-04-29,124446,119261,5040,,5299871,4834008,4385465,897086,448543,
2021-04-30,115779,110542,5003,,5415650,4944377,4490908,906938,453469,
2021-05-01,111252,107407,3634,,5526902,5051603,4594577,914052,457026,
2021-05-02,79116,76150,2854,,5606018,5127596,4667782,919628,459814,
2021-05-03,56771,55112,1591,,5662789,5182554,4721209,922690,461345,
2021-05-04,91899,88539,3278,,5754688,5270915,4806369,929092,464546,
2021-05-05,137967,133272,4611,,5892655,5404018,4934924,938188,469094,
2021-05-06,141807,136863,4807,,6034462,5540697,5066858,947678,473839,
2021-05-07,150233,145214,4823,,6184695,5685751,5207148,957206,478603,
2021-05-08,142421,137749,4424,,6327116,5823305,5340357,965896,482948,
2021-05-09,124776,121137,3474,,6451892,5944278,5457920,972716,486358,
2021-05-10,97785,95812,1874,,6549677,6039901,5551736,976330,488165,
2021-05-11,113475,108817,4480,,6663152,6148516,5655942,985148,492574,
2021-05-12,144997,137988,6864,,6808149,6286325,5786953,998744,499372,
2021-05-13,142628,135288,7197,,6950777,6421438,5914943,1012990,506495,
2021-05-14,148856,138748,9941,,7099633,6559998,6043627,1032742,516371,
2021-05-15,159691,149665,9852,,7259324,6709476,6183328,1052296,526148,
2021-05-16,144338,136070,8064,,7403662,6845378,6311246,1068264,534132,
2021-05-17,114949,110857,3940,,7518611,6956046,6418050,1075992,537996,
2021-05-18,111279,100424,10654,,7629890,7056274,6507686,1097176,548588,
2021-05-19,149832,133440,16218,,7779722,7189562,6624830,1129464,564732,
2021-05-20,151504,131535,19759,,7931226,7320908,6736486,1168844,584422,
2021-05-21,165324,140835,24234,,8096550,7461562,6852983,1217158,608579,
2021-05-22,199364,172191,26950,,8295914,7633556,6998108,1270896,635448,
2021-05-23,139789,127424,12222,,8435703,7760802,7113194,1295216,647608,
2021-05-24,100262,93297,6822,,8535965,7853926,7199566,1308720,654360,
2021-05-25,90402,82933,7262,,8626367,7936696,7275141,1323110,661555,
2021-05-26,139725,112969,26493,,8766092,8049478,7361500,1375956,687978,
2021-05-27,152018,123006,28761,,8918110,8172327,7455657,1433340,716670,
2021-05-28,163802,132264,31238,,9081912,8304418,7556569,1495698,747849,
2021-05-29,153337,117086,36020,,9235249,8421355,7637542,1567626,783813,
2021-05-30,149682,118983,30475,,9384931,8540168,7725942,1628452,814226,
2021-05-31,99179,79787,19202,,9484110,8619785,7786421,1666728,833364,
2021-06-01,124127,90562,33235,,9608237,8710152,7843628,1733048,866524,
2021-06-02,145257,102109,42902,,9753494,8812080,7902723,1818714,909357,
2021-06-03,155306,99867,55163,,9908800,8911763,7947314,1928898,964449,
2021-06-04,181661,115500,65894,,10090461,9027064,7996809,2060510,1030255,
2021-06-05,171958,103389,68295,,10262419,9130255,8031790,2196930,1098465,
2021-06-06,163343,91827,71238,,10425762,9221904,8052271,2339266,1169633,
2021-06-07,119539,63033,56289,,10545301,9284740,8058893,2451694,1225847,
2021-06-08,161851,72417,88999,,10707152,9356968,8042202,2629532,1314766,
2021-06-09,181406,70770,110175,,10888558,9427561,8002701,2849720,1424860,
2021-06-10,185529,66391,118652,,11074087,9493749,7950328,3086842,1543421,
2021-06-11,204738,67485,136500,,11278825,9561048,7881209,3359678,1679839,
2021-06-12,199667,62639,136431,,11478492,9623505,7807327,3632356,1816178,
2021-06-13,190283,58849,130909,,11668775,9682179,7735172,3894014,1947007,
2021-06-14,137653,38670,98590,,11806428,9720653,7675161,4090984,2045492,
2021-06-15,189169,42573,146245,,11995597,9763008,7571368,4383280,2191640,
2021-06-16,206078,42405,163036,,12201675,9805217,7450644,4709146,2354573,
2021-06-17,210359,37912,171875,,12412034,9842914,7316558,5052712,2526356,
2021-06-18,217100,35333,181167,,12629134,9878057,7170626,5414862,2707431,
2021-06-19,215816,35467,179684,,12844950,9913318,7026315,5774006,2887003,
2021-06-20,186214,35536,150107,,13031164,9948656,6911654,6074004,3037002,
2021-06-21,120402,20813,99096,,13151566,9969274,6833268,6272012,3136006,
2021-06-22,204879,27484,176649,,13356445,9996564,6684018,6625092,3312546,
2021-06-23,230460,28595,201135,,13586905,10024959,6511386,7027146,3513573,
2021-06-24,227635,26652,200239,,13814540,10051415,6337713,7427404,3713702,
2021-06-25,251049,27954,222359,,14065589,10079168,6143225,7871886,3935943,
2021-06-26,261233,29973,230560,,14326822,10108916,5942553,8332726,4166363,
2021-06-27,204948,27761,176589,,14531770,10136495,5793653,8685684,4342842,
2021-06-28,199219,20944,177719,,14730989,10157241,5636805,9040872,4520436,
2021-06-29,250062,24470,224874,,14981051,10181470,5436314,9490312,4745156,
2021-06-30,275483,24158,250762,,15256534,10205425,5209636,9991578,4995789,
2021-07-01,271931,25292,246091,,15528465,10230499,4988758,10483482,5241741,
2021-07-02,144686,11571,132892,,15673151,10241896,4867365,10749062,5374531,
2021-07-03,216850,19903,196719,,15890001,10261577,4690476,11142202,5571101,
2021-07-04,196116,19379,176516,,16086117,10280770,4533272,11494996,5747498,
2021-07-05,148693,12432,136120,,16234810,10293013,4409522,11766982,5883491,
2021-07-06,219988,19973,199802,,16454798,10312770,4229623,12166294,6083147,
2021-07-07,246576,22954,223385,,16701374,10335498,4029114,12612768,6306384,
2021-07-08,231153,21331,209614,,16932527,10356623,3840760,13031726,6515863,
2021-07-09,226945,21488,205291,,17159472,10377909,3656887,13442044,6721022,
2021-07-10,209016,20521,188341,,17368488,10398226,3489000,13818452,6909226,
2021-07-11,171638,17562,153952,,17540126,10415587,3352556,14126062,7063031,
2021-07-12,123112,11440,111576,,17663238,10426838,3252368,14348940,7174470,
2021-07-13,178436,18998,159296,,17841674,10445614,3112003,14667222,7333611,
2021-07-14,179996,19284,160557,,18021670,10464684,2970679,14988010,7494005,
2021-07-15,167157,19570,147416,,18188827,10484043,2842786,15282514,7641257,
2021-07-16,169297,19872,149276,,18358124,10503713,2713333,15580760,7790380,
2021-07-17,172938,20237,152578,,18531062,10523701,2580935,15885532,7942766,
2021-07-18,133587,15911,117538,,18664649,10539428,2479272,16120312,8060156,
2021-07-19,91947,10404,81437,,18756596,10549619,2408201,16282836,8141418,
2021-07-20,133497,16927,116510,,18890093,10566306,2308554,16515504,8257752,
2021-07-21,140047,16968,123008,,19030140,10583059,2202461,16761196,8380598,
2021-07-22,125556,17617,107806,,19155696,10600452,2112225,16976454,8488227,
2021-07-23,120207,16967,103033,,19275903,10617178,2026117,17182122,8591061,
2021-07-24,126646,18314,108097,,19402549,10635289,1936294,17397990,8698995,
2021-07-25,103595,14835,88633,,19506144,10649900,1862453,17574894,8787447,
2021-07-26,66661,9876,56694,,19572805,10659558,1815598,17687920,8843960,
2021-07-27,92342,15300,76880,,19665147,10674597,1753974,17841246,8920623,
2021-07-28,93895,16438,77381,,19759042,10690800,1692987,17995626,8997813,
2021-07-29,89342,16678,72505,,19848384,10707246,1637116,18140260,9070130,
2021-07-30,84003,16077,67818,,19932387,10723095,1585335,18275520,9137760,
2021-07-31,83777,15672,67953,,20016164,10738549,1533026,18411046,9205523,
2021-08-01,61838,11304,50353,,20078002,10749627,1493942,18511370,9255685,
2021-08-02,42451,7396,34938,,20120453,10756825,1466368,18580914,9290457,
2021-08-03,33241,5933,27141,,20153694,10762525,1445137,18634776,9317388,
2021-08-04,61275,12354,48731,,20214969,10774644,1408723,18731842,9365921,
2021-08-05,59413,12520,46739,,20274382,10786956,1374460,18824992,9412496,
2021-08-06,55966,11833,43918,,20330348,10798529,1342344,18912370,9456185,
2021-08-07,62327,12114,50017,,20392675,10810382,1304398,19011968,9505984,
2021-08-08,48621,9236,39201,,20441296,10819390,1274410,19089960,9544980,
2021-08-09,30836,5929,24733,,20472132,10825105,1255579,19139052,9569526,
2021-08-10,49199,10483,38420,,20521331,10835308,1227608,19215400,9607700,
2021-08-11,48676,10750,37688,,20570007,10845811,1200639,19290344,9645172,
2021-08-12,49197,11176,37799,,20619204,10856737,1173974,19365526,9682763,
2021-08-13,49571,11708,37596,,20668775,10868204,1148056,19440296,9720148,
2021-08-14,51167,12117,38845,,20719942,10880071,1121302,19517538,9758769,
2021-08-15,41711,9824,31667,,20761653,10889693,1099429,19580528,9790264,
2021-08-16,26703,6164,20385,,20788356,10895634,1085182,19620904,9810452,
2021-08-17,40450,11031,29159,,20828806,10906415,1067030,19678770,9839385,
2021-08-18,41854,11946,29666,,20870660,10918119,1049278,19737682,9868841,
2021-08-19,45838,16501,29077,,20916498,10934369,1036674,19795390,9897695,
2021-08-20,46390,16265,29713,,20962888,10950378,1023199,19854358,9927179,
2021-08-21,47903,15126,32410,,21010791,10965244,1005882,19918724,9959362,
2021-08-22,34350,10792,23294,,21045141,10975790,993356,19964868,9982434,
2021-08-23,23200,6994,15987,,21068341,10982549,984342,19996414,9998207,
2021-08-24,37609,13355,23805,,21105950,10995650,973869,20043562,10021781,
2021-08-25,41276,14389,26290,,21147226,11009783,961949,20095668,10047834,
2021-08-26,39228,13543,24943,,21186454,11023050,950514,20145072,10072536,
2021-08-27,37613,12902,23671,,21224067,11035711,939718,20191986,10095993,
2021-08-28,40057,13400,25486,,21264124,11048834,927608,20242452,10121226,
2021-08-29,30515,10233,19929,,21294639,11058835,917893,20281884,10140942,
2021-08-30,18215,6131,11837,,21312854,11064718,912158,20305120,10152560,
2021-08-31,32668,11923,19598,,21345522,11076373,904455,20343836,10171918,
2021-09-01,36183,12919,21922,,21381705,11089059,895436,20387246,10193623,
2021-09-02,37709,15617,19635,,21419414,11104424,891393,20426062,10213031,
2021-09-03,46818,21058,22413,,21466232,11125234,890019,20470430,10235215,
2021-09-04,46838,20579,24745,,21513070,11145568,885830,20519476,10259738,
2021-09-05,33030,14194,18552,,21546100,11159518,881452,20556132,10278066,
2021-09-06,21674,9475,12017,,21567774,11168744,878893,20579702,10289851,
2021-09-07,14959,6708,8070,,21582733,11175195,877514,20595362,10297681,
2021-09-08,41100,17093,20916,,21623833,11192024,873673,20636702,10318351,
2021-09-09,41402,16953,19653,,21665235,11208700,870948,20675504,10337752,
2021-09-10,39593,15489,18975,,21704828,11223927,867444,20712966,10356483,
2021-09-11,42334,15917,23319,,21747162,11239565,860021,20759088,10379544,
2021-09-12,29933,11523,17851,,21777095,11250794,853663,20794262,10397131,
2021-09-13,16057,6393,9169,,21793152,11256953,850872,20812162,10406081,
2021-09-14,29866,11546,15270,,21823018,11268198,847121,20842154,10421077,
2021-09-15,39244,14007,19407,,21862262,11281946,841706,20880480,10440240,
2021-09-16,39308,13968,19229,,21901570,11295679,836422,20918514,10459257,
2021-09-17,38880,13592,19312,,21940450,11309028,830690,20956676,10478338,
2021-09-18,41180,14071,23489,,21981630,11322826,821251,21003150,10501575,
2021-09-19,30613,10820,18954,,22012243,11333387,813104,21040566,10520283,
2021-09-20,16720,6100,10169,,22028963,11339233,809012,21060442,10530221,
2021-09-21,31322,11201,16969,,22060285,11350169,803228,21093882,10546941,
2021-09-22,41776,14806,22906,,22102061,11364679,795107,21139144,10569572,
2021-09-23,47191,16126,26009,,22149252,11380542,785205,21190674,10595337,
2021-09-24,46255,15621,26616,,22195507,11395902,774191,21243422,10621711,
2021-09-25,48158,15245,29923,,22243665,11410894,759494,21302800,10651400,
2021-09-26,37450,12406,24455,,22281115,11423025,747424,21351202,10675601,
2021-09-27,19142,6527,12310,,22300257,11429298,741625,21375346,10687673,
2021-09-28,30915,11281,17853,,22331172,11440320,735041,21410558,10705279,
2021-09-29,37849,12465,21702,,22369021,11452514,725784,21453460,10726730,
2021-09-30,37292,11636,21346,,22406313,11463891,716055,21495672,10747836,
2021-10-01,30836,9799,18386,,22437149,11473464,707455,21532018,10766009,
2021-10-02,37099,11149,23562,,22474248,11484343,695024,21578638,10789319,
2021-10-03,27193,8159,18317,,22501441,11492261,684853,21614816,10807408,
2021-10-04,14862,4744,9799,,22516303,11496759,679780,21633958,10816979,
2021-10-05,26778,8580,15843,,22543081,11505078,672502,21665152,10832576,
2021-10-06,31631,9631,18487,,22574712,11514450,663638,21701624,10850812,
2021-10-07,30317,9386,17101,,22605029,11523585,655910,21735350,10867675,
2021-10-08,32798,10731,18831,,22637827,11534046,647797,21772498,10886249,
2021-10-09,34100,10650,20988,,22671927,11544433,637445,21813976,10906988,
2021-10-10,23382,7654,15064,,22695309,11551837,630023,21843628,10921814,
2021-10-11,11989,3837,7858,,22707298,11555424,625986,21858876,10929438,
2021-10-12,5086,1620,3253,,22712384,11556766,624338,21864856,10932428,
2021-10-13,29078,9184,18066,,22741462,11565660,615440,21900440,10950220,
2021-10-14,28985,8899,17731,,22770447,11574284,606598,21935372,10967686,
2021-10-15,29053,8816,18145,,22799500,11582837,597256,21971162,10985581,
2021-10-16,31119,8978,19860,,22830619,11591524,586362,22010324,11005162,
2021-10-17,23673,7248,15356,,22854292,11598518,578241,22040554,11020277,
2021-10-18,12296,3746,8141,,22866588,11601983,573834,22056298,11028149,
2021-10-19,21239,6618,12612,,22887827,11608319,567827,22080984,11040492,
2021-10-20,25621,7533,14892,,22913448,11615605,560455,22110300,11055150,
2021-10-21,23148,6672,13017,,22936596,11622008,554099,22135818,11067909,
2021-10-22,26079,7299,15089,,22962675,11628985,546293,22165384,11082692,
2021-10-23,28147,7598,17138,,22990822,11636321,536746,22199150,11099575,
2021-10-24,19325,5729,12577,,23010147,11641794,529886,22223816,11111908,
2021-10-25,9918,2710,6470,,23020065,11644235,526118,22236234,11118117,
2021-10-26,18861,5379,11071,,23038926,11649336,520417,22257838,11128919,
2021-10-27,22812,6067,13186,,23061738,11655148,513284,22283728,11141864,
2021-10-28,22274,5790,12624,,23084012,11660650,506439,22308422,11154211,
2021-10-29,22779,5725,13028,,23106791,11666074,499122,22333904,11166952,
2021-10-30,24076,6030,14595,,23130867,11671832,490545,22362574,11181287,
2021-10-31,16451,4586,10584,,23147318,11676124,484542,22383164,11191582,
2021-11-01,7857,2075,5051,,23155175,11677919,481553,22392732,11196366,
2021-11-02,15604,4363,7731,,23170779,11681991,478174,22407634,11203817,
2021-11-03,18598,5065,9591,,23189377,11686753,473638,22426230,11213115,
2021-11-04,19471,4863,10013,,23208848,11691340,468473,22445734,11222867,
2021-11-05,21434,4394,9508,,23230282,11695445,463345,22464200,11232100,
2021-11-06,25309,5199,12145,,23255591,11700375,456382,22487986,11243993,
2021-11-07,21426,4020,8905,,23277017,11704115,451485,22505260,11252630,
2021-11-08,11983,2108,4728,,23289000,11705928,448849,22514158,11257079,
2021-11-09,24087,3843,7622,,23313087,11709450,445060,22528780,11264390,
2021-11-10,28441,4502,8973,,23341528,11713674,440575,22546198,11273099,
2021-11-11,28726,4294,9080,,23370254,11717672,435780,22563784,11281892,
2021-11-12,26710,4155,8216,,23396964,11721536,431705,22579662,11289831,
2021-11-13,34272,5070,11391,,23431236,11726300,425375,22601850,11300925,
2021-11-14,23192,3896,8590,,23454428,11729933,420674,22618518,11309259,
2021-11-15,12689,2186,4486,,23467117,11731859,418366,22626986,11313493,
2021-11-16,26143,3920,7463,,23493260,11735522,414819,22641406,11320703,
2021-11-17,31129,4046,7787,,23524389,11739286,411068,22656436,11328218,
2021-11-18,32460,3849,7505,,23556849,11742830,407398,22670864,11335432,
2021-11-19,35431,3855,7732,,23592280,11746385,403509,22685752,11342876,
2021-11-20,40093,4380,8807,,23632373,11750486,399073,22702826,11351413,
2021-11-21,28090,3431,6935,,23660463,11753655,395555,22716200,11358100,
2021-11-22,14883,1948,3887,,23675346,11755327,393610,22723434,11361717,
2021-11-23,33029,3269,5995,,23708375,11758316,390876,22734880,11367440,
2021-11-24,42610,3748,6782,,23750985,11761760,387831,22747858,11373929,
2021-11-25,46003,3929,6545,,23796988,11765415,385212,22760406,11380203,
2021-11-26,52803,11340,6596,,23849791,11776485,389949,22773072,11386536,
2021-11-27,63479,22346,7015,,23913270,11798550,405270,22786560,11393280,
2021-11-28,51431,27732,5302,,23964701,11825990,427688,22796604,11398302,
2021-11-29,33509,18931,2871,,23998210,11844660,443737,22801846,11400923,
2021-11-30,55977,20666,5111,,24054187,11865045,459282,22811526,11405763,
2021-12-01,69501,26235,5614,,24123688,11890974,479889,22822170,11411085,
2021-12-02,71589,26479,5017,,24195277,11917156,501338,22831636,11415818,
2021-12-03,73374,25093,5144,,24268651,11941953,521281,22841344,11420672,
2021-12-04,81117,27781,6051,47264,24349768,11969441,543002,,11426439,807261
2021-12-05,62607,31926,4397,26265,24412375,12001072,570523,,11430549,833422
2021-12-06,38612,19139,2706,16752,24450987,12019922,586949,,11432973,850096
2021-12-07,60248,14846,4449,40940,24511235,12034497,597336,,11437161,890962
2021-12-08,73412,19052,4667,49691,24584647,12053272,611711,,11441561,940575
2021-12-09,74463,18270,4329,51845,24659110,12071233,625644,,11445589,992335
2021-12-10,77432,17586,4628,55210,24736542,12088538,638597,,11449941,1047464
2021-12-11,83141,20402,5810,56917,24819683,12108651,653175,,11455476,1104295
2021-12-12,60725,22692,4144,33848,24880408,12131063,671717,,11459346,1138054
2021-12-13,34910,11594,2401,20893,24915318,12142360,680900,,11461460,1158852
2021-12-14,101926,8995,3846,89043,25017244,12151046,686035,,11465011,1247775
2021-12-15,127652,12422,4495,110699,25144896,12163164,693952,,11469212,1358374
2021-12-16,139297,12446,4229,122611,25284193,12175324,702159,,11473165,1480886
2021-12-17,159125,12394,4501,142207,25443318,12187443,710043,,11477400,1622996
2021-12-18,175542,13520,4910,157070,25618860,12200669,718641,,11482028,1779971
2021-12-19,140398,18155,3922,118288,25759258,12218523,732866,,11485657,1898148
2021-12-20,106798,10305,2741,93709,25866056,12228560,740420,,11488140,1991759
2021-12-21,215191,12962,4304,197904,26081247,12241206,749071,,11492135,2189542
2021-12-22,237162,14418,5181,217680,26318409,12255326,758294,,11497032,2407105
2021-12-23,257374,11707,5070,240502,26575783,12266730,764925,,11501805,2647501
2021-12-24,223351,9441,4546,209303,26799134,12275874,769816,,11506058,2856688
2021-12-25,89684,3885,2499,83312,26888818,12279484,771197,,11508287,2939893
2021-12-26,11891,387,354,11140,26900709,12279579,771222,,11508357,2950903
2021-12-27,46916,1495,1108,44285,26947625,12280829,771602,,11509227,2995068
2021-12-28,144729,6097,3988,134583,27092354,12286632,773700,,11512932,3129520
2021-12-29,175427,9373,4564,161421,27267781,12295710,778505,,11517205,3290814
2021-12-30,200004,10125,5335,184503,27467785,12305532,783280,,11522252,3475183
2021-12-31,195165,10005,5787,179122,27662950,12315248,787489,,11527759,3654179
2022-01-01,96918,5375,3871,87347,27759868,12320315,788985,,11531330,3741378
2022-01-02,19431,937,923,17442,27779299,12320961,788990,,11531971,3758674
2022-01-03,88238,4772,4589,78795,27867537,12325423,789165,,11536258,3837316
2022-01-04,146322,5998,5304,134980,28013859,12331093,789846,,11541247,3972140
2022-01-05,177432,7614,7284,162362,28191291,12338353,790165,,11548188,4134342
2022-01-06,191475,7196,6778,176978,28382766,12345230,790572,,11554658,4311165
2022-01-07,191184,7948,6978,175449,28573950,12352834,791530,,11561304,4486441
2022-01-08,181601,8612,6626,165178,28755551,12361114,793503,,11567611,4651463
2022-01-09,131068,9860,7170,113947,28886619,12370653,796188,,11574465,4765250
2022-01-10,90544,5105,4487,80825,28977163,12375436,796796,,11578640,4845922
2022-01-11,138830,6149,6558,125417,29115993,12381239,796374,,11584865,4971150
2022-01-12,156971,8154,8038,138660,29272964,12389064,796485,,11592579,5109642
2022-01-13,162620,9206,9201,141505,29435584,12397908,796476,,11601432,5250964
2022-01-14,159804,10742,10364,136009,29595388,12408290,796849,,11611441,5386776
2022-01-15,161159,11005,11665,135855,29756547,12418925,796178,,11622747,5522438
2022-01-16,109745,9282,9669,89439,29866292,12427846,795784,,11632062,5611660
2022-01-17,65754,5934,6553,52626,29932046,12433446,795155,,11638291,5664102
2022-01-18,36073,2000,2116,31136,29968119,12435092,795029,,11640063,5695042
2022-01-19,101273,5573,6709,85932,30069392,12440265,793875,,11646390,5780747
2022-01-20,103560,6325,6996,85706,30172952,12446207,793196,,11653011,5866231
2022-01-21,102064,6227,8048,82476,30275016,12452031,791361,,11660670,5948480
2022-01-22,102540,8707,12064,78092,30377556,12460349,787997,,11672352,6026344
2022-01-23,76660,7303,13979,54779,30454216,12467309,781314,,11685995,6080901
2022-01-24,42240,3190,7928,30734,30496456,12470135,776558,,11693577,6111428
2022-01-25,62537,3754,8362,48104,30558993,12473510,771935,,11701575,6159314
2022-01-26,77857,4911,13163,55676,30636850,12478046,763678,,11714368,6214749
2022-01-27,78041,4893,13237,56026,30714891,12482567,755324,,11727243,6270538
2022-01-28,77249,4667,13667,53874,30792140,12486876,746311,,11740565,6324193
2022-01-29,84787,5528,17701,58098,30876927,12492042,734131,,11757911,6382047
2022-01-30,66479,5024,20620,40141,30943406,12496724,718521,,11778203,6421963
2022-01-31,34723,2174,9873,22336,30978129,12498579,710813,,11787766,6444110
2022-02-01,51326,3266,9650,36515,31029455,12501492,704419,,11797073,6480400
2022-02-02,57686,3844,12388,38668,31087141,12505006,695860,,11809146,6518869
2022-02-03,52568,3609,11505,34295,31139709,12508239,687952,,11820287,6552913
2022-02-04,43064,2943,10554,27271,31182773,12510873,680331,,11830542,6579991
2022-02-05,58695,3737,14463,37556,31241468,12514280,669593,,11844687,6617335
2022-02-06,49841,3637,16110,29565,31291309,12517595,657115,,11860480,6646676
2022-02-07,23218,1687,7804,13434,31314527,12518956,650985,,11867971,6659886
2022-02-08,33360,2350,7236,21958,31347887,12520976,646092,,11874884,6681611
2022-02-09,38858,2780,8908,24403,31386745,12523398,639958,,11883440,6705762
2022-02-10,37518,2763,8826,22546,31424263,12525826,633891,,11891935,6728079
2022-02-11,39417,2717,10283,22993,31463680,12528197,626316,,11901881,6750834
2022-02-12,42023,2953,11449,25304,31505703,12530817,617809,,11913008,6775914
2022-02-13,36297,2799,13137,19935,31542000,12533330,607468,,11925862,6795651
2022-02-14,16959,1173,6113,9465,31558959,12534228,602520,,11931708,6804916
2022-02-15,19323,1381,4737,11866,31578282,12535287,599154,,11936133,6816556
2022-02-16,26004,1763,7723,14943,31604286,12536754,593190,,11943564,6831299
2022-02-17,26742,1679,7517,14978,31631028,12538079,587343,,11950736,6846023
2022-02-18,23917,1352,6597,13668,31654945,12539114,582086,,11957028,6859482
2022-02-19,37816,1902,8330,26042,31692761,12540685,575653,,11965032,6885283
2022-02-20,32557,1491,7957,22801,31725318,12541877,569179,,11972698,6907881
2022-02-21,17494,912,3675,12755,31742812,12542494,566407,,11976087,6920425
2022-02-22,9088,427,1545,6947,31751900,12542632,565284,,11977348,6927162
2022-02-23,25316,1326,4784,17289,31777216,12543650,561819,,11981831,6944217
2022-02-24,24551,1395,5232,15471,31801767,12544725,557978,,11986747,6959446
2022-02-25,23084,1384,5131,14503,31824851,12545814,554224,,11991590,6973722
2022-02-26,25210,1383,5902,16547,31850061,12546887,549698,,11997189,6990043
2022-02-27,26937,1366,7359,17698,31876998,12547984,543694,,12004290,7007546
2022-02-28,10122,593,2525,6744,31887120,12548324,541754,,12006570,7014107
2022-03-01,13174,942,3142,8158,31900294,12548961,539544,,12009417,7022048
2022-03-02,15403,1162,3574,9612,31915697,12549862,537125,,12012737,7031483
2022-03-03,14287,1076,3222,8684,31929984,12550627,534972,,12015655,7039936
2022-03-04,14454,989,3439,8307,31944438,12551295,532518,,12018777,7047990
2022-03-05,18518,1276,4990,11179,31962956,12552263,528793,,12023470,7058946
2022-03-06,16502,1086,5521,9599,31979458,12553070,524352,,12028718,7068338
2022-03-07,5937,462,1854,3508,31985395,12553247,522953,,12030294,7071629
2022-03-08,7348,698,1933,4155,31992743,12553667,521711,,12031956,7075585
2022-03-09,11150,906,2735,6402,32003893,12554297,519876,,12034421,7081785
2022-03-10,12743,1040,3246,6831,32016636,12555060,517663,,12037397,7088403
2022-03-11,12875,902,3402,6860,32029511,12555673,515155,,12040518,7095047
2022-03-12,14669,1044,4173,8307,32044180,12556446,512023,,12044423,7103151
2022-03-13,14737,1089,4995,8329,32058917,12557246,508113,,12049133,7111245
2022-03-14,6321,448,2223,3494,32065238,12557425,506335,,12051090,7114526
2022-03-15,10188,789,2620,5972,32075426,12557924,504492,,12053432,7120284
2022-03-16,13047,931,3660,6950,32088473,12558567,501760,,12056807,7127004
2022-03-17,13167,1042,3953,6751,32101640,12559322,498842,,12060480,7133536
2022-03-18,11895,910,3142,6429,32113535,12559930,496600,,12063330,7139742
2022-03-19,14426,1002,4158,7895,32127961,12560653,493442,,12067211,7147419
2022-03-20,11728,990,3949,6363,32139689,12561373,490478,,12070895,7153574
2022-03-21,5053,413,1589,2812,32144742,12561528,489298,,12072230,7156184
2022-03-22,6695,550,1553,3886,32151437,12561793,488290,,12073503,7159856
2022-03-23,9960,783,2296,5191,32161397,12562261,486774,,12075487,7164806
2022-03-24,9282,723,2374,4605,32170679,12562720,485114,,12077606,7169207
2022-03-25,9209,781,2148,4743,32179888,12563238,483739,,12079499,7173738
2022-03-26,10916,932,2830,5502,32190804,12563895,481839,,12082056,7179023
2022-03-27,10217,908,3535,5297,32201021,12564544,479208,,12085336,7184109
2022-03-28,3577,319,1107,1986,32204598,12564625,478417,,12086208,7185902
2022-03-29,5331,499,1208,2684,32209929,12564842,477702,,12087140,7188365
2022-03-30,7841,747,1829,4119,32217770,12565311,476615,,12088696,7192260
2022-03-31,8642,689,1923,4410,32226412,12565712,475375,,12090337,7196449
2022-04-01,9297,801,1910,4884,32235709,12566221,474257,,12091964,7201094
2022-04-02,10424,888,2207,5562,32246133,12566822,472926,,12093896,7206439
2022-04-03,9191,877,2565,5062,32255324,12567446,471232,,12096214,7211303
2022-04-04,4193,387,1004,2405,32259517,12567572,470612,,12096960,7213505
2022-04-05,6058,597,1033,3048,32265575,12567830,470170,,12097660,7216279
2022-04-06,8364,715,1478,4371,32273939,12568255,469402,,12098853,7220424
2022-04-07,10326,732,1681,4834,32284265,12568688,468448,,12100240,7225016
2022-04-08,23980,811,1576,4834,32308245,12569221,467677,,12101544,7229634
2022-04-09,30467,968,1968,5893,32338712,12569892,466668,,12103224,7235305
2022-04-10,24844,978,2383,5330,32363556,12570613,465257,,12105356,7240435
2022-04-11,12567,385,874,2431,32376123,12570749,464764,,12105985,7242665
2022-04-12,28101,691,1013,3532,32404224,12571138,464435,,12106703,7245965
2022-04-13,37764,851,1552,4925,32441988,12571690,463730,,12107960,7250660
2022-04-14,37875,761,1607,4906,32479863,12572140,462881,,12109259,7255314
2022-04-15,43389,1230,2101,6725,32523252,12573073,462006,,12111067,7261803
2022-04-16,8086,358,649,1736,32531338,12573171,461713,,12111458,7263323
2022-04-17,21001,869,1923,4312,32552339,12573756,460652,,12113104,7267412
2022-04-18,5453,305,460,1287,32557792,12573777,460492,,12113285,7268461
2022-04-19,22644,615,770,3101,32580436,12574111,460328,,12113783,7271343
2022-04-20,40317,1062,1393,4614,32620753,12574847,459994,,12114853,7275693
2022-04-21,38739,940,1597,4677,32659492,12575492,459329,,12116163,7280136
2022-04-22,35605,1010,1426,4263,32695097,12576230,458906,,12117324,7284181
2022-04-23,34636,1004,1732,4711,32729733,12576953,458175,,12118778,7288655
2022-04-24,20800,1020,1879,3777,32750533,12577723,457313,,12120410,7292238
2022-04-25,8297,451,692,1707,32758830,12577906,457071,,12120835,7293730
2022-04-26,24597,732,939,3136,32783427,12578347,456858,,12121489,7296630
2022-04-27,33588,955,1366,3932,32817015,12579027,456439,,12122588,7300346
2022-04-28,32824,927,1411,3927,32849839,12579682,455947,,12123735,7304050
2022-04-29,32039,1095,1373,3908,32881878,12580481,455662,,12124819,7307730
2022-04-30,30266,920,1532,4020,32912144,12581106,455044,,12126062,7311515
2022-05-01,16744,767,1576,2969,32928888,12581577,454230,,12127347,7314242
2022-05-02,5931,307,524,1097,32934819,12581590,454009,,12127581,7315113
2022-05-03,20917,588,827,2344,32955736,12581873,453764,,12128109,7317218
2022-05-04,29403,799,1090,3290,32985139,12582363,453468,,12128895,7320259
2022-05-05,29085,871,1159,3121,33014224,12582923,453170,,12129753,7323137
2022-05-06,29079,1146,1279,2983,33043303,12583783,453032,,12130751,7325895
2022-05-07,28480,869,1261,3109,33071783,12584364,452635,,12131729,7328781
2022-05-08,15995,896,1309,2321,33087778,12585003,452220,,12132783,7330901
2022-05-09,5896,292,474,943,33093674,12585030,452032,,12132998,7331635
2022-05-10,21217,695,717,2117,33114891,12585408,452003,,12133405,7333493
2022-05-11,28935,835,1079,2651,33143826,12585914,451755,,12134159,7335874
2022-05-12,28229,800,1081,2510,33172055,12586418,451470,,12134948,7338143
2022-05-13,27586,879,1114,2467,33199641,12586990,451231,,12135759,7340356
2022-05-14,25681,808,1096,2607,33225322,12587483,450936,,12136547,7342709
2022-05-15,14842,751,1272,2054,33240164,12587964,450408,,12137556,7344546
2022-05-16,6379,325,532,1047,33246543,12588052,450197,,12137855,7345407
2022-05-17,19591,584,775,1740,33266134,12588324,449999,,12138325,7346900
2022-05-18,26536,877,1096,2271,33292670,12588938,449775,,12139163,7348956
2022-05-19,24425,681,1155,2155,33317095,12589352,449294,,12140058,7350894
2022-05-20,24254,799,1133,2215,33341349,12589886,448956,,12140930,7352894
2022-05-21,22391,692,1164,2344,33363740,12590272,448475,,12141797,7354999
2022-05-22,10552,551,887,1484,33374292,12590563,448134,,12142429,7356267
2022-05-23,4558,241,460,784,33378850,12590547,447913,,12142634,7356843
2022-05-24,2605,118,176,429,33381455,12590412,447853,,12142559,7357063
2022-05-25,19349,656,943,1950,33400804,12590804,447556,,12143248,7358805
2022-05-26,20630,661,948,1907,33421434,12591194,447263,,12143931,7360492
2022-05-27,21744,815,1055,2070,33443178,12591728,447020,,12144708,7362336
2022-05-28,19394,723,1162,2143,33462572,12592184,446578,,12145606,7364268
2022-05-29,12101,759,1279,1724,33474673,12592709,446051,,12146658,7365800
2022-05-30,4575,311,548,751,33479248,12592775,445811,,12146964,7366354
2022-05-31,13541,571,748,1663,33492789,12593046,445628,,12147418,7367778
2022-06-01,16603,702,970,1875,33509392,12593445,445359,,12148086,7369399
2022-06-02,14589,555,864,1668,33523981,12593690,445043,,12148647,7370827
2022-06-03,16088,696,1091,1809,33540069,12594111,444642,,12149469,7372419
2022-06-04,13305,648,1159,1840,33553374,12594505,444127,,12150378,7374059
2022-06-05,7864,587,1109,1430,33561238,12594844,443601,,12151243,7375298
2022-06-06,3293,206,444,641,33564531,12594805,443360,,12151445,7375741
2022-06-07,11202,474,724,1361,33575733,12594981,443105,,12151876,7376858
2022-06-08,14051,667,1012,1605,33589784,12595393,442755,,12152638,7378247
2022-06-09,13362,663,920,1670,33603146,12595769,442493,,12153276,7379686
2022-06-10,13839,683,1063,1693,33616985,12596170,442105,,12154065,7381153
2022-06-11,12971,613,1030,1863,33629956,12596502,441686,,12154816,7382798
2022-06-12,8090,643,1235,1498,33638046,12596890,441090,,12155800,7384092
2022-06-13,3186,284,422,709,33641232,12596911,440947,,12155964,7384595
2022-06-14,10121,510,666,1262,33651353,12597133,440785,,12156348,7385620
2022-06-15,13496,470,828,1620,33664849,12597312,440425,,12156887,7387006
2022-06-16,12527,490,854,1615,33677376,12597503,440056,,12157447,7388379
2022-06-17,11685,478,815,1652,33689061,12597696,439712,,12157984,7389797
2022-06-18,11441,435,873,1859,33700502,12597862,439271,,12158591,7391433
2022-06-19,6998,482,896,1420,33707500,12598099,438856,,12159243,7392646
2022-06-20,2286,147,301,643,33709786,12598030,438696,,12159334,7393124
2022-06-21,9534,358,614,1381,33719320,12598103,438435,,12159668,7394259
2022-06-22,13601,407,724,1697,33732921,12598241,438111,,12160130,7395734
2022-06-23,13691,399,772,1679,33746612,12598382,437736,,12160646,7397205
2022-06-24,15356,433,811,1669,33761968,12598562,437354,,12161208,7398664
2022-06-25,14460,424,850,1708,33776428,12598730,436917,,12161813,7400168
2022-06-26,8155,432,885,1279,33784583,12598910,436457,,12162453,7401238
2022-06-27,3209,171,363,592,33787792,12598841,436261,,12162580,7401629
2022-06-28,9608,370,554,1218,33797400,12598930,436073,,12162857,7402617
2022-06-29,13298,411,725,1627,33810698,12599055,435757,,12163298,7404008
2022-06-30,12219,482,846,1573,33822917,12599257,435391,,12163866,7405352
2022-07-01,13033,548,969,1946,33835950,12599554,434965,,12164589,7407097
2022-07-02,1605,110,114,361,33837555,12599393,434959,,12164434,7407230
2022-07-03,5155,261,491,957,33842710,12599407,434720,,12164687,7407981
2022-07-04,2755,131,279,614,33845465,12599295,434571,,12164724,7408401
2022-07-05,11138,372,598,1571,33856603,12599375,434337,,12165038,7409729
2022-07-06,15949,545,855,2007,33872552,12599630,434021,,12165609,7411499
2022-07-07,15649,519,830,1921,33888201,12599865,433709,,12166156,7413171
2022-07-08,17870,552,869,2241,33906071,12600123,433391,,12166732,7415169
2022-07-09,14131,449,596,1841,33920202,12600303,433243,,12167060,7416781
2022-07-10,8736,472,752,1499,33928938,12600533,432962,,12167571,7418079
2022-07-11,4093,199,331,870,33933031,12600472,432827,,12167645,7418734
2022-07-12,12097,413,523,1650,33945128,12600590,432712,,12167878,7420133
2022-07-13,16705,560,770,2141,33961833,12600862,432496,,12168366,7422038
2022-07-14,16851,485,672,2021,33978684,12601043,432298,,12168745,7423821
2022-07-15,28882,599,820,2178,34007566,12601346,432076,,12169270,7425761
2022-07-16,30280,585,769,2323,34037846,12601628,431885,,12169743,7427840
2022-07-17,22909,536,634,1874,34060755,12601931,431784,,12170147,7429523
2022-07-18,11386,187,254,851,34072141,12601854,431712,,12170142,7430154
2022-07-19,28938,593,589,2127,34101079,12602179,431713,,12170466,7432054
2022-07-20,37617,840,921,2583,34138696,12602750,431627,,12171123,7434407
2022-07-21,36336,736,807,2799,34175032,12603207,431549,,12171658,7436972
2022-07-22,35787,825,886,2679,34210819,12603753,431482,,12172271,7439420
2022-07-23,35127,818,912,2821,34245946,12604266,431380,,12172886,7441990
2022-07-24,21726,603,804,1767,34267672,12604614,431176,,12173438,7443536
2022-07-25,11925,308,307,1079,34279597,12604648,431173,,12173475,7444392
2022-07-26,26077,622,597,2206,34305674,12604994,431197,,12173797,7446359
2022-07-27,32455,810,843,2643,34338129,12605552,431162,,12174390,7448796
2022-07-28,31524,728,880,2596,34369653,12605992,431006,,12174986,7451149
2022-07-29,29977,1789,872,2637,34399630,12607498,431920,,12175578,7453541
2022-07-30,25811,2523,742,2429,34425441,12609754,433699,,12176055,7455749
2022-07-31,14283,1068,540,1554,34439724,12610564,434223,,12176341,7457085
2022-08-01,5906,336,222,678,34445630,12610647,434335,,12176312,7457545
2022-08-02,4467,305,134,596,34450097,12610689,434503,,12176186,7457922
2022-08-03,22922,2634,735,2232,34473019,12613058,436398,,12176660,7459927
2022-08-04,22213,2479,675,2126,34495232,12615220,438196,,12177024,7461797
2022-08-05,21781,2756,742,2062,34517013,12617701,440203,,12177498,7463636
2022-08-06,19639,2877,657,1989,34536652,12620277,442417,,12177860,7465376
2022-08-07,12690,2236,616,1414,34549342,12622249,444031,,12178218,7466579
2022-08-08,4763,570,188,603,34554105,12622544,444406,,12178138,7466955
2022-08-09,13997,1464,554,1589,34568102,12623728,445310,,12178418,7468308
2022-08-10,19117,2364,715,1986,34587219,12625823,446957,,12178866,7470070
2022-08-11,17070,2043,717,1849,34604289,12627607,448281,,12179326,7471700
2022-08-12,16973,2048,730,1849,34621262,12629373,449598,,12179775,7473326
2022-08-13,15940,2222,759,1803,34637202,12631321,451059,,12180262,7474898
2022-08-14,9518,1620,617,1079,34646720,12632660,452058,,12180602,7475747
2022-08-15,3867,388,268,476,34650587,12632803,452175,,12180628,7476022
2022-08-16,10796,1074,513,1354,34661383,12633586,452734,,12180852,7477134
2022-08-17,16085,1832,737,1775,34677468,12635141,453828,,12181313,7478681
2022-08-18,14916,1639,744,1684,34692384,12636473,454719,,12181754,7480110
2022-08-19,15293,1847,743,1542,34707677,12638052,455819,,12182233,7481426
2022-08-20,14275,1642,737,1542,34721952,12639411,456718,,12182693,7482735
2022-08-21,9893,1535,658,1159,34731845,12640689,457591,,12183098,7483682
2022-08-22,4160,482,269,560,34736005,12640886,457801,,12183085,7483998
2022-08-23,11113,1246,550,1486,34747118,12641840,458494,,12183346,7485244
2022-08-24,14744,1806,868,2182,34761862,12643381,459432,,12183949,7487200
2022-08-25,14019,1720,779,2117,34775881,12644825,460366,,12184459,7489081
2022-08-26,13920,1688,813,2089,34789801,12646234,461234,,12185000,7490934
2022-08-27,12406,1486,878,1992,34802207,12647406,461837,,12185569,7492668
2022-08-28,7918,1258,619,1395,34810125,12648417,462474,,12185943,7493852
2022-08-29,3393,504,282,681,34813518,12648660,462693,,12185967,7494312
2022-08-30,9900,1169,647,1853,34823418,12649489,463209,,12186280,7495878
2022-08-31,13505,1626,944,2310,34836923,12650840,463887,,12186953,7497956
2022-09-01,12894,1719,910,2136,34849817,12652273,464692,,12187581,7499855
2022-09-02,15037,1614,990,4918,34864854,12653621,465308,,12188313,7504555
2022-09-03,14705,1528,920,5509,34879559,12654887,465913,,12188974,7509847
2022-09-04,8660,1011,674,3234,34888219,12655651,466242,,12189409,7512872
2022-09-05,3549,321,229,1382,34891768,12655717,466331,,12189386,7514039
2022-09-06,2455,155,113,1124,34894223,12655635,466370,,12189265,7514967
2022-09-07,10917,1018,587,3489,34905140,12656370,466799,,12189571,7518214
2022-09-08,10858,1021,522,2790,34915998,12657086,467295,,12189791,7520746
2022-09-09,9578,1015,487,2499,34925576,12657822,467818,,12190004,7523016
2022-09-10,10649,1267,551,3162,34936225,12658827,468530,,12190297,7525956
2022-09-11,9399,984,667,3732,34945624,12659574,468841,,12190733,7529488
2022-09-12,3124,295,203,1079,34948748,12659604,468927,,12190677,7530343
2022-09-13,6009,542,281,1130,34954757,12659876,469180,,12190696,7531244
2022-09-14,14472,798,430,1842,34969229,12660373,469544,,12190829,7532835
2022-09-15,15736,779,407,1531,34984965,12660853,469912,,12190941,7534111
2022-09-16,17744,768,445,1687,35002709,12661380,470229,,12191151,7535593
2022-09-17,17599,722,455,1664,35020308,12661820,470492,,12191328,7537020
2022-09-18,11206,776,451,1685,35031514,12662358,470815,,12191543,7538501
2022-09-19,4975,402,287,670,35036489,12662509,470927,,12191582,7538970
2022-09-20,13743,438,325,939,35050232,12662649,471038,,12191611,7539655
2022-09-21,23018,644,406,1496,35073250,12663015,471272,,12191743,7540921
2022-09-22,22889,640,394,1375,35096139,12663364,471512,,12191852,7542046
2022-09-23,22929,727,598,1414,35119068,12663817,471637,,12192180,7543225
2022-09-24,21663,735,685,1496,35140731,12664280,471684,,12192596,7544498
2022-09-25,11308,594,702,1355,35152039,12664613,471572,,12193041,7545631
2022-09-26,4557,192,217,593,35156596,12664535,471543,,12192992,7545992
2022-09-27,37640,503,364,1496,35194236,12664786,471678,,12193108,7547275
2022-09-28,50937,730,666,1898,35245173,12665268,471741,,12193527,7548966
2022-09-29,47988,637,739,1836,35293161,12665616,471633,,12193983,7550549
2022-09-30,47263,680,806,1999,35340424,12665992,471505,,12194487,7552287
2022-10-01,34427,527,631,1542,35374851,12666238,471400,,12194838,7553587
2022-10-02,24233,737,1023,1710,35399084,12666704,471111,,12195593,7555064
2022-10-03,10860,240,230,610,35409944,12666683,471117,,12195566,7555459
2022-10-04,32176,476,458,1168,35442120,12666863,471131,,12195732,7556374
2022-10-05,40409,625,740,1558,35482529,12667202,471011,,12196191,7557691
2022-10-06,38671,608,652,1567,35521200,12667531,470966,,12196565,7559014
2022-10-07,42225,663,848,1742,35563425,12667879,470774,,12197105,7560480
2022-10-08,37379,788,1145,2120,35600804,12668374,470412,,12197962,7562355
2022-10-09,18810,549,727,1558,35619614,12668676,470231,,12198445,7563700
2022-10-10,6861,171,369,568,35626475,12668576,470031,,12198545,7564032
2022-10-11,4982,124,111,317,35631457,12668436,470040,,12198396,7564131
2022-10-12,35087,582,682,1424,35666544,12668714,469938,,12198776,7565289
2022-10-13,36747,644,857,1621,35703291,12669033,469723,,12199310,7566632
2022-10-14,36953,623,752,1537,35740244,12669357,469592,,12199765,7567911
2022-10-15,35438,716,1009,1624,35775682,12669815,469296,,12200519,7569316
2022-10-16,20652,652,1024,1592,35796334,12670222,468919,,12201303,7570695
2022-10-17,7349,206,478,538,35803683,12670178,468647,,12201531,7571022
2022-10-18,36407,461,497,1397,35840090,12670349,468608,,12201741,7572170
2022-10-19,49870,621,729,1982,35889960,12670700,468497,,12202203,7573927
2022-10-20,51258,624,648,2048,35941218,12671051,468472,,12202579,7575745
2022-10-21,52831,698,617,1938,35994049,12671460,468550,,12202910,7577443
2022-10-22,50847,751,904,2305,36044896,12671925,468392,,12203533,7579507
2022-10-23,30619,577,783,2118,36075515,12672230,468183,,12204047,7581393
2022-10-24,14127,232,270,979,36089642,12672198,468140,,12204058,7582143
2022-10-25,41335,475,487,1815,36130977,12672371,468126,,12204245,7583700
2022-10-26,51611,618,660,2122,36182588,12672690,468080,,12204610,7585571
2022-10-27,50086,610,768,2161,36232674,12673012,467916,,12205096,7587490
2022-10-28,49743,590,673,2092,36282417,12673297,467831,,12205466,7589312
2022-10-29,50573,738,778,2216,36332990,12673733,467787,,12205946,7591269
2022-10-30,28384,664,928,2034,36361374,12674158,467521,,12206637,7593092
2022-10-31,12435,201,234,775,36373809,12674128,467486,,12206642,7593672
2022-11-01,33059,342,194,1218,36406868,12674169,467628,,12206541,7594631
2022-11-02,44258,577,622,1902,36451126,12674469,467581,,12206888,7596281
2022-11-03,44163,542,604,1857,36495289,12674744,467517,,12207227,7597903
2022-11-04,44596,646,527,2021,36539885,12675143,467633,,12207510,7599712
2022-11-05,45179,646,754,2365,36585064,12675538,467522,,12208016,7601854
2022-11-06,26010,561,771,2095,36611074,12675811,467310,,12208501,7603698
2022-11-07,10706,243,235,876,36621780,12675832,467315,,12208517,7604388
2022-11-08,33460,488,396,1584,36655240,12676089,467404,,12208685,7605774
2022-11-09,40516,610,570,1961,36695756,12676447,467443,,12209004,7607518
2022-11-10,39127,626,547,1923,36734883,12676818,467521,,12209297,7609214
2022-11-11,43317,638,641,2205,36778200,12677204,467517,,12209687,7611200
2022-11-12,36827,641,593,2182,36815027,12677591,467559,,12210032,7613159
2022-11-13,24254,560,770,2273,36839281,12677922,467346,,12210576,7615234
2022-11-14,10959,233,204,1023,36850240,12677928,467374,,12210554,7616054
2022-11-15,33452,486,377,1687,36883692,12678133,467480,,12210653,7617500
2022-11-16,43508,804,582,2361,36927200,12678712,467701,,12211011,7619664
2022-11-17,38312,674,646,2241,36965512,12679114,467727,,12211387,7621669
2022-11-18,40582,724,531,2327,37006094,12679569,467918,,12211651,7623759
2022-11-19,39628,1018,1030,3074,37045722,12680321,467902,,12212419,7626596
2022-11-20,22405,664,715,2440,37068127,12680786,467850,,12212936,7628861
2022-11-21,8917,197,192,970,37077044,12680787,467851,,12212936,7629673
2022-11-22,26425,480,368,1511,37103469,12680981,467960,,12213021,7630931
2022-11-23,32046,688,664,2066,37135515,12681408,467982,,12213426,7632770
2022-11-24,31884,665,750,2078,37167399,12681826,467896,,12213930,7634635
2022-11-25,30737,766,829,1946,37198136,12682363,467828,,12214535,7636388
2022-11-26,30247,914,1189,2694,37228383,12683018,467547,,12215471,7638853
2022-11-27,18668,611,943,2086,37247051,12683392,467213,,12216179,7640729
2022-11-28,7534,191,280,785,37254585,12683349,467120,,12216229,7641306
2022-11-29,21010,422,450,1290,37275595,12683526,467089,,12216437,7642380
2022-11-30,27871,645,646,1839,37303466,12683934,467086,,12216848,7644007
2022-12-01,24778,594,681,1688,37328244,12684288,466997,,12217291,7645481
2022-12-02,25044,526,629,1770,37353288,12684569,466889,,12217680,7647033
2022-12-03,25533,588,779,1943,37378821,12684909,466691,,12218218,7648776
2022-12-04,15246,499,606,1698,37394067,12685160,466580,,12218580,7650252
2022-12-05,6868,170,156,740,37400935,12685108,466590,,12218518,7650803
2022-12-06,20321,421,351,1372,37421256,12685256,466659,,12218597,7651932
2022-12-07,24750,554,608,1668,37446006,12685579,466603,,12218976,7653400
2022-12-08,23133,563,523,1760,37469139,12685907,466642,,12219265,7654949
2022-12-09,23302,635,575,1630,37492441,12686300,466701,,12219599,7656373
2022-12-10,22558,510,599,1626,37514999,12686587,466611,,12219976,7657803
2022-12-11,14194,549,785,1567,37529193,12686947,466373,,12220574,7659202
2022-12-12,5506,150,157,593,37534699,12686884,466362,,12220522,7659616
2022-12-13,17776,380,364,1124,37552475,12687015,466378,,12220637,7660523
2022-12-14,21304,511,547,1450,37573779,12687323,466338,,12220985,7661794
2022-12-15,21929,532,600,1576,37595708,12687597,466269,,12221328,7663144
2022-12-16,16265,378,449,1027,37611973,12687733,466198,,12221535,7663964
2022-12-17,18679,559,504,1271,37630652,12688067,466252,,12221815,7665027
2022-12-18,12631,530,795,1303,37643283,12688385,465986,,12222399,7666138
2022-12-19,4585,133,115,448,37647868,12688274,466000,,12222274,7666369
2022-12-20,16197,502,449,1103,37664065,12688548,466050,,12222498,7667272
2022-12-21,18441,545,547,1296,37682506,12688888,466046,,12222842,7668385
2022-12-22,18573,577,587,1740,37701079,12689262,466036,,12223226,7669947
2022-12-23,15622,581,596,1712,37716701,12689594,466017,,12223577,7671449
2022-12-24,5327,222,171,670,37722028,12689596,466068,,12223528,7671917
2022-12-25,2439,153,152,480,37724467,12689538,466062,,12223476,7672213
2022-12-26,262,12,7,48,37724729,12689333,466063,,12223270,7672070
2022-12-27,2087,99,35,301,37726816,12689250,466125,,12223125,7672209
2022-12-28,8308,336,167,975,37735124,12689350,466292,,12223058,7672971
2022-12-29,13151,584,524,1600,37748275,12689707,466349,,12223358,7674371
2022-12-30,15807,673,658,1872,37764082,12690151,466361,,12223790,7676038
2022-12-31,11222,462,387,1353,37775304,12690357,466432,,12223925,7677167
2023-01-01,3882,202,214,559,37779186,12690341,466419,,12223922,7677536
2023-01-02,651,37,15,96,37779837,12690202,466441,,12223761,7677478
2023-01-03,8185,300,152,897,37788022,12690303,466584,,12223719,7678208
2023-01-04,14707,577,547,1543,37802729,12690689,466608,,12224081,7679584
2023-01-05,16091,660,533,1790,37818820,12691146,466733,,12224413,7681195
2023-01-06,18809,722,606,2039,37837629,12691670,466846,,12224824,7683059
2023-01-07,18494,709,638,2053,37856123,12692184,466914,,12225270,7684942
2023-01-08,11602,584,606,1629,37867725,12692604,466891,,12225713,7686423
2023-01-09,5295,216,196,664,37873020,12692637,466910,,12225727,7686925
2023-01-10,12154,422,315,779,37885174,12692851,467017,,12225834,7687516
2023-01-11,15530,459,370,1092,37900704,12693101,467104,,12225997,7688428
2023-01-12,14043,452,407,969,37914747,12693343,467148,,12226195,7689210
2023-01-13,14138,426,345,1034,37928885,12693606,467229,,12226377,7690091
2023-01-14,13351,478,453,1074,37942236,12693905,467252,,12226653,7691001
2023-01-15,9034,468,504,1048,37951270,12694209,467215,,12226994,7691912
2023-01-16,3741,150,130,478,37955011,12694189,467235,,12226954,7692234
2023-01-17,8837,271,178,651,37963848,12694249,467328,,12226921,7692704
2023-01-18,10236,352,273,756,37974084,12694429,467407,,12227022,7693303
2023-01-19,10551,319,318,756,37984635,12694574,467404,,12227170,7693904
2023-01-20,9811,320,271,712,37994446,12694739,467452,,12227287,7694471
2023-01-21,11285,357,398,905,38005731,12694945,467411,,12227534,7695241
2023-01-22,7560,348,404,815,38013291,12695150,467354,,12227796,7695922
2023-01-23,3372,145,131,288,38016663,12695179,467368,,12227811,7696109
2023-01-24,8257,232,165,544,38024920,12695240,467433,,12227807,7696507
2023-01-25,10303,351,296,657,38035223,12695440,467487,,12227953,7697034
2023-01-26,6713,238,203,466,38041936,12695530,467522,,12228008,7697373
2023-01-27,6891,242,197,486,38048827,12695631,467567,,12228064,7697734
2023-01-28,9310,312,337,683,38058137,12695783,467538,,12228245,7698276
2023-01-29,5950,239,340,687,38064087,12695880,467434,,12228446,7698836
2023-01-30,1896,92,79,213,38065983,12695853,467447,,12228406,7698940
2023-01-31,5838,156,150,409,38071821,12695883,467453,,12228430,7699232
2023-02-01,7265,254,246,485,38079086,12696032,467461,,12228571,7699626
2023-02-02,6445,296,239,497,38085531,12696225,467516,,12228709,7700037
2023-02-03,6512,196,191,461,38092043,12696329,467521,,12228808,7700417
2023-02-04,6631,225,301,538,38098674,12696461,467443,,12229018,7700877
2023-02-05,4161,201,288,482,38102835,12696579,467356,,12229223,7701289
2023-02-06,1829,91,97,211,38104664,12696580,467349,,12229231,7701416
2023-02-07,4927,166,177,379,38109591,12696659,467338,,12229321,7701720
2023-02-08,5746,214,209,424,38115337,12696814,467342,,12229472,7702091
2023-02-09,6084,217,245,433,38121421,12696981,467314,,12229667,7702482
2023-02-10,4990,153,203,363,38126411,12697105,467264,,12229841,7702816
2023-02-11,5980,187,257,447,38132391,12697245,467191,,12230054,7703223
2023-02-12,4060,221,341,406,38136451,12697435,467070,,12230365,7703599
2023-02-13,1474,57,86,142,38137925,12697467,467041,,12230426,7703721
2023-02-14,3879,132,175,298,38141804,12697584,466998,,12230586,7704005
2023-02-15,4388,122,187,273,38146192,12697706,466933,,12230773,7704278
2023-02-16,4666,180,273,362,38150858,12697886,466840,,12231046,7704640
