"report_date","previous_day_total_doses_administered","previous_day_at_least_one","previous_day_fully_vaccinated","previous_day_3doses","total_doses_administered","total_individuals_at_least_one","total_individuals_partially_vaccinated","total_doses_in_fully_vaccinated_individuals","total_individuals_fully_vaccinated","total_individuals_3doses"
2021-01-01,6251,6241,2,,32194,32139,32128,22,11,
2021-01-02,4613,4601,6,,36807,36688,36675,26,13,
2021-01-03,5394,5387,3,,42201,42075,42059,32,16,
2021-01-04,5994,5992,0,,48195,48066,48051,30,15,
2021-01-05,9683,9658,20,,57878,57722,57688,68,34,
2021-01-06,12793,12328,450,,70671,70046,69566,960,480,
2021-01-07,16216,15505,697,,86887,85550,84373,2354,1177,
2021-01-08,18037,17022,1002,,104924,102572,100393,4358,2179,
2021-01-09,19500,18423,1064,,124424,120994,117751,6486,3243,
2021-01-10,11371,11331,38,,135795,132316,129036,6560,3280,
2021-01-11,11711,11661,48,,147506,143977,140649,6656,3328,
2021-01-12,14467,14160,298,,161973,158129,154503,7252,3626,
2021-01-13,15435,13813,1593,,177408,171928,166711,10434,5217,
2021-01-14,19183,16732,2436,,196591,188654,181002,15304,7652,
2021-01-15,20048,17991,2038,,216639,206634,196944,19380,9690,
2021-01-16,17116,15933,1170,,233755,222551,211691,21720,10860,
2021-01-17,11256,10012,1237,,245011,232548,220453,24190,12095,
2021-01-18,6793,6711,72,,251804,239236,227072,24328,12164,
2021-01-19,11826,9718,2094,,263630,248933,234675,28516,14258,
2021-01-20,10800,7211,3572,,274430,256121,238292,35658,17829,
2021-01-21,10970,6852,4091,,285400,262957,241037,43840,21920,
2021-01-22,9038,4320,4698,,294438,267240,240624,53232,26616,
2021-01-23,7450,3034,4388,,301888,270244,239241,62006,31003,
2021-01-24,4381,1825,2536,,306269,272051,238512,67078,33539,
2021-01-25,5319,1046,4264,,311588,273065,235263,75604,37802,
2021-01-26,9386,2863,6495,,320974,275896,231600,88592,44296,
2021-01-27,9893,2861,7004,,330867,278728,227429,102598,51299,
2021-01-28,13108,5732,7334,,343975,284427,225794,117266,58633,
2021-01-29,10687,3274,7379,,354662,287670,221659,132022,66011,
2021-01-30,9186,2726,6423,,363848,290354,217923,144862,72431,
2021-01-31,3375,1562,1768,,367223,291882,217684,148396,74198,
2021-02-01,2121,484,1609,,369344,292332,216529,151606,75803,
2021-02-02,4407,1354,2995,,373751,293648,214854,157588,78794,
2021-02-03,6232,1712,4458,,379983,295319,212074,166490,83245,
2021-02-04,9076,1707,7290,,389059,296983,206454,181058,90529,
2021-02-05,8441,1467,6903,,397500,298410,200984,194852,97426,
2021-02-06,10658,1862,8736,,408158,300217,194064,212306,106153,
2021-02-07,7570,1726,5796,,415728,301903,189966,223874,111937,
2021-02-08,8219,3096,5080,,423947,304951,187947,234008,117004,
2021-02-09,14999,3851,11081,,438946,308760,180691,256138,128069,
2021-02-10,15503,4924,10518,,454449,313632,175070,277124,138562,
2021-02-11,16360,3897,12407,,470809,317477,166539,301876,150938,
2021-02-12,17651,2095,15506,,488460,319533,153109,332848,166424,
2021-02-13,16204,2441,13748,,504664,321929,141776,360306,180153,
2021-02-14,12877,920,11925,,517541,322801,130753,384096,192048,
2021-02-15,7860,484,7328,,525401,323237,123887,398700,199350,
2021-02-16,5990,1040,4900,,531391,324234,120007,408454,204227,
2021-02-17,10163,1607,8522,,541554,325797,113076,425442,212721,
2021-02-18,13866,2952,10870,,555420,328701,105140,447122,223561,
2021-02-19,18487,6213,12207,,573907,334862,99125,471474,235737,
2021-02-20,22623,11129,11442,,596530,345928,98787,494282,247141,
2021-02-21,17232,10377,6821,,613762,356245,102325,507840,253920,
2021-02-22,13581,8756,4774,,627343,364931,106287,517288,258644,
2021-02-23,17856,11119,6666,,645199,375994,110720,530548,265274,
2021-02-24,18569,13608,4880,,663768,389546,119434,540224,270112,
2021-02-25,20803,16486,4260,,684571,405966,131642,548648,274324,
2021-02-26,24883,21826,2996,,709454,427732,150449,554566,277283,
2021-02-27,27450,23574,3835,,736904,451242,170172,562140,281070,
2021-02-28,20578,19140,1404,,757482,470328,187896,564864,282432,
2021-03-01,18220,17025,1148,,775702,487291,203758,567066,283533,
2021-03-02,24673,22269,2320,,800375,509499,223692,571614,285807,
2021-03-03,30591,27962,2576,,830966,537410,249060,576700,288350,
2021-03-04,34687,32458,2144,,865653,569802,279358,580888,290444,
2021-03-05,39987,38157,1782,,905640,607911,315719,584384,292192,
2021-03-06,44139,41936,2165,,949779,649792,355476,588632,294316,
2021-03-07,32732,31554,1174,,982511,681272,385840,590864,295432,
2021-03-08,24034,22160,1860,,1006545,703364,406126,594476,297238,
2021-03-09,33280,29833,3419,,1039825,733131,432520,601222,300611,
2021-03-10,38325,34065,4215,,1078150,767122,462344,609556,304778,
2021-03-11,43969,40698,3232,,1122119,807754,499796,615916,307958,
2021-03-12,47699,45987,1688,,1169818,853677,544081,619192,309596,
2021-03-13,57904,55033,2844,,1227722,908639,596253,624772,312386,
2021-03-14,43404,42168,1219,,1271126,950724,637187,627074,313537,
2021-03-15,32801,31104,1682,,1303927,981769,666593,630352,315176,
2021-03-16,53945,51651,2278,,1357872,1033355,715944,634822,317411,
2021-03-17,61052,58515,2494,,1418924,1091804,771949,639710,319855,
2021-03-18,61531,59076,2429,,1480455,1150808,828577,644462,322231,
2021-03-19,64454,61131,3269,,1544909,1211861,886414,650894,325447,
2021-03-20,62555,59969,2555,,1607464,1271774,943820,655908,327954,
2021-03-21,43990,42469,1535,,1651454,1314178,984726,658904,329452,
2021-03-22,30993,30029,975,,1682447,1344119,1013748,660742,330371,
2021-03-23,54607,51834,2722,,1737054,1395858,1062828,666060,333030,
2021-03-24,76418,73237,3133,,1813472,1469005,1132899,672212,336106,
2021-03-25,82903,80324,2532,,1896375,1549250,1210669,677162,338581,
2021-03-26,86993,83464,3490,,1983368,1632633,1290614,684038,342019,
2021-03-27,80836,77888,2864,,2064204,1710418,1365600,689636,344818,
2021-03-28,66983,65394,1554,,2131187,1775722,1429407,692630,346315,
2021-03-29,51727,49041,2651,,2182914,1824683,1475763,697840,348920,
2021-03-30,73564,70157,3348,,2256478,1894763,1542536,704454,352227,
2021-03-31,93141,89493,3581,,2349619,1984158,1628403,711510,355755,
2021-04-01,89303,85430,3834,,2438922,2069490,1709954,719072,359536,
2021-04-02,93073,88850,4207,,2531995,2158254,1794563,727382,363691,
2021-04-03,60998,59324,1732,,2592993,2217487,1852115,730744,365372,
2021-04-04,72324,70671,1649,,2665317,2288047,1921084,733926,366963,
2021-04-05,53726,53257,468,,2719043,2341220,1973837,734766,367383,
2021-04-06,79570,77707,1883,,2798613,2418825,2049613,738424,369212,
2021-04-07,107993,104934,3050,,2906606,2523634,2151430,744408,372204,
2021-04-08,114061,110099,4019,,3020667,2633622,2257455,752334,376167,
2021-04-09,109834,105614,4293,,3130501,2739118,2358723,760790,380395,
2021-04-10,109226,105472,3846,,3239727,2844462,2460287,768350,384175,
2021-04-11,98615,95502,3257,,3338342,2939839,2552466,774746,387373,
2021-04-12,76061,75000,1154,,3414403,3014691,2626232,776918,388459,
2021-04-13,99462,96085,3397,,3513865,3110667,2718859,783616,391808,
2021-04-14,117038,113277,3649,,3630903,3223826,2828409,790834,395417,
2021-04-15,113555,109502,3895,,3744458,3333202,2933947,798510,399255,
2021-04-16,118086,113716,4191,,3862544,3446808,3043406,806804,403402,
2021-04-17,112404,107819,4445,,3974948,3554493,3146705,815576,407788,
2021-04-18,88733,86498,2102,,4063681,3640868,3231032,819672,409836,
2021-04-19,68963,67436,1448,,4132644,3708174,3296941,822466,411233,
2021-04-20,101929,98608,3116,,4234573,3806620,3392336,828568,414284,
2021-04-21,141987,137719,4034,,4376560,3944165,3525915,836500,418250,
2021-04-22,139463,135322,3902,,4516023,4079358,3657262,844192,422096,
2021-04-23,138197,131791,6160,,4654220,4210995,3782797,856396,428198,
2021-04-24,130275,126219,3883,,4784495,4337066,3905041,864050,432025,
2021-04-25,102009,98603,3176,,4886504,4435521,4000387,870268,435134,
2021-04-26,70998,69295,1555,,4957502,4504685,4068056,873258,436629,
2021-04-27,98490,95415,2885,,5055992,4599939,4160488,878902,439451,
2021-04-28,120562,115945,4426,,5176554,4715716,4271911,887610,443805,
2021-04-29,124469,119279,5043,,5301023,4834828,4386049,897558,448779,
2021-04-30,115803,110557,5009,,5416826,4945212,4491501,907422,453711,
2021-05-01,111278,107423,3640,,5528104,5052454,4595180,914548,457274,
2021-05-02,79132,76159,2860,,5607236,5128456,4668388,920136,460068,
2021-05-03,56784,55117,1595,,5664020,5183418,4721815,923206,461603,
2021-05-04,91915,88547,3282,,5755935,5271787,4806979,929616,464808,
2021-05-05,137986,133284,4618,,5893921,5404902,4935539,938726,469363,
2021-05-06,141827,136877,4813,,6035748,5541595,5067481,948228,474114,
2021-05-07,150268,145234,4831,,6186016,5686669,5207783,957772,478886,
2021-05-08,142444,137760,4435,,6328460,5824234,5340992,966484,483242,
2021-05-09,124788,121144,3476,,6453248,5945214,5458560,973308,486654,
2021-05-10,97795,95818,1876,,6551043,6040843,5552380,976926,488463,
2021-05-11,113511,108846,4486,,6664554,6149487,5656609,985756,492878,
2021-05-12,145028,138006,6876,,6809582,6287314,5787626,999376,499688,
2021-05-13,142658,135306,7203,,6952240,6422445,5915628,1013634,506817,
2021-05-14,148855,138766,9920,,7101095,6561023,6044351,1033344,516672,
2021-05-15,159715,149676,9861,,7260810,6710512,6184054,1052916,526458,
2021-05-16,144348,136084,8060,,7405158,6846428,6311990,1068876,534438,
2021-05-17,114965,110870,3942,,7520123,6957109,6418805,1076608,538304,
2021-05-18,111311,100453,10656,,7631434,7057366,6508468,1097796,548898,
2021-05-19,149861,133459,16225,,7781295,7190673,6625624,1130098,565049,
2021-05-20,151546,131565,19769,,7932841,7322049,6737300,1169498,584749,
2021-05-21,165365,140866,24242,,8098206,7462734,6853820,1217828,608914,
2021-05-22,199413,172226,26961,,8297619,7634763,6998969,1271588,635794,
2021-05-23,139811,127443,12223,,8437430,7762028,7114073,1295910,647955,
2021-05-24,100286,93316,6825,,8537716,7855171,7200461,1309420,654710,
2021-05-25,90447,82967,7271,,8628163,7937975,7276061,1323828,661914,
2021-05-26,139761,112999,26499,,8767924,8050787,7362444,1376686,688343,
2021-05-27,152050,123032,28765,,8919974,8173662,7456623,1434078,717039,
2021-05-28,163847,132295,31247,,9083821,8305784,7557557,1496454,748227,
2021-05-29,153364,117110,36022,,9237185,8422744,7638551,1568386,784193,
2021-05-30,149708,119008,30475,,9386893,8541582,7726976,1629212,814606,
2021-05-31,99199,79806,19202,,9486092,8621218,7787474,1667488,833744,
2021-06-01,124175,90597,33244,,9610267,8711620,7844707,1733826,866913,
2021-06-02,145292,102132,42910,,9755559,8813571,7903817,1819508,909754,
2021-06-03,155340,99895,55167,,9910899,8913281,7948431,1929700,964850,
2021-06-04,181693,115520,65903,,10092592,9028602,7997937,2061330,1030665,
2021-06-05,171998,103417,68305,,10264590,9131821,8032936,2197770,1098885,
2021-06-06,163371,91851,71240,,10427961,9223494,8053439,2340110,1170055,
2021-06-07,119552,63044,56291,,10547513,9286341,8060070,2452542,1226271,
2021-06-08,161879,72439,89002,,10709392,9358591,8043398,2630386,1315193,
2021-06-09,181453,70800,110187,,10890845,9429214,8003915,2850598,1425299,
2021-06-10,185564,66416,118662,,11076409,9495427,7951557,3087740,1543870,
2021-06-11,204761,67502,136506,,11281170,9562743,7882449,3360588,1680294,
2021-06-12,199706,62661,136448,,11480876,9625222,7808572,3633300,1816650,
2021-06-13,190315,58872,130915,,11671191,9683919,7736434,3894970,1947485,
2021-06-14,137681,38689,98593,,11808872,9722412,7676439,4091946,2045973,
2021-06-15,189376,42594,146428,,11998248,9764788,7572484,4384608,2192304,
2021-06-16,206151,42420,163091,,12204399,9807012,7451720,4710584,2355292,
2021-06-17,210399,37925,171894,,12414798,9844722,7317628,5054188,2527094,
2021-06-18,217130,35344,181183,,12631928,9879876,7171691,5416370,2708185,
2021-06-19,215859,35486,179703,,12847787,9915156,7027380,5775552,2887776,
2021-06-20,186252,35553,150123,,13034039,9950511,6912720,6075582,3037791,
2021-06-21,120420,20821,99100,,13154459,9971137,6834338,6273598,3136799,
2021-06-22,204916,27501,176661,,13359375,9998444,6685093,6626702,3313351,
2021-06-23,230504,28616,201152,,13589879,10026860,6512465,7028790,3514395,
2021-06-24,227667,26663,200254,,13817546,10053327,6338788,7429078,3714539,
2021-06-25,251086,27968,222374,,14068632,10081094,6144299,7873590,3936795,
2021-06-26,261275,29995,230578,,14329907,10110864,5943631,8334466,4167233,
2021-06-27,204987,27782,176602,,14534894,10138464,5794739,8687450,4343725,
2021-06-28,199235,20951,177724,,14734129,10159217,5637893,9042648,4521324,
2021-06-29,250098,24488,224881,,14984227,10183464,5437413,9492102,4746051,
2021-06-30,275519,24166,250787,,15259746,10207427,5210718,9993418,4996709,
2021-07-01,271957,25301,246102,,15531703,10232510,4989838,10485344,5242672,
2021-07-02,144710,11582,132904,,15676413,10243918,4868444,10750948,5375474,
2021-07-03,216885,19924,196730,,15893298,10263620,4691565,11144110,5572055,
2021-07-04,196158,19406,176530,,16089456,10282840,4534374,11496932,5748466,
2021-07-05,148714,12438,136133,,16238170,10295088,4410617,11768942,5884471,
2021-07-06,220013,19985,199813,,16458183,10314857,4230719,12168276,6084138,
2021-07-07,246599,22962,223398,,16704782,10337593,4030205,12614776,6307388,
2021-07-08,231191,21347,209635,,16935973,10358734,3841846,13033776,6516888,
2021-07-09,226976,21500,205309,,17162949,10380032,3657967,13444130,6722065,
2021-07-10,209051,20532,188364,,17372000,10400360,3490068,13820584,6910292,
2021-07-11,171659,17572,153962,,17543659,10417731,3353624,14128214,7064107,
2021-07-12,123128,11444,111587,,17666787,10428986,3253429,14351114,7175557,
2021-07-13,178482,19019,159322,,17845269,10447783,3113059,14669448,7334724,
2021-07-14,180024,19298,160570,,18025293,10466866,2971735,14990262,7495131,
2021-07-15,167176,19579,147425,,18192469,10486234,2843842,15284784,7642392,
2021-07-16,169334,19893,149288,,18361803,10505925,2714398,15583054,7791527,
2021-07-17,172990,20257,152606,,18534793,10525933,2581992,15887882,7943941,
2021-07-18,133619,15925,117557,,18668412,10541674,2480324,16122700,8061350,
2021-07-19,91970,10414,81448,,18760382,10551875,2409252,16285246,8142623,
2021-07-20,133528,16943,116526,,18893910,10568578,2309605,16517946,8258973,
2021-07-21,140075,16980,123024,,19033985,10585343,2203508,16763670,8381835,
2021-07-22,125591,17636,107819,,19159576,10602755,2113278,16978954,8489477,
2021-07-23,120244,16981,103057,,19279820,10619495,2027160,17184670,8592335,
2021-07-24,126679,18329,108112,,19406499,10637621,1937337,17400568,8700284,
2021-07-25,103622,14856,88637,,19510121,10652253,1863513,17577480,8788740,
2021-07-26,66677,9882,56704,,19576798,10661917,1816654,17690526,8845263,
2021-07-27,92362,15314,76886,,19669160,10676970,1755038,17843864,8921932,
2021-07-28,93927,16456,77397,,19763087,10693191,1694053,17998276,8999138,
2021-07-29,89380,16695,72523,,19852467,10709654,1638181,18142946,9071473,
2021-07-30,84043,16096,67835,,19936510,10725522,1586402,18278240,9139120,
2021-07-31,83826,15703,67971,,20020336,10741007,1534106,18413802,9206901,
2021-08-01,61850,11309,50360,,20082186,10752090,1495020,18514140,9257070,
2021-08-02,42475,7407,34949,,20124661,10759299,1467446,18583706,9291853,
2021-08-03,33278,5947,27161,,20157939,10765013,1446209,18637608,9318804,
2021-08-04,61301,12366,48745,,20219240,10777144,1409793,18734702,9367351,
2021-08-05,59431,12531,46747,,20278671,10789467,1375533,18827868,9413934,
2021-08-06,56003,11847,43940,,20334674,10801054,1343409,18915290,9457645,
2021-08-07,62350,12124,50030,,20397024,10812917,1305460,19014914,9507457,
2021-08-08,48655,9254,39214,,20445679,10821943,1275477,19092932,9546466,
2021-08-09,30846,5932,24739,,20476525,10827661,1256643,19142036,9571018,
2021-08-10,49238,10499,38438,,20525763,10837880,1228670,19218420,9609210,
2021-08-11,48708,10760,37703,,20574471,10848393,1201696,19293394,9646697,
2021-08-12,49225,11185,37813,,20623696,10859327,1175026,19368602,9684301,
2021-08-13,49604,11720,37609,,20673300,10870806,1149107,19443398,9721699,
2021-08-14,51200,12125,38866,,20724500,10882681,1122340,19520682,9760341,
2021-08-15,41748,9840,31685,,20766248,10892319,1100465,19583708,9791854,
2021-08-16,26720,6173,20392,,20792968,10898269,1086220,19624098,9812049,
2021-08-17,40487,11050,29174,,20833455,10909069,1068072,19681994,9840997,
2021-08-18,41881,11962,29678,,20875336,10920789,1050324,19740930,9870465,
2021-08-19,45871,16519,29089,,20921207,10937057,1037726,19798662,9899331,
2021-08-20,46417,16275,29727,,20967624,10953076,1024247,19857658,9928829,
2021-08-21,47936,15138,32430,,21015560,10967954,1006922,19922064,9961032,
2021-08-22,34377,10800,23310,,21049937,10978508,994388,19968240,9984120,
2021-08-23,23216,7003,15997,,21073153,10985276,985373,19999806,9999903,
2021-08-24,37641,13368,23818,,21110794,10998390,974900,20046980,10023490,
2021-08-25,41317,14405,26305,,21152111,11012539,962981,20099116,10049558,
2021-08-26,39254,13549,24963,,21191365,11025812,951532,20148560,10074280,
2021-08-27,37655,12926,23685,,21229020,11038497,940746,20195502,10097751,
2021-08-28,40098,13413,25510,,21269118,11051631,928625,20246012,10123006,
2021-08-29,30535,10242,19936,,21299653,11061641,918912,20285458,10142729,
2021-08-30,18228,6137,11842,,21317881,11067530,913178,20308704,10154352,
2021-08-31,32700,11934,19616,,21350581,11079196,905468,20347456,10173728,
2021-09-01,36220,12935,21940,,21386801,11091898,896447,20390902,10195451,
2021-09-02,37756,15638,19657,,21424557,11107284,892403,20429762,10214881,
2021-09-03,46854,21074,22432,,21471411,11128110,891026,20474168,10237084,
2021-09-04,46860,20581,24767,,21518271,11148445,886817,20523256,10261628,
2021-09-05,33056,14199,18569,,21551327,11162400,882427,20559946,10279973,
2021-09-06,21698,9483,12027,,21573025,11171634,879866,20583536,10291768,
2021-09-07,14985,6719,8083,,21588010,11178096,878485,20599222,10299611,
2021-09-08,41129,17106,20928,,21629139,11194938,874645,20640586,10320293,
2021-09-09,41435,16969,19671,,21670574,11211630,871918,20679424,10339712,
2021-09-10,39625,15503,18990,,21710199,11226871,868413,20716916,10358458,
2021-09-11,42358,15926,23330,,21752557,11242518,860988,20763060,10381530,
2021-09-12,29950,11527,17860,,21782507,11253751,854625,20798252,10399126,
2021-09-13,16076,6403,9177,,21798583,11259920,851836,20816168,10408084,
2021-09-14,29894,11554,15285,,21828477,11271172,848078,20846188,10423094,
2021-09-15,39264,14020,19412,,21867741,11284933,842671,20884524,10442262,
2021-09-16,39331,13977,19239,,21907072,11298675,837386,20922578,10461289,
2021-09-17,38909,13603,19328,,21945981,11312035,831649,20960772,10480386,
2021-09-18,41213,14076,23515,,21987194,11325838,822189,21007298,10503649,
2021-09-19,30644,10824,18975,,22017838,11336403,814025,21044756,10522378,
2021-09-20,16727,6098,10174,,22034565,11342247,809926,21064642,10532321,
2021-09-21,31350,11211,16986,,22065915,11353193,804135,21098116,10549058,
2021-09-22,41796,14812,22917,,22107711,11367709,796009,21143400,10571700,
2021-09-23,47213,16133,26023,,22154924,11383579,786100,21194958,10597479,
2021-09-24,46286,15626,26640,,22201210,11398944,775067,21247754,10623877,
2021-09-25,48181,15248,29940,,22249391,11413939,760356,21307166,10653583,
2021-09-26,37481,12414,24475,,22286872,11426078,748274,21355608,10677804,
2021-09-27,19146,6527,12313,,22306018,11432351,742472,21379758,10689879,
2021-09-28,30936,11289,17866,,22336954,11443381,735883,21414996,10707498,
2021-09-29,37868,12470,21716,,22374822,11455580,726617,21457926,10728963,
2021-09-30,37322,11648,21363,,22412144,11466969,716883,21500172,10750086,
2021-10-01,30861,9807,18402,,22443005,11476550,708275,21536550,10768275,
2021-10-02,37120,11152,23577,,22480125,11487432,695832,21583200,10791600,
2021-10-03,27199,8161,18321,,22507324,11495352,685659,21619386,10809693,
2021-10-04,14864,4744,9801,,22522188,11499850,680584,21638532,10819266,
2021-10-05,26803,8588,15859,,22548991,11508177,673298,21669758,10834879,
2021-10-06,31648,9636,18498,,22580639,11517554,664428,21706252,10853126,
2021-10-07,30336,9390,17114,,22610975,11526693,656691,21740004,10870002,
2021-10-08,32823,10739,18842,,22643798,11537162,648575,21777174,10888587,
2021-10-09,34126,10655,21010,,22677924,11547554,638206,21818696,10909348,
2021-10-10,23398,7655,15079,,22701322,11554958,630770,21848376,10924188,
2021-10-11,11998,3838,7862,,22713320,11558546,626730,21863632,10931816,
2021-10-12,5099,1625,3259,,22718419,11559893,625081,21869624,10934812,
2021-10-13,29093,9189,18076,,22747512,11568792,616178,21905228,10952614,
2021-10-14,29004,8902,17741,,22776516,11577419,607329,21940180,10970090,
2021-10-15,29078,8820,18159,,22805594,11585976,597977,21975998,10987999,
2021-10-16,31131,8985,19865,,22836725,11594670,587085,22015170,11007585,
2021-10-17,23693,7255,15367,,22860418,11601671,578960,22045422,11022711,
2021-10-18,12303,3747,8145,,22872721,11605137,574550,22061174,11030587,
2021-10-19,21254,6620,12623,,22893975,11611475,568534,22085882,11042941,
2021-10-20,25644,7536,14906,,22919619,11618764,561151,22115226,11057613,
2021-10-21,23162,6675,13025,,22942781,11625170,554790,22140760,11070380,
2021-10-22,26105,7307,15104,,22968886,11632154,546977,22170354,11085177,
2021-10-23,28165,7602,17150,,22997051,11639494,537422,22204144,11102072,
2021-10-24,19340,5727,12594,,23016391,11644965,530543,22228844,11114422,
2021-10-25,9925,2709,6474,,23026316,11647405,526770,22241270,11120635,
2021-10-26,18891,5385,11089,,23045207,11652512,521057,22262910,11131455,
2021-10-27,22837,6073,13203,,23068044,11658330,513913,22288834,11144417,
2021-10-28,22295,5791,12637,,23090339,11663833,507056,22313554,11156777,
2021-10-29,22800,5730,13040,,23113139,11669261,499731,22339060,11169530,
2021-10-30,24088,6033,14601,,23137227,11675022,491151,22367742,11183871,
2021-10-31,16468,4593,10593,,23153695,11679321,485146,22388350,11194175,
2021-11-01,7864,2079,5053,,23161559,11681120,482159,22397922,11198961,
2021-11-02,15616,4362,7740,,23177175,11685191,478770,22412842,11206421,
2021-11-03,18612,5065,9600,,23195787,11689953,474225,22431456,11215728,
2021-11-04,19495,4871,10026,,23215282,11694548,469055,22450986,11225493,
2021-11-05,21449,4400,9513,,23236731,11698659,463928,22469462,11234731,
2021-11-06,25324,5203,12150,,23262055,11703593,456964,22493258,11246629,
2021-11-07,21438,4021,8915,,23283493,11707334,452058,22510552,11255276,
2021-11-08,11988,2110,4729,,23295481,11709149,449423,22519452,11259726,
2021-11-09,24112,3847,7643,,23319593,11712675,445617,22534116,11267058,
2021-11-10,28467,4506,8989,,23348060,11716904,441120,22551568,11275784,
2021-11-11,28744,4302,9090,,23376804,11720910,436323,22569174,11284587,
2021-11-12,26730,4162,8227,,23403534,11724781,432244,22585074,11292537,
2021-11-13,34298,5079,11402,,23437832,11729554,425912,22607284,11303642,
2021-11-14,23211,3897,8599,,23461043,11733188,421203,22623970,11311985,
2021-11-15,12699,2185,4492,,23473742,11735113,418888,22632450,11316225,
2021-11-16,26163,3926,7475,,23499905,11738782,415335,22646894,11323447,
2021-11-17,31151,4046,7803,,23531056,11742546,411568,22661956,11330978,
2021-11-18,32477,3858,7509,,23563533,11746098,407903,22676390,11338195,
2021-11-19,35450,3858,7742,,23598983,11749655,404007,22691296,11345648,
2021-11-20,40101,4380,8810,,23639084,11753755,399568,22708374,11354187,
2021-11-21,28106,3432,6941,,23667190,11756925,396045,22721760,11360880,
2021-11-22,14889,1949,3889,,23682079,11758598,394099,22728998,11364499,
2021-11-23,33041,3272,6002,,23715120,11761590,391361,22740458,11370229,
2021-11-24,42634,3751,6794,,23757754,11765037,388307,22753460,11376730,
2021-11-25,46024,3931,6560,,23803778,11768693,385675,22766036,11383018,
2021-11-26,52843,11342,6609,,23856621,11779765,390401,22778728,11389364,
2021-11-27,63500,22349,7027,,23920121,11801833,405713,22792240,11396120,
2021-11-28,51449,27739,5309,,23971570,11829280,428131,22802298,11401149,
2021-11-29,33520,18933,2877,,24005090,11847952,444176,22807552,11403776,
2021-11-30,56011,20678,5122,,24061101,11868349,459722,22817254,11408627,
2021-12-01,69528,26238,5631,,24130629,11894281,480315,22827932,11413966,
2021-12-02,71614,26486,5029,,24202243,11920469,501759,22837420,11418710,
2021-12-03,73400,25096,5160,,24275643,11945269,521689,22847160,11423580,
2021-12-04,81134,27783,6059,47272,24356777,11972759,543404,,11429355,807491
2021-12-05,62615,31926,4403,26266,24419392,12004390,570919,,11433471,833653
2021-12-06,38622,19141,2711,16754,24458014,12023242,587342,,11435900,850329
2021-12-07,60270,14850,4462,40945,24518284,12037820,597720,,11440100,891200
2021-12-08,73437,19054,4675,49705,24591721,12056597,612089,,11444508,940827
2021-12-09,74478,18271,4334,51854,24666199,12074559,626018,,11448541,992596
2021-12-10,77466,17587,4648,55223,24743665,12091865,638952,,11452913,1047738
2021-12-11,83163,20403,5819,56929,24826828,12111979,653522,,11458457,1104581
2021-12-12,60743,22696,4152,33852,24887571,12134395,672060,,11462335,1138344
2021-12-13,34923,11600,2406,20894,24922494,12145698,681244,,11464454,1159143
2021-12-14,101957,8998,3855,89061,25024451,12154386,686372,,11468014,1248084
2021-12-15,127680,12427,4505,110711,25152131,12166509,694284,,11472225,1358695
2021-12-16,139325,12451,4239,122620,25291456,12178674,702486,,11476188,1481216
2021-12-17,159155,12401,4511,142221,25450611,12190800,710367,,11480433,1623340
2021-12-18,175569,13523,4918,157084,25626180,12204029,718960,,11485069,1780329
2021-12-19,140423,18158,3927,118303,25766603,12221886,733183,,11488703,1898521
2021-12-20,106812,10304,2743,93719,25873415,12231922,740734,,11491188,1992142
2021-12-21,215303,12963,4313,198005,26088718,12244569,749377,,11495192,2190026
2021-12-22,237212,14418,5192,217717,26325930,12258688,758589,,11500099,2407625
2021-12-23,257563,11715,5079,240674,26583493,12270099,765219,,11504880,2648193
2021-12-24,223404,9444,4562,209335,26806897,12279246,770097,,11509149,2857412
2021-12-25,89707,3884,2502,83333,26896604,12282855,771474,,11511381,2940638
2021-12-26,11894,387,357,11140,26908498,12282950,771496,,11511454,2951648
2021-12-27,46933,1491,1114,44297,26955431,12284196,771866,,11512330,2995825
2021-12-28,144759,6100,4001,134598,27100190,12290002,773954,,11516048,3130292
2021-12-29,175453,9374,4576,161432,27275643,12299080,778748,,11520332,3291596
2021-12-30,200039,10128,5342,184527,27475682,12308905,783519,,11525386,3475989
2021-12-31,195185,10006,5796,179132,27670867,12318622,787720,,11530902,3654995
2022-01-01,96937,5379,3875,87358,27767804,12323692,789216,,11534476,3742204
2022-01-02,19442,941,928,17444,27787246,12324342,789220,,11535122,3759502
2022-01-03,88248,4772,4591,78804,27875494,12328804,789393,,11539411,3838153
2022-01-04,146350,5996,5312,135002,28021844,12334472,790064,,11544408,3972999
2022-01-05,177469,7621,7292,162384,28199313,12341739,790382,,11551357,4135223
2022-01-06,191511,7201,6783,177003,28390824,12348621,790789,,11557832,4312071
2022-01-07,191231,7956,6987,175476,28582055,12356233,791746,,11564487,4487374
2022-01-08,181647,8624,6629,165207,28763702,12364525,793728,,11570797,4652425
2022-01-09,131090,9865,7177,113955,28894792,12374068,796411,,11577657,4766220
2022-01-10,90556,5108,4489,80828,28985348,12378854,797020,,11581834,4846895
2022-01-11,138853,6152,6561,125434,29124201,12384659,796598,,11588061,4972139
2022-01-12,157002,8157,8049,138673,29281203,12392487,796701,,11595786,5110644
2022-01-13,162663,9207,9212,141534,29443866,12401332,796682,,11604650,5251995
2022-01-14,159852,10751,10372,136038,29603718,12411722,797056,,11614666,5387835
2022-01-15,161190,11010,11669,135877,29764908,12422361,796386,,11625975,5523519
2022-01-16,109773,9288,9672,89454,29874681,12431287,795995,,11635292,5612755
2022-01-17,65776,5935,6563,52638,29940457,12436886,795357,,11641529,5665208
2022-01-18,36099,2003,2126,31146,29976556,12438534,795223,,11643311,5696158
2022-01-19,101307,5580,6718,85948,30077863,12443714,794067,,11649647,5781879
2022-01-20,103587,6321,7004,85725,30181450,12449651,793376,,11656275,5867381
2022-01-21,102097,6230,8057,82498,30283547,12455477,791535,,11663942,5949651
2022-01-22,102565,8711,12069,78107,30386112,12463799,788170,,11675629,6027530
2022-01-23,76682,7306,13989,54787,30462794,12470762,781480,,11689282,6082095
2022-01-24,42258,3194,7935,30740,30505052,12473592,776721,,11696871,6112628
2022-01-25,62556,3755,8368,48114,30567608,12476968,772093,,11704875,6160523
2022-01-26,77877,4911,13170,55688,30645485,12481502,763829,,11717673,6215969
2022-01-27,78067,4894,13243,56045,30723552,12486024,755470,,11730554,6271777
2022-01-28,77273,4671,13672,53891,30800825,12490337,746456,,11743881,6325449
2022-01-29,84807,5526,17710,58109,30885632,12495499,734265,,11761234,6383313
2022-01-30,66494,5024,20623,40152,30952126,12500181,718652,,11781529,6423240
2022-01-31,34740,2175,9879,22347,30986866,12502037,710939,,11791098,6445398
2022-02-01,51348,3265,9663,36525,31038214,12504949,704531,,11800418,6481698
2022-02-02,57704,3845,12396,38677,31095918,12508464,695965,,11812499,6520176
2022-02-03,52575,3611,11508,34298,31148493,12511698,688056,,11823642,6554223
2022-02-04,43084,2948,10558,27281,31191577,12514336,680436,,11833900,6581310
2022-02-05,58711,3742,14469,37560,31250288,12517746,669697,,11848049,6618657
2022-02-06,49856,3640,16115,29571,31300144,12521063,657217,,11863846,6648004
2022-02-07,23232,1690,7809,13440,31323376,12522427,651085,,11871342,6661220
2022-02-08,33379,2354,7240,21968,31356755,12524451,646192,,11878259,6682955
2022-02-09,38870,2780,8913,24408,31395625,12526872,640053,,11886819,6707111
2022-02-10,37534,2764,8835,22550,31433159,12529300,633978,,11895322,6729431
2022-02-11,39441,2724,10288,23002,31472600,12531678,626405,,11905273,6752195
2022-02-12,42037,2954,11453,25313,31514637,12534298,617895,,11916403,6777284
2022-02-13,36311,2799,13140,19939,31550948,12536810,607551,,11929259,6797025
2022-02-14,16972,1175,6119,9470,31567920,12537710,602599,,11935111,6806295
2022-02-15,19346,1384,4747,11875,31587266,12538771,599226,,11939545,6817943
2022-02-16,26017,1766,7729,14947,31613283,12540240,593259,,11946981,6832689
2022-02-17,26758,1683,7519,14984,31640041,12541568,587414,,11954154,6847418
2022-02-18,23935,1354,6607,13674,31663976,12542605,582149,,11960456,6860883
2022-02-19,37830,1902,8335,26050,31701806,12544176,575711,,11968465,6886692
2022-02-20,32571,1495,7963,22804,31734377,12545371,569235,,11976136,6909292
2022-02-21,17501,913,3678,12756,31751878,12545989,566461,,11979528,6921837
2022-02-22,9100,428,1550,6953,31760978,12546128,565334,,11980794,6928580
2022-02-23,25328,1326,4791,17292,31786306,12547144,561862,,11985282,6945636
2022-02-24,24570,1401,5233,15481,31810876,12548224,558026,,11990198,6960874
2022-02-25,23099,1389,5137,14507,31833975,12549319,554271,,11995048,6975155
2022-02-26,25226,1384,5908,16554,31859201,12550393,549740,,12000653,6991483
2022-02-27,26952,1370,7367,17701,31886153,12551494,543732,,12007762,7008989
2022-02-28,10127,594,2529,6745,31896280,12551835,541789,,12010046,7015551
2022-03-01,13190,944,3148,8165,31909470,12552474,539575,,12012899,7023499
2022-03-02,15410,1163,3575,9616,31924880,12553376,537156,,12016220,7032938
2022-03-03,14295,1077,3225,8688,31939175,12554141,535000,,12019141,7041395
2022-03-04,14469,991,3442,8314,31953644,12554811,532545,,12022266,7049456
2022-03-05,18527,1276,4995,11183,31972171,12555778,528815,,12026963,7060415
2022-03-06,16511,1088,5523,9603,31988682,12556586,524374,,12032212,7069811
2022-03-07,5947,466,1861,3509,31994629,12556767,522972,,12033795,7073103
2022-03-08,7357,698,1939,4158,32001986,12557187,521724,,12035463,7077062
2022-03-09,11154,906,2736,6405,32013140,12557817,519888,,12037929,7083265
2022-03-10,12755,1044,3253,6835,32025895,12558584,517672,,12040912,7089887
2022-03-11,12887,904,3407,6863,32038782,12559199,515161,,12044038,7096534
2022-03-12,14681,1046,4181,8310,32053463,12559973,512023,,12047950,7104640
2022-03-13,14742,1090,4997,8330,32068205,12560772,508112,,12052660,7112733
2022-03-14,6331,449,2228,3498,32074536,12560950,506330,,12054620,7116017
2022-03-15,10196,791,2625,5972,32084732,12561451,504484,,12056967,7121775
2022-03-16,13055,933,3661,6951,32097787,12562096,501753,,12060343,7128496
2022-03-17,13190,1047,3957,6756,32110977,12562856,498836,,12064020,7135033
2022-03-18,11903,912,3145,6432,32122880,12563465,496593,,12066872,7141241
2022-03-19,14435,1002,4161,7900,32137315,12564187,493432,,12070755,7148922
2022-03-20,11741,990,3955,6370,32149056,12564906,490462,,12074444,7155084
2022-03-21,5056,414,1589,2813,32154112,12565061,489283,,12075778,7157694
2022-03-22,6705,552,1557,3889,32160817,12565326,488273,,12077053,7161367
2022-03-23,9966,785,2297,5193,32170783,12565796,486758,,12079038,7166319
2022-03-24,9293,724,2377,4609,32180076,12566256,485096,,12081160,7170724
2022-03-25,9219,782,2153,4746,32189295,12566775,483717,,12083058,7175258
2022-03-26,10923,935,2832,5505,32200218,12567433,481818,,12085615,7180544
2022-03-27,10222,909,3537,5299,32210440,12568082,479186,,12088896,7185632
2022-03-28,3578,319,1107,1987,32214018,12568161,478395,,12089766,7187425
2022-03-29,5337,498,1210,2688,32219355,12568374,477677,,12090697,7189891
2022-03-30,7852,749,1835,4121,32227207,12568844,476586,,12092258,7193787
2022-03-31,8648,689,1924,4413,32235855,12569244,475345,,12093899,7197978
2022-04-01,9303,802,1912,4885,32245158,12569754,474226,,12095528,7202624
2022-04-02,10434,885,2212,5570,32255592,12570352,472887,,12097465,7207977
2022-04-03,9201,880,2568,5064,32264793,12570976,471193,,12099783,7212840
2022-04-04,4198,387,1006,2406,32268991,12571102,470571,,12100531,7215043
2022-04-05,6068,599,1036,3050,32275059,12571360,470128,,12101232,7217818
2022-04-06,8371,715,1477,4378,32283430,12571784,469361,,12102423,7221969
2022-04-07,10337,733,1686,4835,32293767,12572217,468403,,12103814,7226561
2022-04-08,23990,811,1582,4836,32317757,12572750,467626,,12105124,7231181
2022-04-09,30489,969,1972,5894,32348246,12573421,466614,,12106807,7236852
2022-04-10,24856,976,2389,5331,32373102,12574140,465195,,12108945,7241983
2022-04-11,12569,385,875,2432,32385671,12574276,464701,,12109575,7244214
2022-04-12,28111,692,1017,3535,32413782,12574665,464369,,12110296,7247517
2022-04-13,37779,853,1560,4929,32451561,12575219,463658,,12111561,7252216
2022-04-14,37897,761,1615,4911,32489458,12575669,462801,,12112868,7256875
2022-04-15,43393,1230,2101,6725,32532851,12576601,461926,,12114675,7263363
2022-04-16,8089,358,650,1737,32540940,12576699,461632,,12115067,7264884
2022-04-17,21006,870,1924,4315,32561946,12577285,460571,,12116714,7268976
2022-04-18,5457,305,461,1289,32567403,12577303,460410,,12116893,7270024
2022-04-19,22651,615,773,3103,32590054,12577636,460243,,12117393,7272908
2022-04-20,40326,1063,1394,4618,32630380,12578373,459909,,12118464,7277262
2022-04-21,38749,942,1600,4680,32669129,12579019,459242,,12119777,7281708
2022-04-22,35618,1013,1431,4266,32704747,12579760,458817,,12120943,7285756
2022-04-23,34646,1006,1734,4712,32739393,12580482,458086,,12122396,7290229
2022-04-24,20812,1021,1886,3777,32760205,12581253,457218,,12124035,7293812
2022-04-25,8298,453,691,1707,32768503,12581437,456979,,12124458,7295303
2022-04-26,24612,732,945,3141,32793115,12581877,456760,,12125117,7298207
2022-04-27,33595,955,1368,3936,32826710,12582556,456339,,12126217,7301926
2022-04-28,32831,927,1412,3930,32859541,12583210,455845,,12127365,7305633
2022-04-29,32057,1098,1379,3911,32891598,12584011,455557,,12128454,7309316
2022-04-30,30277,923,1535,4023,32921875,12584637,454938,,12129699,7313103
2022-05-01,16751,768,1579,2970,32938626,12585108,454122,,12130986,7315830
2022-05-02,5933,309,524,1097,32944559,12585121,453903,,12131218,7316700
2022-05-03,20926,588,830,2346,32965485,12585404,453655,,12131749,7318807
2022-05-04,29416,800,1091,3293,32994901,12585894,453359,,12132535,7321851
2022-05-05,29093,873,1161,3125,33023994,12586455,453061,,12133394,7324732
2022-05-06,29088,1147,1280,2986,33053082,12587315,452923,,12134392,7327492
2022-05-07,28485,868,1261,3112,33081567,12587893,452525,,12135368,7330380
2022-05-08,15998,896,1309,2323,33097565,12588532,452110,,12136422,7332502
2022-05-09,5896,292,474,943,33103461,12588558,451922,,12136636,7333235
2022-05-10,21221,696,718,2119,33124682,12588937,451893,,12137044,7335095
2022-05-11,28947,837,1083,2655,33153629,12589441,451643,,12137798,7337478
2022-05-12,28236,800,1084,2511,33181865,12589944,451355,,12138589,7339748
2022-05-13,27591,878,1117,2468,33209456,12590512,451112,,12139400,7341959
2022-05-14,25689,807,1098,2608,33235145,12591004,450814,,12140190,7344313
2022-05-15,14846,751,1274,2056,33249991,12591483,450284,,12141199,7346150
2022-05-16,6381,325,532,1047,33256372,12591571,450073,,12141498,7347011
2022-05-17,19599,587,778,1743,33275971,12591844,449875,,12141969,7348506
2022-05-18,26542,878,1100,2272,33302513,12592458,449648,,12142810,7350563
2022-05-19,24436,682,1156,2159,33326949,12592873,449167,,12143706,7352505
2022-05-20,24260,801,1136,2215,33351209,12593407,448828,,12144579,7354503
2022-05-21,22398,692,1167,2346,33373607,12593790,448344,,12145446,7356607
2022-05-22,10556,551,889,1486,33384163,12594080,448001,,12146079,7357876
2022-05-23,4564,241,462,787,33388727,12594062,447778,,12146284,7358455
2022-05-24,2616,119,178,434,33391343,12593928,447717,,12146211,7358680
2022-05-25,19357,655,947,1951,33410700,12594317,447415,,12146902,7360421
2022-05-26,20639,664,949,1908,33431339,12594708,447124,,12147584,7362107
2022-05-27,21754,816,1057,2075,33453093,12595237,446880,,12148357,7363950
2022-05-28,19401,721,1165,2146,33472494,12595688,446433,,12149255,7365882
2022-05-29,12109,761,1281,1725,33484603,12596214,445906,,12150308,7367415
2022-05-30,4580,311,550,751,33489183,12596279,445664,,12150615,7367968
2022-05-31,13545,572,749,1666,33502728,12596549,445481,,12151068,7369394
2022-06-01,16608,702,970,1877,33519336,12596947,445211,,12151736,7371017
2022-06-02,14601,556,866,1675,33533937,12597191,444894,,12152297,7372451
2022-06-03,16100,697,1095,1814,33550037,12597611,444490,,12153121,7374047
2022-06-04,13320,649,1164,1843,33563357,12598002,443970,,12154032,7375688
2022-06-05,7866,587,1109,1432,33571223,12598340,443444,,12154896,7376928
2022-06-06,3293,206,444,641,33574516,12598298,443203,,12155095,7377368
2022-06-07,11218,475,726,1370,33585734,12598474,442947,,12155527,7378494
2022-06-08,14062,667,1013,1609,33599796,12598882,442596,,12156286,7379885
2022-06-09,13368,662,922,1673,33613164,12599256,442331,,12156925,7381326
2022-06-10,13848,685,1067,1695,33627012,12599655,441941,,12157714,7382791
2022-06-11,12981,616,1030,1854,33639993,12599986,441525,,12158461,7384422
2022-06-12,8095,644,1236,1501,33648088,12600373,440929,,12159444,7385717
2022-06-13,3187,284,422,710,33651275,12600391,440786,,12159605,7386218
2022-06-14,10127,511,666,1264,33661402,12600613,440625,,12159988,7387244
2022-06-15,13503,471,831,1620,33674905,12600790,440263,,12160527,7388628
2022-06-16,12539,494,856,1616,33687444,12600979,439896,,12161083,7389997
2022-06-17,11687,480,816,1652,33699131,12601174,439553,,12161621,7391415
2022-06-18,11447,436,874,1860,33710578,12601339,439112,,12162227,7393051
2022-06-19,7000,483,897,1419,33717578,12601573,438697,,12162876,7394259
2022-06-20,2286,147,301,643,33719864,12601496,438537,,12162959,7394732
2022-06-21,9540,358,614,1383,33729404,12601567,438276,,12163291,7395867
2022-06-22,13606,406,724,1702,33743010,12601701,437951,,12163750,7397344
2022-06-23,13700,401,774,1682,33756710,12601836,437575,,12164261,7398813
2022-06-24,15362,435,811,1672,33772072,12602011,437195,,12164816,7400270
2022-06-25,14468,425,851,1713,33786540,12602176,436758,,12165418,7401775
2022-06-26,8156,432,885,1280,33794696,12602347,436298,,12166049,7402839
2022-06-27,3212,171,364,594,33797908,12602270,436101,,12166169,7403227
2022-06-28,9615,370,556,1223,33807523,12602355,435911,,12166444,7404218
2022-06-29,13308,413,728,1629,33820831,12602478,435594,,12166884,7405607
2022-06-30,12228,483,846,1576,33833059,12602677,435229,,12167448,7406950
2022-07-01,13035,548,970,1947,33846094,12602968,434802,,12168166,7408691
2022-07-02,1610,110,115,363,33847704,12602802,434795,,12168007,7408822
2022-07-03,5158,260,493,959,33852862,12602806,434553,,12168253,7409566
2022-07-04,2757,132,279,614,33855619,12602691,434405,,12168286,7409983
2022-07-05,11142,372,599,1573,33866761,12602766,434170,,12168596,7411308
2022-07-06,15955,545,857,2008,33882716,12603017,433852,,12169165,7413075
2022-07-07,15662,520,832,1924,33898378,12603250,433539,,12169711,7414747
2022-07-08,17882,555,870,2244,33916260,12603500,433223,,12170277,7416742
2022-07-09,14137,450,597,1841,33930397,12603676,433075,,12170601,7418349
2022-07-10,8745,475,754,1501,33939142,12603903,432795,,12171108,7419644
2022-07-11,4092,199,331,870,33943234,12603837,432660,,12171177,7420294
2022-07-12,12104,412,523,1654,33955338,12603950,432544,,12171406,7421694
2022-07-13,16718,564,771,2142,33972056,12604219,432331,,12171888,7423594
2022-07-14,16858,486,674,2023,33988914,12604400,432132,,12172268,7425378
2022-07-15,28890,599,822,2182,34017804,12604699,431908,,12172791,7427319
2022-07-16,30292,586,771,2325,34048096,12604972,431714,,12173258,7429393
2022-07-17,22926,538,636,1887,34071022,12605273,431613,,12173660,7431086
2022-07-18,11394,187,255,856,34082416,12605192,431540,,12173652,7431720
2022-07-19,28950,593,590,2134,34111366,12605510,431540,,12173970,7433622
2022-07-20,37634,841,924,2589,34149000,12606072,431452,,12174620,7435974
2022-07-21,36351,732,810,2805,34185351,12606517,431367,,12175150,7438539
2022-07-22,35797,825,891,2682,34221148,12607055,431295,,12175760,7440984
2022-07-23,35143,820,912,2830,34256291,12607563,431195,,12176368,7443559
2022-07-24,21732,600,804,1774,34278023,12607900,430988,,12176912,7445108
2022-07-25,11932,308,311,1080,34289955,12607926,430980,,12176946,7445960
2022-07-26,26085,621,602,2209,34316040,12608264,430998,,12177266,7447927
2022-07-27,32465,810,846,2647,34348505,12608817,430960,,12177857,7450364
2022-07-28,31535,724,884,2605,34380040,12609247,430796,,12178451,7452721
2022-07-29,29991,1791,875,2644,34410031,12610747,431708,,12179039,7455116
2022-07-30,25827,2526,747,2433,34435858,12612997,433485,,12179512,7457320
2022-07-31,14298,1068,541,1559,34450156,12613797,434008,,12179789,7458652
2022-08-01,5911,336,223,681,34456067,12613875,434119,,12179756,7459110
2022-08-02,4475,305,135,602,34460542,12613910,434285,,12179625,7459490
2022-08-03,22933,2636,737,2236,34483475,12616270,436180,,12180090,7461490
2022-08-04,22229,2482,679,2130,34505704,12618425,437977,,12180448,7463357
2022-08-05,21791,2756,743,2066,34527495,12620900,439982,,12180918,7465195
2022-08-06,19642,2877,657,1990,34547137,12623466,442196,,12181270,7466927
2022-08-07,12703,2236,621,1419,34559840,12625428,443805,,12181623,7468129
2022-08-08,4766,570,188,603,34564606,12625713,444180,,12181533,7468498
2022-08-09,14008,1466,557,1591,34578614,12626892,445083,,12181809,7469848
2022-08-10,19128,2365,718,1990,34597742,12628984,446728,,12182256,7471610
2022-08-11,17074,2040,718,1854,34614816,12630751,448048,,12182703,7473234
2022-08-12,16980,2048,734,1851,34631796,12632511,449361,,12183150,7474857
2022-08-13,15949,2223,762,1806,34647745,12634453,450820,,12183633,7476425
2022-08-14,9523,1621,618,1082,34657268,12635785,451819,,12183966,7477271
2022-08-15,3869,388,269,477,34661137,12635920,451935,,12183985,7477539
2022-08-16,10803,1073,514,1355,34671940,12636694,452492,,12184202,7478644
2022-08-17,16095,1833,738,1782,34688035,12638241,453586,,12184655,7480191
2022-08-18,14928,1640,748,1692,34702963,12639558,454474,,12185084,7481613
2022-08-19,15310,1846,748,1547,34718273,12641129,455568,,12185561,7482928
2022-08-20,14281,1640,739,1545,34732554,12642478,456463,,12186015,7484235
2022-08-21,9900,1532,659,1163,34742454,12643747,457332,,12186415,7485183
2022-08-22,4163,481,271,561,34746617,12643930,457539,,12186391,7485489
2022-08-23,11132,1248,554,1493,34757749,12644873,458230,,12186643,7486731
2022-08-24,14756,1808,869,2185,34772505,12646412,459169,,12187243,7488687
2022-08-25,14026,1718,780,2120,34786531,12647843,460100,,12187743,7490563
2022-08-26,13925,1688,815,2090,34800456,12649237,460966,,12188271,7492405
2022-08-27,12411,1484,876,1997,34812867,12650396,461568,,12188828,7494136
2022-08-28,7922,1258,620,1397,34820789,12651395,462204,,12189191,7495315
2022-08-29,3395,502,285,681,34824184,12651622,462416,,12189206,7495768
2022-08-30,9904,1169,649,1855,34834088,12652434,462930,,12189504,7497321
2022-08-31,13509,1627,946,2312,34847597,12653773,463607,,12190166,7499392
2022-09-01,12903,1721,912,2138,34860500,12655198,464411,,12190787,7501284
2022-09-02,15041,1615,991,4918,34875541,12656538,465027,,12191511,7505976
2022-09-03,14710,1525,920,5512,34890251,12657782,465629,,12192153,7511255
2022-09-04,8663,1010,675,3234,34898914,12658533,465955,,12192578,7514272
2022-09-05,3554,321,229,1386,34902468,12658590,466044,,12192546,7515436
2022-09-06,2463,157,113,1128,34904931,12658494,466085,,12192409,7516356
2022-09-07,10924,1018,587,3491,34915855,12659215,466512,,12192703,7519597
2022-09-08,10866,1022,525,2789,34926721,12659911,467006,,12192905,7522112
2022-09-09,9580,1012,488,2501,34936301,12660637,467525,,12193112,7524379
2022-09-10,10630,1264,551,3164,34946931,12661628,468231,,12193397,7527313
2022-09-11,9406,982,667,3735,34956337,12662364,468540,,12193824,7530840
2022-09-12,3124,294,204,1079,34959461,12662377,468624,,12193753,7531682
2022-09-13,6013,542,281,1132,34965474,12662634,468876,,12193758,7532572
2022-09-14,14481,797,434,1845,34979955,12663117,469235,,12193882,7534154
2022-09-15,15750,780,408,1533,34995705,12663578,469602,,12193976,7535417
2022-09-16,17754,766,446,1690,35013459,12664088,469916,,12194172,7536889
2022-09-17,17609,722,456,1665,35031068,12664508,470178,,12194330,7538301
2022-09-18,11210,777,451,1684,35042278,12665029,470502,,12194527,7539766
2022-09-19,4978,404,289,670,35047256,12665167,470613,,12194554,7540225
2022-09-20,13762,439,329,943,35061018,12665292,470721,,12194571,7540906
2022-09-21,23032,646,407,1496,35084050,12665634,470955,,12194679,7542151
2022-09-22,22906,636,398,1378,35106956,12665967,471187,,12194780,7543271
2022-09-23,22938,726,599,1417,35129894,12666396,471309,,12195087,7544436
2022-09-24,21685,736,690,1498,35151579,12666839,471351,,12195488,7545699
2022-09-25,11317,595,702,1355,35162896,12667160,471239,,12195921,7546823
2022-09-26,4561,192,218,594,35167457,12667068,471207,,12195861,7547177
2022-09-27,37649,498,365,1498,35205106,12667301,471336,,12195965,7548452
2022-09-28,50960,730,670,1901,35256066,12667764,471395,,12196369,7550129
2022-09-29,47993,637,740,1836,35304059,12668088,471285,,12196803,7551694
2022-09-30,47267,679,806,2001,35351326,12668446,471156,,12197290,7553419
2022-10-01,34442,527,633,1546,35385768,12668669,471048,,12197621,7554702
2022-10-02,24241,736,1028,1710,35410009,12669117,470753,,12198364,7556166
2022-10-03,10864,238,230,611,35420873,12669067,470757,,12198310,7556541
2022-10-04,32187,477,458,1169,35453060,12669229,470772,,12198457,7557438
2022-10-05,40425,625,740,1561,35493485,12669544,470652,,12198892,7558742
2022-10-06,38686,610,653,1568,35532171,12669853,470607,,12199246,7560052
2022-10-07,42229,660,852,1741,35574400,12670171,470407,,12199764,7561496
2022-10-08,37387,783,1145,2120,35611787,12670627,470039,,12200588,7563345
2022-10-09,18813,549,727,1557,35630600,12670903,469858,,12201045,7564669
2022-10-10,6862,170,370,567,35637462,12670778,469656,,12201122,7564978
2022-10-11,4989,124,111,318,35642451,12670612,469664,,12200948,7565060
2022-10-12,35106,579,685,1426,35677557,12670864,469556,,12201308,7566203
2022-10-13,36753,644,857,1620,35714310,12671149,469340,,12201809,7567521
2022-10-14,36969,621,752,1542,35751279,12671443,469206,,12202237,7568786
2022-10-15,35447,715,1013,1625,35786726,12671876,468905,,12202971,7570171
2022-10-16,20662,654,1024,1593,35807388,12672265,468529,,12203736,7571536
2022-10-17,7351,206,477,539,35814739,12672192,468257,,12203935,7571836
2022-10-18,36418,457,500,1397,35851157,12672335,468209,,12204126,7572966
2022-10-19,49888,619,729,1984,35901045,12672657,468096,,12204561,7574703
2022-10-20,51272,624,649,2048,35952317,12672973,468068,,12204905,7576492
2022-10-21,52840,697,618,1938,36005157,12673349,468144,,12205205,7578165
2022-10-22,50853,751,905,2309,36056010,12673777,467985,,12205792,7580204
2022-10-23,30631,578,783,2119,36086641,12674044,467774,,12206270,7582063
2022-10-24,14131,231,270,978,36100772,12673983,467730,,12206253,7582791
2022-10-25,41354,474,488,1817,36142126,12674119,467713,,12206406,7584320
2022-10-26,51629,616,660,2124,36193755,12674407,467665,,12206742,7586170
2022-10-27,50093,609,767,2162,36243848,12674698,467500,,12207198,7588067
2022-10-28,49784,591,675,2094,36293632,12674940,467412,,12207528,7589860
2022-10-29,50586,736,778,2218,36344218,12675337,467366,,12207971,7591787
2022-10-30,28389,664,930,2034,36372607,12675725,467096,,12208629,7593583
2022-10-31,12437,199,234,777,36385044,12675652,467058,,12208594,7594131
2022-11-01,33078,339,198,1220,36418122,12675654,467193,,12208461,7595064
2022-11-02,44275,576,622,1904,36462397,12675909,467143,,12208766,7596679
2022-11-03,44175,540,605,1856,36506572,12676133,467075,,12209058,7598260
2022-11-04,44629,652,528,2026,36551201,12676490,467192,,12209298,7600039
2022-11-05,45195,648,753,2369,36596396,12676846,467084,,12209762,7602149
2022-11-06,26014,560,771,2096,36622410,12677072,466870,,12210202,7603955
2022-11-07,10710,243,235,876,36633120,12677048,466875,,12210173,7604610
2022-11-08,33473,487,395,1584,36666593,12677258,466964,,12210294,7605960
2022-11-09,40523,605,570,1965,36707116,12677556,466997,,12210559,7607664
2022-11-10,39163,623,547,1927,36746279,12677870,467068,,12210802,7609324
2022-11-11,43332,636,641,2207,36789611,12678201,467062,,12211139,7611266
2022-11-12,36837,640,592,2185,36826448,12678525,467102,,12211423,7613176
2022-11-13,24261,559,770,2276,36850709,12678800,466885,,12211915,7615209
2022-11-14,10965,233,204,1023,36861674,12678749,466913,,12211836,7615984
2022-11-15,33588,484,379,1691,36895262,12678881,467014,,12211867,7617377
2022-11-16,43524,798,583,2370,36938786,12679394,467223,,12212171,7619508
2022-11-17,38338,672,646,2241,36977124,12679743,467245,,12212498,7621473
2022-11-18,40617,726,530,2330,37017741,12680137,467437,,12212700,7623513
2022-11-19,39646,1010,1031,3075,37057387,12680816,467412,,12213404,7626295
2022-11-20,22416,661,718,2441,37079803,12681213,467352,,12213861,7628516
2022-11-21,8918,197,192,969,37088721,12681157,467352,,12213805,7629288
2022-11-22,26433,479,368,1512,37115154,12681300,467459,,12213841,7630505
2022-11-23,32059,687,668,2068,37147213,12681669,467476,,12214193,7632303
2022-11-24,31894,663,750,2083,37179107,12682032,467387,,12214645,7634135
2022-11-25,30750,764,828,1950,37209857,12682500,467317,,12215183,7635836
2022-11-26,30277,907,1191,2696,37240134,12683084,467025,,12216059,7638255
2022-11-27,18672,611,944,2087,37258806,12683405,466687,,12216718,7640095
2022-11-28,7536,191,280,786,37266342,12683311,466591,,12216720,7640631
2022-11-29,21016,421,452,1291,37287358,12683417,466556,,12216861,7641652
2022-11-30,27887,646,649,1841,37315245,12683765,466551,,12217214,7643235
2022-12-01,24800,593,682,1692,37340045,12684050,466459,,12217591,7644658
2022-12-02,25049,524,631,1771,37365094,12684262,466346,,12217916,7646159
2022-12-03,25552,587,780,1944,37390646,12684539,466143,,12218396,7647852
2022-12-04,15246,498,606,1699,37405892,12684722,466031,,12218691,7649272
2022-12-05,6879,168,156,746,37412771,12684610,466038,,12218572,7649778
2022-12-06,20335,421,351,1376,37433106,12684688,466104,,12218584,7650862
2022-12-07,24766,553,608,1668,37457872,12684946,466044,,12218902,7652275
2022-12-08,23159,564,523,1761,37481031,12685211,466083,,12219128,7653774
2022-12-09,23320,635,575,1632,37504351,12685539,466140,,12219399,7655148
2022-12-10,22566,511,600,1627,37526917,12685756,466049,,12219707,7656518
2022-12-11,14200,549,785,1566,37541117,12686055,465811,,12220244,7657867
2022-12-12,5506,150,157,593,37546623,12685935,465799,,12220136,7658233
2022-12-13,17791,378,367,1125,37564414,12686012,465809,,12220203,7659101
2022-12-14,21312,511,547,1453,37585726,12686254,465767,,12220487,7660328
2022-12-15,21959,532,602,1578,37607685,12686473,465696,,12220777,7661635
2022-12-16,16282,379,450,1030,37623967,12686542,465622,,12220920,7662404
2022-12-17,18693,559,506,1273,37642660,12686804,465673,,12221131,7663411
2022-12-18,12635,529,794,1305,37655295,12687074,465407,,12221667,7664485
2022-12-19,4585,133,115,448,37659880,12686902,465421,,12221481,7664669
2022-12-20,16202,500,448,1106,37676082,12687108,465467,,12221641,7665525
2022-12-21,18466,547,551,1298,37694548,12687376,465460,,12221916,7666579
2022-12-22,18591,576,589,1744,37713139,12687679,465447,,12222232,7668084
2022-12-23,15637,580,598,1712,37728776,12687932,465424,,12222508,7669522
2022-12-24,5335,224,171,671,37734111,12687870,465476,,12222394,7669937
2022-12-25,2443,153,153,480,37736554,12687736,465468,,12222268,7670169
2022-12-26,262,12,7,48,37736816,12687478,465469,,12222009,7669983
2022-12-27,2094,99,36,305,37738910,12687318,465529,,12221789,7670070
2022-12-28,8316,336,167,976,37747226,12687367,465694,,12221673,7670792
2022-12-29,13159,584,524,1601,37760385,12687665,465750,,12221915,7672145
2022-12-30,15815,671,657,1880,37776200,12688054,465761,,12222293,7673772
2022-12-31,11229,462,386,1353,37787429,12688202,465833,,12222369,7674849
2023-01-01,3907,202,219,562,37791336,12688121,465816,,12222305,7675161
2023-01-02,651,37,14,96,37791987,12687901,465839,,12222062,7675031
2023-01-03,8193,298,151,898,37800180,12687941,465980,,12221961,7675713
2023-01-04,14717,576,547,1544,37814897,12688260,466003,,12222257,7677033
2023-01-05,16113,653,534,1795,37831010,12688646,466118,,12222528,7678595
2023-01-06,18821,718,609,2044,37849831,12689113,466224,,12222889,7680418
2023-01-07,18520,706,638,2055,37868351,12689567,466287,,12223280,7682256
2023-01-08,11611,584,608,1630,37879962,12689921,466260,,12223661,7683681
2023-01-09,5300,216,196,664,37885262,12689873,466278,,12223595,7684120
2023-01-10,12157,419,316,781,37897419,12690024,466381,,12223643,7684662
2023-01-11,15538,460,370,1092,37912957,12690215,466469,,12223746,7685521
2023-01-12,14060,446,407,973,37927017,12690388,466507,,12223881,7686254
2023-01-13,14163,424,345,1039,37941180,12690602,466584,,12224018,7687102
2023-01-14,13376,477,452,1077,37954556,12690833,466606,,12224227,7687956
2023-01-15,9044,466,507,1049,37963600,12691078,466564,,12224514,7688817
2023-01-16,3745,148,130,479,37967345,12690992,466582,,12224410,7689084
2023-01-17,8849,269,179,651,37976194,12690972,466671,,12224301,7689487
2023-01-18,10249,350,273,761,37986443,12691079,466748,,12224331,7690024
2023-01-19,10582,318,318,760,37997025,12691153,466744,,12224409,7690574
2023-01-20,9826,317,272,717,38006851,12691233,466787,,12224446,7691074
2023-01-21,11304,358,398,904,38018155,12691364,466747,,12224617,7691783
2023-01-22,7567,345,404,816,38025722,12691498,466686,,12224812,7692405
2023-01-23,3380,143,131,288,38029102,12691455,466698,,12224757,7692529
2023-01-24,8280,227,166,549,38037382,12691426,466757,,12224669,7692853
2023-01-25,10305,349,296,661,38047687,12691549,466808,,12224741,7693317
2023-01-26,6721,236,203,469,38054408,12691549,466840,,12224709,7693586
2023-01-27,6906,241,197,491,38061314,12691541,466883,,12224658,7693862
2023-01-28,9338,312,339,693,38070652,12691618,466852,,12224766,7694350
2023-01-29,5960,235,341,689,38076612,12691619,466741,,12224878,7694829
2023-01-30,1899,88,79,215,38078511,12691482,466748,,12224734,7694843
2023-01-31,5876,157,150,412,38084387,12691381,466753,,12224628,7695023
2023-02-01,7295,250,249,489,38091682,12691421,466752,,12224669,7695329
2023-02-02,6480,296,239,501,38098162,12691514,466807,,12224707,7695661
2023-02-03,6546,196,192,462,38104708,12691498,466809,,12224689,7695935
2023-02-04,6723,232,306,541,38111431,12691532,466730,,12224802,7696308
2023-02-05,4175,198,291,484,38115606,12691503,466636,,12224867,7696603
2023-02-06,1834,91,98,211,38117440,12691362,466627,,12224735,7696604
2023-02-07,4964,162,181,383,38122404,12691279,466606,,12224673,7696777
2023-02-08,5767,213,206,429,38128171,12691273,466612,,12224661,7697008
2023-02-09,6122,213,244,438,38134293,12691278,466581,,12224697,7697267
2023-02-10,5081,158,207,371,38139374,12691265,466530,,12224735,7697485
2023-02-11,6050,185,259,458,38145424,12691227,466452,,12224775,7697740
2023-02-12,4082,219,344,408,38149506,12691234,466324,,12224910,7697955
2023-02-13,1482,57,87,146,38150988,12691093,466293,,12224800,7697936
2023-02-14,3943,131,179,309,38154931,12690987,466244,,12224743,7698034
2023-02-15,4539,119,191,286,38159470,12690893,466172,,12224721,7698133
2023-02-16,4912,174,285,400,38164382,12690848,466059,,12224789,7698337
2023-02-17,4981,180,210,342,38169363,12690829,466028,,12224801,7698505
2023-02-18,5113,231,295,488,38174476,12690844,465962,,12224882,7698801
2023-02-19,3350,133,243,373,38177826,12690770,465849,,12224921,7699001
2023-02-20,1419,64,54,157,38179245,12690635,465857,,12224778,7698987
2023-02-21,912,25,14,107,38180157,12690473,465866,,12224607,7698924
2023-02-22,4134,131,212,370,38184291,12690412,465780,,12224632,7699134
2023-02-23,4276,163,231,390,38188567,12690344,465705,,12224639,7699320
2023-02-24,3029,138,229,272,38191596,12690287,465610,,12224677,7699414
2023-02-25,5019,214,540,385,38196615,12690295,465283,,12225012,7699627
2023-02-26,3472,146,681,384,38200087,12690232,464746,,12225486,7699831
2023-02-27,1074,37,57,97,38201161,12690078,464723,,12225355,7699770
2023-02-28,2724,98,163,232,38203885,12689936,464656,,12225280,7699785
2023-03-01,3845,138,428,333,38207730,12689832,464364,,12225468,7699895
2023-03-02,4588,158,495,328,38212318,12689753,464022,,12225731,7700023
2023-03-03,4365,161,357,333,38216683,12689698,463824,,12225874,7700159
2023-03-04,4965,207,623,350,38221648,12689697,463406,,12226291,7700324
2023-03-05,2532,110,449,251,38224180,12689585,463066,,12226519,7700379
2023-03-06,1156,48,37,114,38225336,12689436,463075,,12226361,7700319
2023-03-07,3216,88,171,223,38228552,12689281,462989,,12226292,7700335
2023-03-08,4314,133,412,283,38232866,12689190,462709,,12226481,7700416
2023-03-09,4608,171,452,312,38237474,12689140,462423,,12226717,7700541
2023-03-10,3939,101,138,255,38241413,12689048,462384,,12226664,7700626
2023-03-11,4060,140,170,285,38245473,12689011,462351,,12226660,7700751
2023-03-12,2882,109,234,301,38248355,12688916,462221,,12226695,7700871
2023-03-13,862,32,32,105,38249217,12688766,462219,,12226547,7700818
2023-03-14,3077,101,109,256,38252294,12688665,462211,,12226454,7700899
2023-03-15,4097,141,163,309,38256391,12688619,462189,,12226430,7701041
2023-03-16,4019,175,234,277,38260410,12688556,462126,,12226430,7701119
2023-03-17,4286,170,202,307,38264696,12688499,462090,,12226409,7701222
2023-03-18,4352,145,194,296,38269048,12688440,462041,,12226399,7701334
2023-03-19,2721,129,233,255,38271769,12688408,461937,,12226471,7701440
2023-03-20,774,31,19,74,38272543,12688241,461949,,12226292,7701338
2023-03-21,2890,69,84,199,38275433,12688112,461930,,12226182,7701367
2023-03-22,3890,130,131,249,38279323,12688045,461926,,12226119,7701438
2023-03-23,3805,119,171,224,38283128,12687971,461869,,12226102,7701496
2023-03-24,3686,102,115,237,38286814,12687898,461855,,12226043,7701574
2023-03-25,4268,108,171,248,38291082,12687821,461788,,12226033,7701663
2023-03-26,2470,114,211,200,38293552,12687770,461688,,12226082,7701717
2023-03-27,915,48,32,68,38294467,12687670,461704,,12225966,7701655
2023-03-28,3097,86,78,202,38297564,12687579,461706,,12225873,7701703
2023-03-29,4162,128,136,221,38301726,12687520,461696,,12225824,7701756
2023-03-30,3837,109,164,210,38305563,12687465,461641,,12225824,7701814
2023-03-31,3975,141,109,220,38309538,12687431,461672,,12225759,7701880
2023-04-01,4183,137,146,224,38313721,12687406,461662,,12225744,7701962
2023-04-02,2178,58,121,172,38315899,12687279,461597,,12225682,7701971
2023-04-03,778,25,12,52,38316677,12687141,461609,,12225532,7701881
2023-04-04,3401,74,73,168,38320078,12687054,461609,,12225445,7701897
2023-04-05,4332,95,107,245,38324410,12686986,461595,,12225391,7702001
2023-04-06,3686,111,107,187,38328096,12686957,461599,,12225358,7702056
2023-04-07,4592,105,115,241,38332688,12686898,461587,,12225311,7702153
2023-04-08,833,22,11,54,38333521,12686791,461596,,12225195,7702098
2023-04-09,2429,83,103,157,38335950,12686768,461575,,12225193,7702164
2023-04-10,360,9,6,20,38336310,12686650,461573,,12225077,7702078
2023-04-11,2769,36,28,119,38339079,12686518,461581,,12224937,7702044
2023-04-12,6323,104,95,187,38345402,12686499,461590,,12224909,7702123
2023-04-13,6978,105,128,206,38352380,12686467,461565,,12224902,7702205
2023-04-14,6501,90,101,204,38358881,12686432,461553,,12224879,7702300
2023-04-15,6937,109,147,228,38365818,12686409,461514,,12224895,7702415
2023-04-16,3264,88,144,164,38369082,12686368,461457,,12224911,7702465
2023-04-17,861,12,13,49,38369943,12686271,461456,,12224815,7702416
2023-04-18,4765,100,78,159,38374708,12686266,461477,,12224789,7702481
2023-04-19,6530,119,97,177,38381238,12686280,461498,,12224782,7702563
2023-04-20,6284,100,150,208,38387522,12686279,461448,,12224831,7702682
2023-04-21,5750,85,72,133,38393272,12686262,461459,,12224803,7702725
2023-04-22,6369,93,91,180,38399641,12686276,461460,,12224816,7702845
2023-04-23,3282,121,147,171,38402923,12686329,461434,,12224895,7702955
2023-04-24,951,4,12,58,38403874,12686259,461425,,12224834,7702955
2023-04-25,4758,67,70,185,38408632,12686260,461422,,12224838,7703085
2023-04-26,6521,112,90,203,38415153,12686321,461444,,12224877,7703241
2023-04-27,6836,121,148,203,38421989,12686399,461416,,12224983,7703404
2023-04-28,6513,87,84,181,38428502,12686456,461419,,12225037,7703557
2023-04-29,6463,133,106,188,38434965,12686580,461446,,12225134,7703737
2023-04-30,2610,99,127,140,38437575,12686672,461418,,12225254,7703871
2023-05-01,1017,20,16,29,38438592,12686692,461422,,12225270,7703900
2023-05-02,4213,71,53,103,38442805,12686761,461440,,12225321,7704001
2023-05-03,5445,109,106,166,38448250,12686870,461443,,12225427,7704167
2023-05-04,7605,91,84,127,38455855,12686961,461450,,12225511,7704294
