"report_date","previous_day_total_doses_administered","previous_day_at_least_one","previous_day_fully_vaccinated","previous_day_3doses","total_doses_administered","total_individuals_at_least_one","total_individuals_partially_vaccinated","total_doses_in_fully_vaccinated_individuals","total_individuals_fully_vaccinated","total_individuals_3doses"
2021-01-01,6252,6242,2,,32210,32155,32144,22,11,
2021-01-02,4615,4603,6,,36825,36706,36693,26,13,
2021-01-03,5396,5389,3,,42221,42095,42079,32,16,
2021-01-04,5996,5993,0,,48217,48087,48072,30,15,
2021-01-05,9687,9662,21,,57904,57747,57712,70,35,
2021-01-06,12793,12328,450,,70697,70072,69590,964,482,
2021-01-07,16219,15508,697,,86916,85579,84400,2358,1179,
2021-01-08,18039,17024,1002,,104955,102603,100422,4362,2181,
2021-01-09,19500,18423,1064,,124455,121025,117780,6490,3245,
2021-01-10,11373,11332,39,,135828,132349,129065,6568,3284,
2021-01-11,11712,11661,48,,147540,144010,140678,6664,3332,
2021-01-12,14468,14161,298,,162008,158163,154533,7260,3630,
2021-01-13,15437,13813,1594,,177445,171962,166740,10444,5222,
2021-01-14,19192,16740,2436,,196637,188696,181039,15314,7657,
2021-01-15,20076,18018,2038,,216713,206703,197008,19390,9695,
2021-01-16,17119,15935,1171,,233832,222622,211756,21732,10866,
2021-01-17,11260,10016,1237,,245092,232623,220522,24202,12101,
2021-01-18,6794,6712,72,,251886,239312,227142,24340,12170,
2021-01-19,11829,9721,2094,,263715,249012,234748,28528,14264,
2021-01-20,10804,7215,3572,,274519,256204,238369,35670,17835,
2021-01-21,10977,6856,4093,,285496,263044,241116,43856,21928,
2021-01-22,9038,4321,4697,,294534,267328,240705,53246,26623,
2021-01-23,7462,3044,4390,,301996,270342,239330,62024,31012,
2021-01-24,4389,1832,2536,,306385,272156,238608,67096,33548,
2021-01-25,5323,1049,4265,,311708,273173,235361,75624,37812,
2021-01-26,9394,2867,6499,,321102,276008,231698,88620,44310,
2021-01-27,9898,2866,7004,,331000,278845,227532,102626,51313,
2021-01-28,13120,5743,7335,,344120,284555,225907,117296,58648,
2021-01-29,10702,3288,7379,,354822,287812,221786,132052,66026,
2021-01-30,9192,2731,6424,,364014,290501,218054,144894,72447,
2021-01-31,3384,1570,1768,,367398,292037,217823,148428,74214,
2021-02-01,2125,488,1609,,369523,292491,216672,151638,75819,
2021-02-02,4418,1365,2996,,373941,293818,215007,157622,78811,
2021-02-03,6237,1717,4458,,380178,295494,212232,166524,83262,
2021-02-04,9094,1722,7293,,389272,297173,206624,181098,90549,
2021-02-05,8446,1468,6904,,397718,298601,201154,194894,97447,
2021-02-06,10669,1872,8737,,408387,300418,194243,212350,106175,
2021-02-07,7576,1729,5796,,415963,302107,190148,223918,111959,
2021-02-08,8221,3096,5081,,424184,305155,188128,234054,117027,
2021-02-09,15010,3860,11082,,439194,308973,180880,256186,128093,
2021-02-10,15514,4935,10518,,454708,313856,175270,277172,138586,
2021-02-11,16366,3899,12409,,471074,317703,166739,301928,150964,
2021-02-12,17677,2099,15527,,488751,319763,153292,332942,166471,
2021-02-13,16213,2446,13752,,504964,322164,141960,360408,180204,
2021-02-14,12882,924,11926,,517846,323040,130940,384200,192100,
2021-02-15,7862,486,7328,,525708,323478,124076,398804,199402,
2021-02-16,5995,1042,4903,,531703,324477,120195,408564,204282,
2021-02-17,10169,1610,8525,,541872,326043,113264,425558,212779,
2021-02-18,13874,2957,10873,,555746,328952,105330,447244,223622,
2021-02-19,18490,6213,12210,,574236,335113,99312,471602,235801,
2021-02-20,22630,11133,11444,,596866,346183,98976,494414,247207,
2021-02-21,17243,10386,6823,,614109,356509,102521,507976,253988,
2021-02-22,13588,8759,4777,,627697,365199,106483,517432,258716,
2021-02-23,17869,11126,6672,,645566,376269,110917,530704,265352,
2021-02-24,18577,13612,4884,,664143,389825,119631,540388,270194,
2021-02-25,20811,16490,4264,,684954,406249,131839,548820,274410,
2021-02-26,24906,21839,3006,,709860,428028,150649,554758,277379,
2021-02-27,27467,23584,3840,,737327,451548,170377,562342,281171,
2021-02-28,20585,19144,1406,,757912,470638,188103,565070,282535,
2021-03-01,18227,17030,1148,,776139,487606,203970,567272,283636,
2021-03-02,24692,22280,2327,,800831,509825,223908,571834,285917,
2021-03-03,30601,27966,2578,,831432,537740,249278,576924,288462,
2021-03-04,34697,32464,2147,,866129,570138,279579,581118,290559,
2021-03-05,40005,38170,1786,,906134,608260,315949,584622,292311,
2021-03-06,44156,41948,2170,,950290,650153,355713,588880,294440,
2021-03-07,32736,31557,1175,,983026,681636,386079,591114,295557,
2021-03-08,24038,22162,1861,,1007064,703730,406366,594728,297364,
2021-03-09,33296,29845,3423,,1040360,733509,432768,601482,300741,
2021-03-10,38346,34083,4218,,1078706,767518,462607,609822,304911,
2021-03-11,43983,40710,3234,,1122689,808162,500069,616186,308093,
2021-03-12,47715,46003,1689,,1170404,854101,544369,619464,309732,
2021-03-13,57936,55060,2849,,1228340,909090,596563,625054,312527,
2021-03-14,43422,42182,1222,,1271762,951189,637508,627362,313681,
2021-03-15,32814,31116,1682,,1304576,982246,666926,630640,315320,
2021-03-16,53959,51660,2282,,1358535,1033841,716282,635118,317559,
2021-03-17,61068,58527,2497,,1419603,1092302,772296,640012,320006,
2021-03-18,61557,59093,2436,,1481160,1151323,828934,644778,322389,
2021-03-19,64479,61147,3274,,1545639,1212392,886782,651220,325610,
2021-03-20,62575,59984,2559,,1608214,1272320,944199,656242,328121,
2021-03-21,44005,42479,1539,,1652219,1314734,985111,659246,329623,
2021-03-22,31002,30035,978,,1683221,1344681,1014136,661090,330545,
2021-03-23,54623,51849,2723,,1737844,1396435,1063230,666410,333205,
2021-03-24,76438,73256,3134,,1814282,1469601,1133319,672564,336282,
2021-03-25,82917,80336,2534,,1897199,1549858,1211099,677518,338759,
2021-03-26,87016,83486,3490,,1984215,1633263,1291066,684394,342197,
2021-03-27,80865,77911,2868,,2065080,1711071,1366071,690000,345000,
2021-03-28,67000,65410,1555,,2132080,1776391,1429893,692996,346498,
2021-03-29,51740,49050,2651,,2183820,1825361,1476258,698206,349103,
2021-03-30,73587,70175,3350,,2257407,1895459,1543047,704824,352412,
2021-03-31,93155,89503,3586,,2350562,1984864,1628919,711890,355945,
2021-04-01,89321,85442,3840,,2439883,2070208,1710476,719464,359732,
2021-04-02,93091,88864,4211,,2532974,2158986,1795095,727782,363891,
2021-04-03,61011,59331,1736,,2593985,2218226,1852650,731152,365576,
2021-04-04,72331,70677,1650,,2666316,2288792,1921624,734336,367168,
2021-04-05,53732,53261,470,,2720048,2341969,1974379,735180,367590,
2021-04-06,79584,77714,1888,,2799632,2419581,2050157,738848,369424,
2021-04-07,108012,104944,3056,,2907644,2524400,2151978,744844,372422,
2021-04-08,114080,110106,4028,,3021724,2634395,2258001,752788,376394,
2021-04-09,109855,105625,4301,,3131579,2739902,2359272,761260,380630,
2021-04-10,109250,105486,3854,,3240829,2845260,2460842,768836,384418,
2021-04-11,98631,95512,3259,,3339460,2940647,2553029,775236,387618,
2021-04-12,76071,75006,1158,,3415531,3015505,2626797,777416,388708,
2021-04-13,99477,96092,3402,,3515008,3111488,2719426,784124,392062,
2021-04-14,117051,113287,3649,,3632059,3224657,2828986,791342,395671,
2021-04-15,113563,109505,3897,,3745622,3334036,2934525,799022,399511,
2021-04-16,118089,113715,4194,,3863711,3447641,3043980,807322,403661,
2021-04-17,112423,107830,4453,,3976134,3555337,3147282,816110,408055,
2021-04-18,88748,86511,2102,,4064882,3641725,3231622,820206,410103,
2021-04-19,68976,67441,1453,,4133858,3709036,3297531,823010,411505,
2021-04-20,102115,98789,3120,,4235973,3807663,3393103,829120,414560,
2021-04-21,142051,137772,4043,,4378024,3945261,3526726,837070,418535,
2021-04-22,139506,135353,3911,,4517530,4080485,3658095,844780,422390,
2021-04-23,138222,131798,6176,,4655752,4212129,3783621,857016,428508,
2021-04-24,130297,126233,3889,,4786049,4338214,3905873,864682,432341,
2021-04-25,102022,98610,3180,,4888071,4436676,4001222,870908,435454,
2021-04-26,71008,69302,1558,,4959079,4505847,4068895,873904,436952,
2021-04-27,98518,95425,2900,,5057597,4601111,4161322,879578,439789,
2021-04-28,120581,115954,4434,,5178178,4716897,4272746,888302,444151,
2021-04-29,124489,119293,5047,,5302667,4836023,4386894,898258,449129,
2021-04-30,115830,110573,5015,,5418497,4946423,4492356,908134,454067,
2021-05-01,111308,107435,3652,,5529805,5053677,4596035,915284,457642,
2021-05-02,79146,76170,2863,,5608951,5129690,4669251,920878,460439,
2021-05-03,56794,55124,1597,,5665745,5184659,4722683,923952,461976,
2021-05-04,91934,88564,3282,,5757679,5273045,4807864,930362,465181,
2021-05-05,138004,133296,4620,,5895683,5406172,4936434,939476,469738,
2021-05-06,141841,136885,4817,,6037524,5542873,5068380,948986,474493,
2021-05-07,150289,145247,4837,,6187813,5687960,5208689,958542,479271,
2021-05-08,142474,137782,4440,,6330287,5825547,5341915,967264,483632,
2021-05-09,124815,121163,3482,,6455102,5946546,5459496,974100,487050,
2021-05-10,97815,95826,1884,,6552917,6042183,5553316,977734,488867,
2021-05-11,113544,108860,4496,,6666461,6150841,5657549,986584,493292,
2021-05-12,145058,138023,6886,,6811519,6288685,5788573,1000224,500112,
2021-05-13,142715,135322,7238,,6954234,6423832,5916556,1014552,507276,
2021-05-14,148873,138780,9922,,7103107,6562424,6045291,1034266,517133,
2021-05-15,159748,149699,9868,,7262855,6711936,6185010,1053852,526926,
2021-05-16,144366,136096,8063,,7407221,6847864,6312955,1069818,534909,
2021-05-17,114983,110885,3944,,7522204,6958560,6419783,1077554,538777,
2021-05-18,111349,100482,10664,,7633553,7058846,6509467,1098758,549379,
2021-05-19,149890,133475,16237,,7783443,7192169,6626627,1131084,565542,
2021-05-20,151576,131581,19777,,7935019,7323561,6738311,1170500,585250,
2021-05-21,165406,140897,24250,,8100425,7464277,6854854,1218846,609423,
2021-05-22,199452,172251,26973,,8299877,7636330,7000015,1272630,636315,
2021-05-23,139843,127472,12225,,8439720,7763624,7115146,1296956,648478,
2021-05-24,100300,93328,6827,,8540020,7856779,7201544,1310470,655235,
2021-05-25,90477,82990,7276,,8630497,7939606,7277162,1324888,662444,
2021-05-26,139794,113024,26506,,8770291,8052443,7363563,1377760,688880,
2021-05-27,152070,123050,28768,,8922361,8175336,7457757,1435158,717579,
2021-05-28,163878,132320,31250,,9086239,8307483,7558713,1497540,748770,
2021-05-29,153397,117135,36029,,9239636,8424468,7639725,1569486,784743,
2021-05-30,149733,119026,30479,,9389369,8543324,7728164,1630320,815160,
2021-05-31,99219,79824,19202,,9488588,8622978,7788680,1668596,834298,
2021-06-01,124211,90622,33250,,9612799,8713405,7845932,1734946,867473,
2021-06-02,145330,102163,42916,,9758129,8815387,7905067,1820640,910320,
2021-06-03,155380,99923,55176,,9913509,8915125,7949700,1930850,965425,
2021-06-04,181729,115544,65913,,10095238,9030470,7999220,2062500,1031250,
2021-06-05,172043,103443,68316,,10267281,9133715,8034234,2198962,1099481,
2021-06-06,163400,91873,71246,,10430681,9225410,8054753,2341314,1170657,
2021-06-07,119568,63061,56289,,10550249,9288274,8061403,2453742,1226871,
2021-06-08,161903,72459,89004,,10712152,9360544,8044749,2631590,1315795,
2021-06-09,181475,70814,110190,,10893627,9431181,8005277,2851808,1425904,
2021-06-10,185594,66430,118671,,11079221,9497408,7952924,3088968,1544484,
2021-06-11,204803,67527,136515,,11284024,9564749,7883832,3361834,1680917,
2021-06-12,199749,62685,136461,,11483773,9627252,7809966,3634572,1817286,
2021-06-13,190352,58899,130921,,11674125,9685976,7737849,3896254,1948127,
2021-06-14,137693,38700,98594,,11811818,9724480,7677864,4093232,2046616,
2021-06-15,189565,42624,146582,,12001383,9766885,7573784,4386202,2193101,
2021-06-16,206269,42439,163182,,12207652,9809128,7452948,4712360,2356180,
2021-06-17,210481,37947,171948,,12418133,9846860,7318824,5056072,2528036,
2021-06-18,217209,35368,181237,,12635342,9882038,7172857,5418362,2709181,
2021-06-19,215907,35506,179724,,12851249,9917338,7028545,5777586,2888793,
2021-06-20,186285,35576,150130,,13037534,9952716,6913901,6077630,3038815,
2021-06-21,120439,20831,99103,,13157973,9973352,6835526,6275652,3137826,
2021-06-22,204955,27529,176669,,13362928,10000687,6686301,6628772,3314386,
2021-06-23,230553,28640,201165,,13593481,10029127,6513684,7030886,3515443,
2021-06-24,227715,26683,200274,,13821196,10055614,6340007,7431214,3715607,
2021-06-25,251134,27999,222383,,14072330,10083411,6145540,7875742,3937871,
2021-06-26,261321,30019,230593,,14333651,10113204,5944881,8336646,4168323,
2021-06-27,205014,27797,176609,,14538665,10140819,5795997,8689644,4344822,
2021-06-28,199261,20957,177735,,14737926,10161578,5639146,9044864,4522432,
2021-06-29,250123,24497,224890,,14988049,10185834,5438666,9494336,4747168,
2021-06-30,275556,24182,250805,,15263605,10209813,5211969,9995688,4997844,
2021-07-01,271982,25314,246112,,15535587,10234909,4991092,10487634,5243817,
2021-07-02,144738,11594,132913,,15680325,10246329,4869701,10753256,5376628,
2021-07-03,216907,19937,196739,,15897232,10266044,4692826,11146436,5573218,
2021-07-04,196226,19463,176538,,16093458,10285321,4535684,11499274,5749637,
2021-07-05,148727,12449,136135,,16242185,10297580,4411936,11771288,5885644,
2021-07-06,220044,20000,199827,,16462229,10317364,4232039,12170650,6085325,
2021-07-07,246624,22973,223409,,16708853,10340111,4031525,12617172,6308586,
2021-07-08,231226,21369,209644,,16940079,10361274,3843179,13036190,6518095,
2021-07-09,227010,21516,205325,,17167089,10382588,3659300,13446576,6723288,
2021-07-10,209071,20542,188372,,17376160,10402926,3491403,13823046,6911523,
2021-07-11,171688,17589,153971,,17547848,10420314,3354967,14130694,7065347,
2021-07-12,123137,11445,111593,,17670985,10431570,3254767,14353606,7176803,
2021-07-13,178522,19038,159340,,17849507,10450386,3114398,14671976,7335988,
2021-07-14,180048,19307,160583,,18029555,10469478,2973070,14992816,7496408,
2021-07-15,167215,19591,147449,,18196770,10488858,2845165,15287386,7643693,
2021-07-16,169373,19918,149304,,18366143,10508574,2715730,15585688,7792844,
2021-07-17,173029,20276,152622,,18539172,10528601,2583327,15890548,7945274,
2021-07-18,133644,15941,117564,,18672816,10544358,2481668,16125380,8062690,
2021-07-19,91991,10421,81462,,18764807,10554566,2410589,16287954,8143977,
2021-07-20,133550,16958,116536,,18898357,10571284,2310947,16520674,8260337,
2021-07-21,140090,16987,123032,,19038447,10588056,2204849,16766414,8383207,
2021-07-22,125637,17658,107841,,19164084,10605490,2114619,16981742,8490871,
2021-07-23,120284,16998,103079,,19284368,10622247,2028496,17187502,8593751,
2021-07-24,126707,18337,108132,,19411075,10640381,1938661,17403440,8701720,
2021-07-25,103656,14870,88655,,19514731,10655027,1864833,17580388,8790194,
2021-07-26,66697,9892,56710,,19581428,10664702,1817978,17693448,8846724,
2021-07-27,92394,15322,76910,,19673822,10679763,1756346,17846834,8923417,
2021-07-28,93959,16476,77412,,19767781,10696004,1695366,18001276,9000638,
2021-07-29,89408,16708,72537,,19857189,10712480,1639493,18145974,9072987,
2021-07-30,84072,16105,67851,,19941261,10728357,1587707,18281300,9140650,
2021-07-31,83874,15735,67992,,20025135,10743874,1535422,18416904,9208452,
2021-08-01,61883,11324,50373,,20087018,10754972,1496338,18517268,9258634,
2021-08-02,42499,7422,34956,,20129517,10762196,1468772,18586848,9293424,
2021-08-03,33303,5960,27169,,20162820,10767923,1447540,18640766,9320383,
2021-08-04,61333,12379,48763,,20224153,10780067,1411119,18737896,9368948,
2021-08-05,59467,12555,46759,,20283620,10792414,1376871,18831086,9415543,
2021-08-06,56034,11861,43958,,20339654,10804015,1344743,18918544,9459272,
2021-08-07,62383,12137,50051,,20402037,10815891,1306786,19018210,9509105,
2021-08-08,48705,9281,39232,,20450742,10824944,1276812,19096264,9548132,
2021-08-09,30863,5940,24745,,20481605,10830670,1257980,19145380,9572690,
2021-08-10,49272,10518,38451,,20530877,10840908,1230013,19221790,9610895,
2021-08-11,48732,10768,37713,,20579609,10851429,1203037,19296784,9648392,
2021-08-12,49265,11207,37824,,20628874,10862385,1176378,19372014,9686007,
2021-08-13,49643,11738,37630,,20678517,10873882,1150456,19446852,9723426,
2021-08-14,51231,12139,38880,,20729748,10885771,1123689,19524164,9762082,
2021-08-15,41777,9856,31696,,20771525,10895425,1101819,19587212,9793606,
2021-08-16,26746,6190,20406,,20798271,10901392,1087577,19627630,9813815,
2021-08-17,40516,11063,29185,,20838787,10912205,1069431,19685548,9842774,
2021-08-18,41904,11976,29685,,20880691,10923939,1051690,19744498,9872249,
2021-08-19,45906,16541,29101,,20926597,10940229,1039102,19802254,9901127,
2021-08-20,46461,16301,29746,,20973058,10956274,1025630,19861288,9930644,
2021-08-21,47963,15152,32443,,21021021,10971166,1008306,19925720,9962860,
2021-08-22,34404,10810,23321,,21055425,10981730,995771,19971918,9985959,
2021-08-23,23226,7006,16001,,21078651,10988501,986755,20003492,10001746,
2021-08-24,37655,13375,23822,,21116306,11001622,976285,20050674,10025337,
2021-08-25,41367,14427,26329,,21157673,11015793,964364,20102858,10051429,
2021-08-26,39278,13557,24979,,21196951,11029074,952907,20152334,10076167,
2021-08-27,37684,12948,23690,,21234635,11041781,942138,20199286,10099643,
2021-08-28,40130,13426,25525,,21274765,11054928,930015,20249826,10124913,
2021-08-29,30566,10257,19947,,21305331,11064953,920306,20289294,10144647,
2021-08-30,18241,6141,11848,,21323572,11070846,914570,20312552,10156276,
2021-08-31,32719,11940,19625,,21356291,11082518,906857,20351322,10175661,
2021-09-01,36258,12952,21961,,21392549,11095237,897832,20394810,10197405,
2021-09-02,37789,15648,19673,,21430338,11110633,893782,20433702,10216851,
2021-09-03,46897,21099,22446,,21477235,11131483,892416,20478134,10239067,
2021-09-04,46886,20591,24779,,21524121,11151828,888205,20527246,10263623,
2021-09-05,33086,14209,18583,,21557207,11165793,883811,20563964,10281982,
2021-09-06,21721,9491,12038,,21578928,11175035,881247,20587576,10293788,
2021-09-07,15017,6730,8101,,21593945,11181508,879859,20603298,10301649,
2021-09-08,41152,17116,20938,,21635097,11198360,876019,20644682,10322341,
2021-09-09,41459,16981,19681,,21676556,11215064,873294,20683540,10341770,
2021-09-10,39661,15513,19013,,21716217,11230314,869776,20721076,10360538,
2021-09-11,42387,15936,23340,,21758604,11245971,862351,20767240,10383620,
2021-09-12,29974,11534,17872,,21788578,11257211,855983,20802456,10401228,
2021-09-13,16092,6406,9188,,21804670,11263383,853186,20820394,10410197,
2021-09-14,29916,11563,15296,,21834586,11274644,849426,20850436,10425218,
2021-09-15,39286,14025,19426,,21873872,11288409,844009,20888800,10444400,
2021-09-16,39353,13988,19250,,21913225,11302162,838724,20926876,10463438,
2021-09-17,38940,13614,19345,,21952165,11315533,832981,20965104,10482552,
2021-09-18,41262,14089,23549,,21993427,11329349,823500,21011698,10505849,
2021-09-19,30667,10829,18987,,22024094,11339919,815329,21049180,10524590,
2021-09-20,16734,6099,10177,,22040828,11345764,811228,21069072,10534536,
2021-09-21,31370,11218,16996,,22072198,11356717,805434,21102566,10551283,
2021-09-22,41819,14818,22930,,22114017,11371239,797301,21147876,10573938,
2021-09-23,47235,16138,26035,,22161252,11387112,787385,21199454,10599727,
2021-09-24,46322,15638,26660,,22207574,11402490,776344,21252292,10626146,
2021-09-25,48206,15258,29953,,22255780,11417495,761630,21311730,10655865,
2021-09-26,37517,12425,24497,,22293297,11429645,749537,21360216,10680108,
2021-09-27,19162,6531,12324,,22312459,11435922,743728,21384388,10692194,
2021-09-28,30965,11295,17887,,22343424,11446958,737124,21419668,10709834,
2021-09-29,37894,12477,21731,,22381318,11459164,727850,21462628,10731314,
2021-09-30,37350,11656,21377,,22418668,11470561,718110,21504902,10752451,
2021-10-01,30884,9811,18416,,22449552,11480145,709492,21541306,10770653,
2021-10-02,37144,11160,23591,,22486696,11491035,697043,21587984,10793992,
2021-10-03,27209,8165,18325,,22513905,11498959,686870,21624178,10812089,
2021-10-04,14869,4747,9803,,22528774,11503459,681796,21643326,10821663,
2021-10-05,26844,8600,15882,,22555618,11511798,674499,21674598,10837299,
2021-10-06,31674,9640,18518,,22587292,11521179,665613,21711132,10855566,
2021-10-07,30357,9402,17122,,22617649,11530330,657880,21744900,10872450,
2021-10-08,32847,10745,18856,,22650496,11540804,649755,21782098,10891049,
2021-10-09,34150,10668,21020,,22684646,11551209,639389,21823640,10911820,
2021-10-10,23420,7662,15091,,22708066,11558620,631948,21853344,10926672,
2021-10-11,12005,3839,7867,,22720071,11562209,627904,21868610,10934305,
2021-10-12,5120,1629,3274,,22725191,11563560,626244,21874632,10937316,
2021-10-13,29121,9193,18096,,22754312,11572463,617325,21910276,10955138,
2021-10-14,29023,8905,17753,,22783335,11581092,608467,21945250,10972625,
2021-10-15,29106,8832,18174,,22812441,11589661,599112,21981098,10990549,
2021-10-16,31144,8988,19873,,22843585,11598358,588215,22020286,11010143,
2021-10-17,23721,7264,15384,,22867306,11605368,580082,22050572,11025286,
2021-10-18,12311,3747,8151,,22879617,11608834,575666,22066336,11033168,
2021-10-19,21285,6631,12641,,22900902,11615182,569643,22091078,11045539,
2021-10-20,25677,7541,14927,,22926579,11622476,562244,22120464,11060232,
2021-10-21,23184,6684,13034,,22949763,11628891,555883,22146016,11073008,
2021-10-22,26134,7317,15121,,22975897,11635885,548063,22175644,11087822,
2021-10-23,28192,7606,17165,,23004089,11643229,538497,22209464,11104732,
2021-10-24,19355,5729,12604,,23023444,11648702,531610,22234184,11117092,
2021-10-25,9932,2710,6477,,23033376,11651143,527835,22246616,11123308,
2021-10-26,18927,5395,11105,,23052303,11656260,522116,22268288,11134144,
2021-10-27,22865,6081,13220,,23075168,11662086,514963,22294246,11147123,
2021-10-28,22309,5791,12648,,23097477,11667589,508095,22318988,11159494,
2021-10-29,22819,5733,13053,,23120296,11673020,500760,22344520,11172260,
2021-10-30,24124,6047,14622,,23144420,11678795,492173,22373244,11186622,
2021-10-31,16489,4596,10606,,23160909,11683097,486158,22393878,11196939,
2021-11-01,7872,2081,5056,,23168781,11684898,483170,22403456,11201728,
2021-11-02,15629,4364,7748,,23184410,11688973,479775,22418396,11209198,
2021-11-03,18635,5070,9607,,23203045,11693740,475228,22437024,11218512,
2021-11-04,19510,4875,10035,,23222555,11698339,470053,22456572,11228286,
2021-11-05,21474,4405,9525,,23244029,11702455,464919,22475072,11237536,
2021-11-06,25340,5209,12156,,23269369,11707395,457955,22498880,11249440,
2021-11-07,21456,4026,8926,,23290825,11711140,453043,22516194,11258097,
2021-11-08,11992,2111,4732,,23302817,11712956,450406,22525100,11262550,
2021-11-09,24133,3853,7654,,23326950,11716488,446595,22539786,11269893,
2021-11-10,28480,4508,8998,,23355430,11720720,442091,22557258,11278629,
2021-11-11,28770,4310,9102,,23384200,11724733,437290,22574886,11287443,
2021-11-12,26751,4166,8245,,23410951,11728608,433197,22590822,11295411,
2021-11-13,34320,5082,11416,,23445271,11733384,426854,22613060,11306530,
2021-11-14,23226,3900,8610,,23468497,11737021,422137,22629768,11314884,
2021-11-15,12703,2186,4496,,23481200,11738947,419819,22638256,11319128,
2021-11-16,26189,3934,7490,,23507389,11742625,416259,22652732,11326366,
2021-11-17,31177,4046,7827,,23538566,11746389,412468,22667842,11333921,
2021-11-18,32511,3868,7531,,23571077,11749951,408791,22682320,11341160,
2021-11-19,35484,3866,7759,,23606561,11753516,404886,22697260,11348630,
2021-11-20,40119,4382,8822,,23646680,11757617,400437,22714360,11357180,
2021-11-21,28127,3439,6952,,23674807,11760794,396910,22727768,11363884,
2021-11-22,14900,1951,3894,,23689707,11762468,394961,22735014,11367507,
2021-11-23,33057,3278,6011,,23722764,11765466,392220,22746492,11373246,
2021-11-24,42670,3762,6811,,23765434,11768924,389160,22759528,11379764,
2021-11-25,46048,3934,6577,,23811482,11772583,386514,22772138,11386069,
2021-11-26,52869,11348,6617,,23864351,11783660,391238,22784844,11392422,
2021-11-27,63527,22357,7041,,23927878,11805736,406544,22798384,11399192,
2021-11-28,51463,27742,5319,,23979341,11833186,428955,22808462,11404231,
2021-11-29,33529,18933,2884,,24012870,11851858,444993,22813730,11406865,
2021-11-30,56048,20687,5139,,24068918,11872264,460531,22823466,11411733,
2021-12-01,69547,26243,5640,,24138465,11898201,481120,22834162,11417081,
2021-12-02,71640,26489,5040,,24210105,11924392,502556,22843672,11421836,
2021-12-03,73429,25097,5173,,24283534,11949193,522474,22853438,11426719,
2021-12-04,81164,27784,6078,47282,24364698,11976683,544171,,11432512,807747
2021-12-05,62639,31932,4415,26270,24427337,12008320,571680,,11436640,833913
2021-12-06,38629,19144,2713,16757,24465966,12027174,588104,,11439070,850592
2021-12-07,60298,14853,4483,40948,24526264,12041755,598464,,11443291,891466
2021-12-08,73455,19057,4682,49713,24599719,12060535,612829,,11447706,941101
2021-12-09,74508,18275,4347,51866,24674227,12078501,626749,,11451752,992882
2021-12-10,77510,17589,4659,55250,24751737,12095809,639674,,11456135,1048051
2021-12-11,83197,20405,5839,56941,24834934,12115925,654226,,11461699,1104906
2021-12-12,60763,22699,4161,33860,24895697,12138344,672758,,11465586,1138677
2021-12-13,34940,11603,2414,20900,24930637,12149650,681937,,11467713,1159482
2021-12-14,101992,9002,3876,89070,25032629,12158341,687048,,11471293,1248432
2021-12-15,127706,12429,4516,110723,25160335,12170466,694951,,11475515,1359055
2021-12-16,139372,12468,4256,122632,25299707,12182648,703153,,11479495,1481588
2021-12-17,159185,12404,4526,142233,25458892,12194777,711022,,11483755,1623724
2021-12-18,175593,13523,4926,157098,25634485,12208006,719607,,11488399,1780727
2021-12-19,140446,18160,3936,118313,25774931,12225865,733823,,11492042,1898929
2021-12-20,106825,10305,2747,93726,25881756,12235902,741371,,11494531,1992557
2021-12-21,215405,12967,4324,198092,26097161,12248553,750007,,11498546,2190528
2021-12-22,237265,14427,5204,217751,26334426,12262680,759216,,11503464,2408161
2021-12-23,257787,11731,5091,240867,26592213,12274105,765850,,11508255,2648922
2021-12-24,223640,9465,4576,209532,26815853,12283273,770735,,11512538,2858338
2021-12-25,89735,3890,2513,83344,26905588,12286888,772107,,11514781,2941575
2021-12-26,11900,388,360,11142,26917488,12286984,772127,,11514857,2952587
2021-12-27,46945,1491,1116,44307,26964433,12288230,772495,,11515735,2996774
2021-12-28,144790,6100,4012,134615,27109223,12294036,774572,,11519464,3131258
2021-12-29,175476,9377,4586,161443,27284699,12303117,779359,,11523758,3292573
2021-12-30,200074,10135,5352,184545,27484773,12312949,784127,,11528822,3476984
2021-12-31,195220,10009,5808,179150,27679993,12322669,788319,,11534350,3656008
2022-01-01,96959,5384,3884,87364,27776952,12327744,789811,,11537933,3743223
2022-01-02,19451,943,930,17448,27796403,12328396,789815,,11538581,3760525
2022-01-03,88258,4773,4593,78811,27884661,12332859,789987,,11542872,3839183
2022-01-04,146381,6003,5323,135016,28031042,12338534,790654,,11547880,3974043
2022-01-05,177521,7635,7298,162414,28208563,12345815,790980,,11554835,4136297
2022-01-06,191555,7217,6790,177021,28400118,12352713,791396,,11561317,4313163
2022-01-07,191311,7969,7007,175521,28591429,12360338,792346,,11567992,4488511
2022-01-08,181692,8631,6644,165228,28773121,12368637,794320,,11574317,4653583
2022-01-09,131107,9868,7187,113959,28904228,12378183,796996,,11581187,4767382
2022-01-10,90563,5108,4489,80835,28994791,12382968,797605,,11585363,4848064
2022-01-11,138909,6164,6584,125455,29133700,12388785,797172,,11591613,4973329
2022-01-12,157047,8167,8062,138695,29290747,12396623,797272,,11599351,5111856
2022-01-13,162695,9216,9219,141550,29453442,12405477,797255,,11608222,5253223
2022-01-14,159905,10757,10388,136069,29613347,12415872,797619,,11618253,5389094
2022-01-15,161216,11015,11677,135890,29774563,12426515,796946,,11629569,5524791
2022-01-16,109793,9295,9679,89457,29884356,12435448,796555,,11638893,5614030
2022-01-17,65790,5940,6567,52642,29950146,12441052,795918,,11645134,5666487
2022-01-18,36126,2007,2138,31158,29986272,12442704,795776,,11646928,5697449
2022-01-19,101333,5587,6723,85963,30087605,12447891,794622,,11653269,5783185
2022-01-20,103613,6327,7008,85740,30191218,12453834,793933,,11659901,5868702
2022-01-21,102120,6235,8060,82513,30293338,12459665,792094,,11667571,5950987
2022-01-22,102595,8720,12076,78120,30395933,12467996,788731,,11679265,6028879
2022-01-23,76707,7308,14000,54800,30472640,12474961,782032,,11692929,6083457
2022-01-24,42269,3199,7936,30746,30514909,12477796,777277,,11700519,6113996
2022-01-25,62576,3759,8374,48122,30577485,12481173,772647,,11708526,6161898
2022-01-26,77897,4919,13172,55695,30655382,12485715,764389,,11721326,6217351
2022-01-27,78085,4898,13246,56055,30733467,12490241,756031,,11734210,6273169
2022-01-28,77295,4676,13677,53903,30810762,12494559,747017,,11747542,6326853
2022-01-29,84831,5531,17718,58119,30895593,12499726,734823,,11764903,6384727
2022-01-30,66514,5025,20632,40160,30962107,12504409,719202,,11785207,6424662
2022-01-31,34757,2179,9888,22351,30996864,12506269,711484,,11794785,6446824
2022-02-01,51357,3266,9665,36531,31048221,12509182,705075,,11804107,6483130
2022-02-02,57722,3851,12403,38681,31105943,12512702,696508,,11816194,6521611
2022-02-03,52587,3611,11513,34302,31158530,12515936,688594,,11827342,6555662
2022-02-04,43101,2946,10567,27286,31201631,12518570,680963,,11837607,6582753
2022-02-05,58733,3748,14474,37567,31260364,12521986,670225,,11851761,6620107
2022-02-06,49868,3643,16120,29574,31310232,12525306,657743,,11867563,6649457
2022-02-07,23245,1693,7813,13447,31333477,12526673,651610,,11875063,6662680
2022-02-08,33410,2360,7256,21975,31366887,12528703,646707,,11881996,6684422
2022-02-09,38892,2786,8923,24411,31405779,12531130,640564,,11890566,6708581
2022-02-10,37545,2765,8838,22556,31443324,12533558,634487,,11899071,6730906
2022-02-11,39454,2725,10296,23007,31482778,12535935,626906,,11909029,6753674
2022-02-12,42056,2959,11458,25321,31524834,12538560,618396,,11920164,6778771
2022-02-13,36331,2803,13148,19943,31561165,12541076,608048,,11933028,6798516
2022-02-14,16985,1176,6124,9475,31578150,12541977,603092,,11938885,6807791
2022-02-15,19371,1389,4759,11880,31597521,12543042,599712,,11943330,6819444
2022-02-16,26034,1769,7739,14949,31623555,12544514,593738,,11950776,6834192
2022-02-17,26773,1684,7528,14987,31650328,12545843,587885,,11957958,6848924
2022-02-18,23954,1355,6614,13681,31674282,12546881,582614,,11964267,6862396
2022-02-19,37841,1904,8340,26056,31712123,12548452,576173,,11972279,6888209
2022-02-20,32581,1499,7964,22807,31744704,12549650,569700,,11979950,6910811
2022-02-21,17505,914,3679,12758,31762209,12550268,566926,,11983342,6923357
2022-02-22,9114,431,1555,6958,31771323,12550409,565797,,11984612,6930104
2022-02-23,25343,1327,4798,17298,31796666,12551426,562319,,11989107,6947166
2022-02-24,24579,1401,5233,15485,31821245,12552505,558482,,11994023,6962408
2022-02-25,23112,1397,5138,14509,31844357,12553608,554734,,11998874,6976691
2022-02-26,25239,1386,5911,16560,31869596,12554684,550202,,12004482,6993025
2022-02-27,26962,1371,7372,17705,31896558,12555786,544190,,12011596,7010535
2022-02-28,10130,594,2531,6745,31906688,12556127,542245,,12013882,7017097
2022-03-01,13205,950,3152,8167,31919893,12556772,540033,,12016739,7025047
2022-03-02,15421,1164,3578,9622,31935314,12557674,537612,,12020062,7034491
2022-03-03,14304,1080,3228,8689,31949618,12558442,535456,,12022986,7042949
2022-03-04,14481,993,3446,8318,31964099,12559114,532999,,12026115,7051014
2022-03-05,18539,1278,4999,11186,31982638,12560082,529267,,12030815,7061976
2022-03-06,16521,1089,5526,9608,31999159,12560890,524824,,12036066,7071377
2022-03-07,5951,469,1862,3509,32005110,12561074,523424,,12037650,7074669
2022-03-08,7369,701,1944,4159,32012479,12561497,522174,,12039323,7078629
2022-03-09,11178,908,2740,6407,32023657,12562129,520336,,12041793,7084834
2022-03-10,12771,1046,3260,6842,32036428,12562898,518115,,12044783,7091463
2022-03-11,12894,905,3410,6867,32049322,12563514,515602,,12047912,7098114
2022-03-12,14693,1049,4190,8310,32064015,12564291,512458,,12051833,7106220
2022-03-13,14752,1091,4999,8336,32078767,12565091,508546,,12056545,7114319
2022-03-14,6336,450,2230,3500,32085103,12565270,506763,,12058507,7117605
2022-03-15,10200,793,2625,5974,32095303,12565773,504919,,12060854,7123365
2022-03-16,13070,935,3670,6954,32108373,12566418,502181,,12064237,7130088
2022-03-17,13201,1050,3964,6759,32121574,12567180,499260,,12067920,7136627
2022-03-18,11909,915,3147,6433,32133483,12567792,497018,,12070774,7142836
2022-03-19,14444,1005,4163,7903,32147927,12568517,493858,,12074659,7150520
2022-03-20,11754,992,3960,6374,32159681,12569237,490885,,12078352,7156686
2022-03-21,5059,415,1589,2814,32164740,12569393,489707,,12079686,7159297
2022-03-22,6717,552,1559,3894,32171457,12569657,488694,,12080963,7162975
2022-03-23,9973,787,2300,5195,32181430,12570128,487178,,12082950,7167929
2022-03-24,9299,723,2377,4615,32190729,12570587,485515,,12085072,7172340
2022-03-25,9233,782,2158,4754,32199962,12571106,484131,,12086975,7176882
2022-03-26,10932,937,2837,5506,32210894,12571766,482229,,12089537,7182169
2022-03-27,10229,912,3539,5301,32221123,12572418,479598,,12092820,7187259
2022-03-28,3584,322,1109,1987,32224707,12572499,478808,,12093691,7189051
2022-03-29,5352,500,1217,2692,32230059,12572714,478085,,12094629,7191521
2022-03-30,7858,748,1839,4124,32237917,12573183,476989,,12096194,7195420
2022-03-31,8656,689,1926,4415,32246573,12573583,475746,,12097837,7199613
2022-04-01,9315,802,1917,4889,32255888,12574093,474622,,12099471,7204263
2022-04-02,10447,886,2215,5573,32266335,12574692,473281,,12101411,7209619
2022-04-03,9212,880,2569,5067,32275547,12575315,471586,,12103729,7214484
2022-04-04,4204,388,1006,2407,32279751,12575441,470965,,12104476,7216687
2022-04-05,6082,601,1037,3054,32285833,12575701,470523,,12105178,7219465
2022-04-06,8383,715,1479,4384,32294216,12576125,469754,,12106371,7223622
2022-04-07,10352,733,1689,4837,32304568,12576558,468793,,12107765,7228216
2022-04-08,23998,812,1584,4837,32328566,12577092,468015,,12109077,7232837
2022-04-09,30499,970,1975,5894,32359065,12577764,467001,,12110763,7238508
2022-04-10,24870,976,2393,5336,32383935,12578481,465578,,12112903,7243642
2022-04-11,12577,386,877,2432,32396512,12578617,465083,,12113534,7245872
2022-04-12,28136,693,1023,3537,32424648,12579006,464746,,12114260,7249176
2022-04-13,37786,853,1562,4928,32462434,12579560,464033,,12115527,7253874
2022-04-14,37908,761,1619,4915,32500342,12580007,463172,,12116835,7258535
2022-04-15,43405,1234,2104,6726,32543747,12580943,462298,,12118645,7265024
2022-04-16,8095,356,650,1741,32551842,12581039,462002,,12119037,7266549
2022-04-17,21027,871,1925,4319,32572869,12581626,460941,,12120685,7270645
2022-04-18,5464,306,464,1290,32578333,12581645,460778,,12120867,7271694
2022-04-19,22659,615,775,3103,32600992,12581977,460609,,12121368,7274577
2022-04-20,40346,1063,1403,4620,32641338,12582714,460266,,12122448,7278933
2022-04-21,38759,943,1600,4683,32680097,12583361,459600,,12123761,7283382
2022-04-22,35639,1017,1437,4270,32715736,12584106,459173,,12124933,7287434
2022-04-23,34659,1005,1740,4714,32750395,12584827,458435,,12126392,7291909
2022-04-24,20817,1021,1890,3777,32771212,12585598,457563,,12128035,7295492
2022-04-25,8299,453,691,1707,32779511,12585782,457324,,12128458,7296983
2022-04-26,24624,733,948,3145,32804135,12586223,457103,,12129120,7299891
2022-04-27,33605,956,1370,3939,32837740,12586902,456681,,12130221,7303612
2022-04-28,32846,930,1420,3931,32870586,12587559,456182,,12131377,7307320
2022-04-29,32064,1098,1381,3909,32902650,12588359,455892,,12132467,7311000
2022-04-30,30292,925,1539,4025,32932942,12588986,455271,,12133715,7314789
2022-05-01,16757,770,1581,2970,32949699,12589458,454455,,12135003,7317515
2022-05-02,5936,309,526,1098,32955635,12589471,454234,,12135237,7318386
2022-05-03,20933,588,834,2347,32976568,12589754,453982,,12135772,7320494
2022-05-04,29418,800,1093,3290,33005986,12590244,453684,,12136560,7323535
2022-05-05,29101,872,1166,3125,33035087,12590803,453380,,12137423,7326415
2022-05-06,29101,1147,1287,2987,33064188,12591661,453235,,12138426,7329175
2022-05-07,28494,870,1266,3113,33092682,12592241,452834,,12139407,7332064
2022-05-08,16001,895,1309,2323,33108683,12592879,452418,,12140461,7334186
2022-05-09,5897,293,474,943,33114580,12592905,452230,,12140675,7334919
2022-05-10,21232,698,724,2120,33135812,12593285,452197,,12141088,7336779
2022-05-11,28955,837,1087,2656,33164767,12593790,451943,,12141847,7339164
2022-05-12,28244,799,1086,2515,33193011,12594292,451652,,12142640,7341438
2022-05-13,27598,878,1119,2469,33220609,12594859,451406,,12143453,7343650
2022-05-14,25694,807,1100,2610,33246303,12595352,451106,,12144246,7346006
2022-05-15,14851,751,1276,2058,33261154,12595831,450574,,12145257,7347845
2022-05-16,6387,326,533,1048,33267541,12595919,450363,,12145556,7348706
2022-05-17,19607,590,781,1743,33287148,12596193,450165,,12146028,7350200
2022-05-18,26549,877,1101,2277,33313697,12596805,449936,,12146869,7352261
2022-05-19,24447,684,1159,2164,33338144,12597222,449454,,12147768,7354208
2022-05-20,24272,801,1141,2218,33362416,12597752,449110,,12148642,7356206
2022-05-21,22407,692,1168,2351,33384823,12598134,448625,,12149509,7358314
2022-05-22,10561,549,891,1489,33395384,12598422,448278,,12150144,7359586
2022-05-23,4574,242,465,793,33399958,12598404,448053,,12150351,7360170
2022-05-24,2629,120,182,442,33402587,12598268,447989,,12150279,7360401
2022-05-25,19369,656,949,1954,33421956,12598657,447686,,12150971,7362144
2022-05-26,20651,664,951,1913,33442607,12599047,447393,,12151654,7363834
2022-05-27,21768,818,1062,2078,33464375,12599576,447146,,12152430,7365678
2022-05-28,19418,722,1167,2152,33483793,12600027,446698,,12153329,7367615
2022-05-29,12114,760,1284,1726,33495907,12600552,446167,,12154385,7369149
2022-05-30,4581,311,550,752,33500488,12600616,445924,,12154692,7369703
2022-05-31,13553,573,754,1667,33514041,12600887,445737,,12155150,7371130
2022-06-01,16617,704,975,1879,33530658,12601289,445464,,12155825,7372756
2022-06-02,14613,558,869,1678,33545271,12601535,445146,,12156389,7374193
2022-06-03,16112,699,1096,1818,33561383,12601954,444743,,12157211,7375791
2022-06-04,13325,647,1166,1845,33574708,12602343,444219,,12158124,7377434
2022-06-05,7870,587,1113,1432,33582578,12602681,443689,,12158992,7378674
2022-06-06,3295,207,446,641,33585873,12602639,443447,,12159192,7379113
2022-06-07,11227,475,729,1374,33597100,12602814,443188,,12159626,7380243
2022-06-08,14070,668,1013,1612,33611170,12603221,442838,,12160383,7381635
2022-06-09,13383,663,928,1676,33624553,12603596,442568,,12161028,7383079
2022-06-10,13856,686,1069,1698,33638409,12603994,442176,,12161818,7384547
2022-06-11,12986,616,1031,1846,33651395,12604324,441759,,12162565,7386170
2022-06-12,8099,643,1237,1504,33659494,12604708,441161,,12163547,7387467
2022-06-13,3190,284,422,713,33662684,12604724,441018,,12163706,7387970
2022-06-14,10131,512,666,1265,33672815,12604947,440858,,12164089,7388997
2022-06-15,13513,474,833,1622,33686328,12605124,440497,,12164627,7390380
2022-06-16,12552,497,858,1619,33698880,12605314,440130,,12165184,7391752
2022-06-17,11694,479,819,1653,33710574,12605504,439783,,12165721,7393167
2022-06-18,11456,438,876,1861,33722030,12605671,439342,,12166329,7394804
2022-06-19,7005,484,899,1420,33729035,12605901,438926,,12166975,7396008
2022-06-20,2287,147,301,643,33731322,12605824,438766,,12167058,7396481
2022-06-21,9547,358,616,1386,33740869,12605895,438503,,12167392,7397619
2022-06-22,13616,407,728,1705,33754485,12606030,438175,,12167855,7399099
2022-06-23,13705,402,775,1683,33768190,12606165,437799,,12168366,7400568
2022-06-24,15368,436,812,1675,33783558,12606341,437419,,12168922,7402028
2022-06-25,14473,427,852,1714,33798031,12606506,436983,,12169523,7403532
2022-06-26,8160,432,886,1280,33806191,12606676,436522,,12170154,7404595
2022-06-27,3213,171,365,594,33809404,12606597,436324,,12170273,7404981
2022-06-28,9620,369,559,1226,33819024,12606679,436130,,12170549,7405973
2022-06-29,13321,415,731,1633,33832345,12606803,435812,,12170991,7407366
2022-06-30,12234,481,848,1582,33844579,12606999,435443,,12171556,7408714
2022-07-01,13041,549,972,1949,33857620,12607290,435015,,12172275,7410457
2022-07-02,1619,111,117,366,33859239,12607125,435007,,12172118,7410591
2022-07-03,5165,260,494,962,33864404,12607126,434764,,12172362,7411336
2022-07-04,2758,132,279,615,33867162,12607011,434616,,12172395,7411754
2022-07-05,11148,372,600,1576,33878310,12607085,434380,,12172705,7413082
2022-07-06,15962,549,860,2010,33894272,12607337,434063,,12173274,7414848
2022-07-07,15670,521,832,1927,33909942,12607569,433751,,12173818,7416522
2022-07-08,17890,555,870,2247,33927832,12607819,433435,,12174384,7418520
2022-07-09,14152,451,597,1851,33941984,12607991,433288,,12174703,7420133
2022-07-10,8751,475,755,1505,33950735,12608216,433007,,12175209,7421430
2022-07-11,4094,199,331,871,33954829,12608148,432872,,12175276,7422079
2022-07-12,12111,410,525,1659,33966940,12608259,432752,,12175507,7423484
2022-07-13,16721,564,773,2144,33983661,12608525,432537,,12175988,7425383
2022-07-14,16862,483,676,2024,34000523,12608702,432333,,12176369,7427167
2022-07-15,28903,598,824,2187,34029426,12608999,432106,,12176893,7429112
2022-07-16,30304,586,774,2330,34059730,12609270,431909,,12177361,7431189
2022-07-17,22938,539,636,1895,34082668,12609570,431809,,12177761,7432888
2022-07-18,11398,189,255,857,34094066,12609490,431738,,12177752,7433522
2022-07-19,28961,593,592,2138,34123027,12609807,431736,,12178071,7435428
2022-07-20,37647,839,924,2598,34160674,12610365,431646,,12178719,7437787
2022-07-21,36364,734,812,2811,34197038,12610810,431561,,12179249,7440356
2022-07-22,35808,824,894,2688,34232846,12611344,431484,,12179860,7442806
2022-07-23,35157,821,913,2837,34268003,12611850,431384,,12180466,7445387
2022-07-24,21740,599,804,1779,34289743,12612186,431176,,12181010,7446941
2022-07-25,11939,308,311,1082,34301682,12612208,431168,,12181040,7447791
2022-07-26,26099,621,605,2215,34327781,12612544,431183,,12181361,7449762
2022-07-27,32478,808,849,2653,34360259,12613093,431140,,12181953,7452203
2022-07-28,31547,724,884,2612,34391806,12613518,430976,,12182542,7454562
2022-07-29,30002,1790,875,2649,34421808,12615014,431887,,12183127,7456959
2022-07-30,25839,2525,747,2440,34447647,12617257,433663,,12183594,7459165
2022-07-31,14319,1067,541,1571,34461966,12618054,434185,,12183869,7460507
2022-08-01,5917,337,223,684,34467883,12618131,434297,,12183834,7460968
2022-08-02,4489,306,138,607,34472372,12618166,434461,,12183705,7461352
2022-08-03,22950,2640,740,2244,34495322,12620529,436357,,12184172,7463360
2022-08-04,22239,2481,681,2136,34517561,12622681,438151,,12184530,7465231
2022-08-05,21800,2755,747,2071,34539361,12625154,440151,,12185003,7467073
2022-08-06,19651,2875,657,1999,34559012,12627716,442363,,12185353,7468812
2022-08-07,12712,2236,621,1425,34571724,12629677,443972,,12185705,7470019
2022-08-08,4766,570,188,603,34576490,12629958,444347,,12185611,7470384
2022-08-09,14020,1467,560,1597,34590510,12631136,445248,,12185888,7471739
2022-08-10,19133,2363,716,1997,34609643,12633224,446893,,12186331,7473506
2022-08-11,17084,2041,718,1860,34626727,12634989,448214,,12186775,7475133
2022-08-12,16986,2048,735,1852,34643713,12636748,449526,,12187222,7476756
2022-08-13,15956,2223,766,1809,34659669,12638684,450981,,12187703,7478322
2022-08-14,9531,1621,619,1087,34669200,12640015,451979,,12188036,7479173
2022-08-15,3876,388,271,482,34673076,12640146,452093,,12188053,7479445
2022-08-16,10811,1075,516,1356,34683887,12640919,452650,,12188269,7480549
2022-08-17,16105,1834,739,1785,34699992,12642464,453744,,12188720,7482097
2022-08-18,14936,1640,751,1697,34714928,12643779,454629,,12189150,7483522
2022-08-19,15319,1847,749,1552,34730247,12645347,455723,,12189624,7484840
2022-08-20,14287,1640,740,1547,34744534,12646694,456617,,12190077,7486147
2022-08-21,9907,1533,660,1165,34754441,12647962,457486,,12190476,7487095
2022-08-22,4166,481,271,563,34758607,12648138,457693,,12190445,7487398
2022-08-23,11141,1248,556,1500,34769748,12649077,458381,,12190696,7488645
2022-08-24,14764,1808,871,2189,34784512,12650613,459318,,12191295,7490602
2022-08-25,14028,1716,780,2123,34798540,12652039,460247,,12191792,7492478
2022-08-26,13930,1688,816,2094,34812470,12653429,461112,,12192317,7494322
2022-08-27,12420,1487,878,2001,34824890,12654588,461715,,12192873,7496056
2022-08-28,7926,1259,622,1398,34832816,12655585,462350,,12193235,7497233
2022-08-29,3400,502,286,684,34836216,12655805,462561,,12193244,7497682
2022-08-30,9908,1167,652,1857,34846124,12656613,463070,,12193543,7499235
2022-08-31,13515,1626,946,2315,34859639,12657945,463746,,12194199,7501304
2022-09-01,12908,1720,913,2143,34872547,12659369,464548,,12194821,7503201
2022-09-02,15045,1616,991,4917,34887592,12660708,465165,,12195543,7507890
2022-09-03,14721,1525,924,5517,34902313,12661946,465763,,12196183,7513170
2022-09-04,8668,1009,676,3238,34910981,12662688,466086,,12196602,7516186
2022-09-05,3556,321,229,1387,34914537,12662742,466175,,12196567,7517350
2022-09-06,2469,157,116,1132,34917006,12662642,466213,,12196429,7518272
2022-09-07,10928,1019,587,3494,34927934,12663360,466641,,12196719,7521512
2022-09-08,10873,1022,527,2791,34938807,12664052,467133,,12196919,7524025
2022-09-09,9583,1011,488,2504,34948390,12664774,467651,,12197123,7526292
2022-09-10,10636,1264,552,3168,34959026,12665758,468356,,12197402,7529224
2022-09-11,9412,980,667,3739,34968438,12666487,468663,,12197824,7532752
2022-09-12,3128,295,205,1080,34971566,12666497,468746,,12197751,7533594
2022-09-13,6019,545,284,1132,34977585,12666752,468998,,12197754,7534480
2022-09-14,14482,797,434,1844,34992067,12667229,469357,,12197872,7536057
2022-09-15,15758,781,411,1533,35007825,12667689,469722,,12197967,7537318
2022-09-16,17761,766,448,1693,35025586,12668192,470034,,12198158,7538787
2022-09-17,17622,722,458,1669,35043208,12668607,470294,,12198313,7540199
2022-09-18,11214,773,451,1688,35054422,12669117,470614,,12198503,7541662
2022-09-19,4979,404,288,670,35059401,12669247,470725,,12198522,7542117
2022-09-20,13773,442,332,948,35073174,12669374,470833,,12198541,7542802
2022-09-21,23044,647,410,1500,35096218,12669709,471065,,12198644,7544045
2022-09-22,22918,636,398,1381,35119136,12670035,471297,,12198738,7545163
2022-09-23,22952,727,604,1418,35142088,12670457,471415,,12199042,7546322
2022-09-24,21691,737,689,1499,35163779,12670899,471459,,12199440,7547585
2022-09-25,11320,595,702,1357,35175099,12671211,471346,,12199865,7548704
2022-09-26,4564,192,219,594,35179663,12671111,471313,,12199798,7549053
2022-09-27,37653,497,365,1497,35217316,12671337,471441,,12199896,7550322
2022-09-28,50969,730,670,1902,35268285,12671797,471500,,12200297,7551997
2022-09-29,48010,636,741,1838,35316295,12672108,471387,,12200721,7553555
2022-09-30,47272,677,806,2004,35363567,12672457,471256,,12201201,7555277
2022-10-01,34455,527,633,1549,35398022,12672674,471148,,12201526,7556558
2022-10-02,24246,736,1028,1712,35422268,12673112,470853,,12202259,7558016
2022-10-03,10871,238,231,613,35433139,12673057,470856,,12202201,7558390
2022-10-04,32199,477,460,1170,35465338,12673212,470869,,12202343,7559281
2022-10-05,40440,632,741,1561,35505778,12673519,470753,,12202766,7560574
2022-10-06,38697,611,653,1568,35544475,12673825,470709,,12203116,7561880
2022-10-07,42244,661,852,1742,35586719,12674138,470510,,12203628,7563320
2022-10-08,37397,782,1145,2120,35624116,12674587,470141,,12204446,7565164
2022-10-09,18814,549,727,1556,35642930,12674856,469960,,12204896,7566480
2022-10-10,6865,168,370,565,35649795,12674724,469755,,12204969,7566783
2022-10-11,4994,124,111,318,35654789,12674552,469763,,12204789,7566862
2022-10-12,35118,579,685,1429,35689907,12674795,469655,,12205140,7567999
2022-10-13,36762,643,859,1620,35726669,12675067,469435,,12205632,7569307
2022-10-14,36977,621,753,1541,35763646,12675352,469299,,12206053,7570566
2022-10-15,35454,714,1013,1628,35799100,12675772,468997,,12206775,7571943
2022-10-16,20663,654,1024,1593,35819763,12676153,468621,,12207532,7573303
2022-10-17,7356,206,477,541,35827119,12676069,468348,,12207721,7573600
2022-10-18,36430,454,502,1402,35863549,12676199,468295,,12207904,7574728
2022-10-19,49903,618,730,1983,35913452,12676513,468179,,12208334,7576459
2022-10-20,51295,621,650,2050,35964747,12676818,468147,,12208671,7578242
2022-10-21,52852,695,619,1937,36017599,12677183,468217,,12208966,7579909
2022-10-22,50865,750,904,2311,36068464,12677600,468058,,12209542,7581943
2022-10-23,30641,571,786,2121,36099105,12677853,467836,,12210017,7583799
2022-10-24,14134,232,271,978,36113239,12677779,467792,,12209987,7584516
2022-10-25,41374,473,489,1820,36154613,12677898,467773,,12210125,7586035
2022-10-26,51658,615,660,2124,36206271,12678175,467724,,12210451,7587877
2022-10-27,50119,603,768,2164,36256390,12678447,467551,,12210896,7589766
2022-10-28,49806,591,675,2095,36306196,12678674,467462,,12211212,7591550
2022-10-29,50606,734,779,2222,36356802,12679055,467413,,12211642,7593468
2022-10-30,28404,662,930,2038,36385206,12679427,467141,,12212286,7595258
2022-10-31,12440,200,234,777,36397646,12679342,467103,,12212239,7595797
2022-11-01,33094,338,197,1220,36430740,12679331,467238,,12212093,7596724
2022-11-02,44291,574,625,1903,36475031,12679569,467183,,12212386,7598324
2022-11-03,44195,540,606,1856,36519226,12679775,467112,,12212663,7599891
2022-11-04,44647,648,528,2030,36563873,12680115,467225,,12212890,7601664
2022-11-05,45208,646,753,2368,36609081,12680456,467115,,12213341,7603763
2022-11-06,26020,558,771,2097,36635101,12680669,466899,,12213770,7605559
2022-11-07,10711,242,235,877,36645812,12680616,466903,,12213713,7606192
2022-11-08,33490,486,397,1587,36679302,12680808,466989,,12213819,7607532
2022-11-09,40529,605,571,1964,36719831,12681088,467021,,12214067,7609220
2022-11-10,39178,620,547,1928,36759009,12681383,467088,,12214295,7610869
2022-11-11,43349,636,642,2209,36802358,12681697,467081,,12214616,7612799
2022-11-12,36852,638,592,2185,36839210,12682008,467119,,12214889,7614699
2022-11-13,24269,558,770,2277,36863479,12682265,466901,,12215364,7616718
2022-11-14,10967,232,204,1024,36874446,12682199,466928,,12215271,7617482
2022-11-15,33634,484,380,1695,36908080,12682311,467026,,12215285,7618862
2022-11-16,43541,798,583,2370,36951621,12682802,467235,,12215567,7620974
2022-11-17,38341,674,647,2241,36989962,12683132,467258,,12215874,7622922
2022-11-18,40629,725,530,2333,37030591,12683505,467449,,12216056,7624951
2022-11-19,39659,1005,1031,3060,37070250,12684158,467416,,12216742,7627702
2022-11-20,22424,658,718,2445,37092674,12684531,467352,,12217179,7629912
2022-11-21,8921,196,193,967,37101595,12684459,467350,,12217109,7630669
2022-11-22,26440,481,369,1513,37128035,12684570,467457,,12217113,7631859
2022-11-23,32088,685,668,2069,37160123,12684915,467471,,12217444,7633641
2022-11-24,31913,663,752,2086,37192036,12685257,467380,,12217877,7635459
2022-11-25,30753,763,827,1953,37222789,12685703,467310,,12218393,7637145
2022-11-26,30292,908,1193,2698,37253081,12686263,467016,,12219247,7639546
2022-11-27,18677,608,943,2087,37271758,12686557,466675,,12219882,7641369
2022-11-28,7540,190,282,787,37279298,12686439,466575,,12219864,7641888
2022-11-29,21026,421,454,1292,37300324,12686523,466538,,12219985,7642896
2022-11-30,27892,643,649,1841,37328216,12686839,466530,,12220309,7644453
2022-12-01,24807,593,682,1692,37353023,12687097,466437,,12220660,7645854
2022-12-02,25058,523,630,1776,37378081,12687283,466324,,12220959,7647340
2022-12-03,25559,588,781,1945,37403640,12687538,466121,,12221417,7649012
2022-12-04,15252,494,606,1702,37418892,12687689,466003,,12221686,7650414
2022-12-05,6877,167,157,746,37425769,12687556,466008,,12221548,7650906
2022-12-06,20354,419,352,1379,37446123,12687596,466069,,12221527,7651965
2022-12-07,24784,553,610,1673,37470907,12687821,466004,,12221817,7653359
2022-12-08,23163,563,520,1767,37494070,12688058,466045,,12222013,7654841
2022-12-09,23331,636,575,1633,37517401,12688353,466102,,12222251,7656191
2022-12-10,22580,508,602,1631,37539981,12688532,466005,,12222527,7657536
2022-12-11,14205,548,786,1567,37554186,12688804,465764,,12223040,7658867
2022-12-12,5507,149,156,595,37559693,12688653,465752,,12222901,7659216
2022-12-13,17798,375,371,1125,37577491,12688699,465754,,12222945,7660062
2022-12-14,21325,511,547,1454,37598816,12688905,465712,,12223193,7661263
2022-12-15,21976,530,603,1579,37620792,12689081,465637,,12223444,7662538
2022-12-16,16292,378,451,1031,37637084,12689128,465561,,12223567,7663290
2022-12-17,18701,555,509,1277,37655785,12689351,465605,,12223746,7664275
2022-12-18,12644,530,794,1307,37668429,12689591,465340,,12224251,7665322
2022-12-19,4587,131,116,450,37673016,12689378,465351,,12224027,7665479
2022-12-20,16216,499,450,1110,37689232,12689550,465392,,12224158,7666316
2022-12-21,18476,541,552,1303,37707708,12689778,465377,,12224401,7667346
2022-12-22,18604,574,591,1747,37726312,12690046,465360,,12224686,7668827
2022-12-23,15654,577,602,1716,37741966,12690257,465330,,12224927,7670239
2022-12-24,5339,224,172,674,37747305,12690157,465381,,12224776,7670623
2022-12-25,2445,153,154,480,37749750,12689996,465370,,12224626,7670833
2022-12-26,262,12,7,48,37750012,12689698,465370,,12224328,7670622
2022-12-27,2099,98,37,307,37752111,12689502,465427,,12224075,7670687
2022-12-28,8321,337,168,975,37760432,12689515,465591,,12223924,7671382
2022-12-29,13166,583,529,1601,37773598,12689752,465641,,12224111,7672685
2022-12-30,15825,667,658,1881,37789423,12690100,465647,,12224453,7674282
2022-12-31,11238,459,389,1356,37800661,12690194,465713,,12224481,7675324
2023-01-01,3909,201,219,562,37804570,12690072,465693,,12224379,7675604
2023-01-02,652,36,14,97,37805222,12689812,465714,,12224098,7675447
2023-01-03,8197,297,151,902,37813419,12689810,465854,,12223956,7676097
2023-01-04,14723,574,547,1547,37828142,12690090,465874,,12224216,7677387
2023-01-05,16119,643,535,1796,37844261,12690422,465974,,12224448,7678913
2023-01-06,18837,715,613,2047,37863098,12690830,466073,,12224757,7680695
2023-01-07,18524,701,639,2057,37881622,12691244,466130,,12225114,7682502
2023-01-08,11612,580,608,1632,37893234,12691560,466099,,12225461,7683903
2023-01-09,5299,215,196,664,37898533,12691459,466115,,12225344,7684301
2023-01-10,12163,415,317,786,37910696,12691558,466211,,12225347,7684812
2023-01-11,15546,458,370,1097,37926242,12691684,466293,,12225391,7685630
2023-01-12,14084,444,409,973,37940326,12691810,466327,,12225483,7686333
2023-01-13,14176,419,344,1041,37954502,12691963,466399,,12225564,7687141
2023-01-14,13391,472,451,1079,37967893,12692118,466414,,12225704,7687942
2023-01-15,9046,459,508,1055,37976939,12692283,466364,,12225919,7688749
2023-01-16,3746,146,130,479,37980685,12692143,466380,,12225763,7688976
2023-01-17,8855,267,179,654,37989540,12692063,466464,,12225599,7689337
2023-01-18,10268,349,273,762,37999808,12692107,466537,,12225570,7689827
2023-01-19,10593,315,318,761,38010401,12692116,466529,,12225587,7690331
2023-01-20,9838,318,272,717,38020239,12692136,466573,,12225563,7690786
2023-01-21,11309,354,399,905,38031548,12692179,466527,,12225652,7691430
2023-01-22,7570,343,405,819,38039118,12692249,466462,,12225787,7692010
2023-01-23,3380,143,131,288,38042498,12692144,466473,,12225671,7692079
2023-01-24,8291,226,166,553,38050789,12692046,466530,,12225516,7692350
2023-01-25,10309,346,297,663,38061098,12692114,466575,,12225539,7692780
2023-01-26,6727,236,205,469,38067825,12692045,466602,,12225443,7692994
2023-01-27,6912,237,197,498,38074737,12691963,466639,,12225324,7693220
2023-01-28,9353,313,339,695,38084090,12691976,466607,,12225369,7693658
2023-01-29,5971,234,341,694,38090061,12691924,466495,,12225429,7694097
2023-01-30,1900,88,80,215,38091961,12691715,466501,,12225214,7694053
2023-01-31,5884,156,151,414,38097845,12691550,466502,,12225048,7694183
2023-02-01,7304,248,250,494,38105149,12691535,466497,,12225038,7694455
2023-02-02,6484,296,240,503,38111633,12691548,466550,,12224998,7694729
2023-02-03,6551,197,194,463,38118184,12691472,466549,,12224923,7694952
2023-02-04,6731,233,307,544,38124915,12691431,466469,,12224962,7695262
2023-02-05,4178,199,291,485,38129093,12691342,466372,,12224970,7695510
2023-02-06,1834,90,98,212,38130927,12691126,466361,,12224765,7695452
2023-02-07,4967,160,182,385,38135894,12690971,466336,,12224635,7695575
2023-02-08,5771,212,206,430,38141665,12690894,466337,,12224557,7695755
2023-02-09,6124,211,244,439,38147789,12690821,466303,,12224518,7695953
2023-02-10,5092,159,208,372,38152881,12690743,466250,,12224493,7696120
2023-02-11,6056,186,261,458,38158937,12690635,466171,,12224464,7696312
2023-02-12,4085,220,342,409,38163022,12690597,466045,,12224552,7696493
2023-02-13,1483,57,87,146,38164505,12690396,466013,,12224383,7696422
2023-02-14,3947,131,179,310,38168452,12690235,465963,,12224272,7696471
2023-02-15,4540,119,191,286,38172992,12690074,465888,,12224186,7696519
2023-02-16,4917,175,284,400,38177909,12689961,465775,,12224186,7696671
2023-02-17,4983,179,210,344,38182892,12689881,465740,,12224141,7696795
2023-02-18,5118,232,294,487,38188010,12689839,465676,,12224163,7697049
2023-02-19,3354,132,244,373,38191364,12689696,465559,,12224137,7697193
2023-02-20,1424,63,54,158,38192788,12689496,465565,,12223931,7697129
2023-02-21,914,27,14,107,38193702,12689265,465574,,12223691,7697009
2023-02-22,4136,131,212,370,38197838,12689130,465487,,12223643,7697161
2023-02-23,4282,162,231,392,38202120,12689010,465411,,12223599,7697311
2023-02-24,3034,136,231,274,38205154,12688875,465312,,12223563,7697341
2023-02-25,5024,213,541,386,38210178,12688829,464982,,12223847,7697510
2023-02-26,3472,146,681,384,38213650,12688697,464443,,12224254,7697664
2023-02-27,1075,37,57,97,38214725,12688482,464418,,12224064,7697551
2023-02-28,2730,99,163,232,38217455,12688289,464352,,12223937,7697523
2023-03-01,3850,137,428,336,38221305,12688110,464055,,12224055,7697578
2023-03-02,4595,158,494,330,38225900,12687946,463708,,12224238,7697642
2023-03-03,4369,159,356,334,38230269,12687822,463508,,12224314,7697724
2023-03-04,4970,208,623,350,38235239,12687738,463090,,12224648,7697824
2023-03-05,2537,110,450,251,38237776,12687541,462749,,12224792,7697808
2023-03-06,1157,48,37,114,38238933,12687322,462757,,12224565,7697690
2023-03-07,3221,87,172,225,38242154,12687083,462667,,12224416,7697642
2023-03-08,4319,133,412,284,38246473,12686910,462386,,12224524,7697653
2023-03-09,4623,173,453,312,38251096,12686789,462100,,12224689,7697713
2023-03-10,3942,99,139,255,38255038,12686629,462057,,12224572,7697749
2023-03-11,4064,139,171,286,38259102,12686524,462021,,12224503,7697822
2023-03-12,2893,109,234,301,38261995,12686352,461887,,12224465,7697881
2023-03-13,862,29,32,106,38262857,12686130,461880,,12224250,7697768
2023-03-14,3080,100,109,257,38265937,12685945,461871,,12224074,7697783
2023-03-15,4099,138,163,313,38270036,12685821,461844,,12223977,7697866
2023-03-16,4026,176,234,277,38274062,12685668,461777,,12223891,7697872
2023-03-17,4291,168,202,310,38278353,12685529,461739,,12223790,7697909
2023-03-18,4362,144,194,298,38282715,12685389,461688,,12223701,7697958
2023-03-19,2722,128,233,256,38285437,12685283,461581,,12223702,7698002
2023-03-20,774,31,19,74,38286211,12685038,461591,,12223447,7697839
2023-03-21,2899,69,86,201,38289110,12684837,461569,,12223268,7697810
2023-03-22,3894,130,133,248,38293004,12684670,461563,,12223107,7697793
2023-03-23,3811,118,172,226,38296815,12684490,461503,,12222987,7697765
2023-03-24,3694,102,116,238,38300509,12684328,461487,,12222841,7697782
2023-03-25,4274,108,171,252,38304783,12684169,461417,,12222752,7697803
2023-03-26,2480,112,213,202,38307263,12684012,461310,,12222702,7697777
2023-03-27,915,48,32,68,38308178,12683828,461325,,12222503,7697640
2023-03-28,3106,87,78,203,38311284,12683626,461326,,12222300,7697597
2023-03-29,4172,127,136,224,38315456,12683467,461313,,12222154,7697575
2023-03-30,3838,108,164,211,38319294,12683298,461256,,12222042,7697536
2023-03-31,3987,140,109,222,38323281,12683159,461286,,12221873,7697522
2023-04-01,4195,135,147,225,38327476,12683023,461271,,12221752,7697519
2023-04-02,2181,59,122,172,38329657,12682785,461204,,12221581,7697436
2023-04-03,781,24,12,53,38330438,12682556,461214,,12221342,7697268
2023-04-04,3418,74,74,169,38333856,12682369,461212,,12221157,7697202
2023-04-05,4372,94,109,249,38338228,12682173,461194,,12220979,7697204
2023-04-06,3703,108,109,190,38341931,12682019,461191,,12220828,7697165
2023-04-07,4599,105,115,243,38346530,12681842,461178,,12220664,7697168
2023-04-08,836,23,11,54,38347366,12681613,461185,,12220428,7697006
2023-04-09,2441,81,103,161,38349807,12681468,461160,,12220308,7696975
2023-04-10,360,9,6,20,38350167,12681217,461157,,12220060,7696784
2023-04-11,2771,34,28,121,38352938,12680959,461162,,12219797,7696645
2023-04-12,6347,105,96,188,38359285,12680802,461164,,12219638,7696619
2023-04-13,6997,105,128,207,38366282,12680634,461133,,12219501,7696589
2023-04-14,6514,88,103,206,38372796,12680457,461110,,12219347,7696578
2023-04-15,6949,107,149,230,38379745,12680303,461066,,12219237,7696587
2023-04-16,3275,83,144,165,38383020,12680107,461001,,12219106,7696512
2023-04-17,864,12,13,49,38383884,12679887,460997,,12218890,7696369
2023-04-18,4785,101,77,160,38388669,12679709,461018,,12218691,7696287
2023-04-19,6567,117,98,177,38395236,12679548,461034,,12218514,7696221
2023-04-20,6390,101,153,210,38401626,12679398,460980,,12218418,7696214
2023-04-21,5773,85,75,133,38407399,12679214,460987,,12218227,7696118
2023-04-22,6391,95,91,180,38413790,12679051,460988,,12218063,7696084
2023-04-23,3301,119,147,170,38417091,12678931,460959,,12217972,7696045
2023-04-24,955,4,12,59,38418046,12678691,460949,,12217742,7695905
2023-04-25,4809,69,70,187,38422855,12678505,460948,,12217557,7695866
2023-04-26,6592,108,93,208,38429447,12678376,460962,,12217414,7695866
2023-04-27,6899,118,152,207,38436346,12678230,460923,,12217307,7695846
2023-04-28,6638,86,86,185,38442984,12678061,460921,,12217140,7695801
2023-04-29,6534,123,111,198,38449518,12677938,460929,,12217009,7695786
2023-04-30,2642,94,129,145,38452160,12677805,460893,,12216912,7695730
2023-05-01,1030,20,17,30,38453190,12677568,460891,,12216677,7695536
2023-05-02,4348,68,55,105,38457538,12677372,460899,,12216473,7695416
2023-05-03,5609,108,107,176,38463147,12677231,460894,,12216337,7695382
2023-05-04,8086,87,85,134,38471233,12677057,460893,,12216164,7695301
2023-05-05,13049,90,98,168,38484282,12676908,460882,,12216026,7695262
2023-05-06,15642,114,96,155,38499924,12676804,460898,,12215906,7695219
2023-05-07,6067,56,95,106,38505991,12676636,460855,,12215781,7695130
2023-05-08,2165,16,4,37,38508156,12676427,460864,,12215563,7694972
2023-05-09,12561,55,49,129,38520717,12676246,460867,,12215379,7694903
2023-05-10,14769,70,79,157,38535486,12676078,460856,,12215222,7694852
2023-05-11,13363,77,72,154,38548849,12675941,460860,,12215081,7694816
2023-05-12,13491,85,79,177,38562340,12675806,460864,,12214942,7694795
2023-05-13,11447,80,75,147,38573787,12675625,460865,,12214760,7694713
2023-05-14,4186,67,95,93,38577973,12675479,460834,,12214645,7694633
2023-05-15,1055,9,6,38,38579028,12675282,460831,,12214451,7694496
2023-05-16,8949,57,47,93,38587977,12675104,460835,,12214269,7694385
2023-05-17,11123,99,83,141,38599100,12674958,460848,,12214110,7694298
2023-05-18,10838,81,69,144,38609938,12674797,460859,,12213938,7694229
2023-05-19,10515,96,96,153,38620453,12674660,460855,,12213805,7694171
2023-05-20,9406,91,88,165,38629859,12674512,460857,,12213655,7694117
2023-05-21,3084,48,86,95,38632943,12674370,460817,,12213553,7694043
2023-05-22,970,14,11,30,38633913,12674173,460819,,12213354,7693887
2023-05-23,754,8,3,16,38634667,12673980,460823,,12213157,7693729
2023-05-24,8033,57,80,105,38642700,12673802,460799,,12213003,7693621
2023-05-25,9344,74,93,163,38652044,12673657,460778,,12212879,7693592
2023-05-26,7996,67,70,123,38660040,12673521,460775,,12212746,7693533
2023-05-27,8231,108,76,126,38668271,12673415,460805,,12212610,7693481
2023-05-28,2905,56,72,101,38671176,12673282,460786,,12212496,7693411
2023-05-29,972,13,11,30,38672148,12673085,460785,,12212300,7693250
2023-05-30,6072,61,50,112,38678220,12672925,460795,,12212130,7693164
2023-05-31,8173,91,94,122,38686393,12672789,460789,,12212000,7693094
2023-06-01,7403,70,91,124,38693796,12672643,460766,,12211877,7693026
2023-06-02,6338,50,48,121,38700134,12672477,460767,,12211710,7692949
2023-06-03,5492,70,63,123,38705626,12672321,460773,,12211548,7692873
2023-06-04,2051,47,78,77,38707677,12672177,460739,,12211438,7692777
2023-06-05,600,11,6,18,38708277,12672001,460742,,12211259,7692626
2023-06-06,4465,39,38,79,38712742,12671827,460740,,12211087,7692515
2023-06-07,5816,63,65,121,38718558,12671704,460734,,12210970,7692479
2023-06-08,5756,58,68,112,38724314,12671591,460721,,12210870,7692446
2023-06-09,6191,77,81,122,38730505,12671464,460716,,12210748,7692387
2023-06-10,5348,77,95,115,38735853,12671320,460694,,12210626,7692306
2023-06-11,2010,55,62,105,38737863,12671191,460682,,12210509,7692253
2023-06-12,691,11,7,38,38738554,12671037,460685,,12210352,7692146
2023-06-13,4229,55,58,103,38742783,12670894,460681,,12210213,7692083
2023-06-14,5469,72,83,117,38748252,12670751,460669,,12210082,7692015
2023-06-15,5107,70,75,121,38753359,12670597,460661,,12209936,7691938
2023-06-16,5694,70,64,120,38759053,12670467,460664,,12209803,7691883
2023-06-17,4118,63,62,113,38763171,12670326,460665,,12209661,7691815
2023-06-18,1560,41,61,98,38764731,12670178,460643,,12209535,7691748
2023-06-19,373,6,2,16,38765104,12670001,460645,,12209356,7691604
2023-06-20,3205,52,42,88,38768309,12669841,460652,,12209189,7691506
2023-06-21,3689,42,57,88,38771998,12669703,460633,,12209070,7691432
2023-06-22,3981,75,73,118,38775979,12669592,460633,,12208959,7691387
2023-06-23,4509,56,44,88,38780488,12669480,460643,,12208837,7691326
2023-06-24,3697,49,61,73,38784185,12669313,460628,,12208685,7691215
2023-06-25,1519,31,51,93,38785704,12669175,460606,,12208569,7691159
2023-06-26,510,12,9,23,38786214,12669035,460606,,12208429,7691042
2023-06-27,3111,80,45,91,38789325,12668922,460638,,12208284,7690967
2023-06-28,4074,69,60,91,38793399,12668819,460646,,12208173,7690900
2023-06-29,3972,64,72,83,38797371,12668724,460633,,12208091,7690847
2023-06-30,3833,74,61,128,38801204,12668627,460642,,12207985,7690818
2023-07-01,3218,51,89,117,38804422,12668490,460603,,12207887,7690774
2023-07-02,269,10,4,15,38804691,12668336,460608,,12207728,7690646
2023-07-03,379,6,5,26,38805070,12668198,460608,,12207590,7690547
2023-07-04,1242,18,14,49,38806312,12668049,460612,,12207437,7690446
2023-07-05,2387,56,40,70,38808699,12667949,460626,,12207323,7690388
2023-07-06,2533,38,69,85,38811232,12667803,460593,,12207210,7690315
2023-07-07,2823,53,46,71,38814055,12667717,460598,,12207119,7690266
2023-07-08,2401,64,43,92,38816456,12667614,460619,,12206995,7690208
2023-07-09,915,31,44,37,38817371,12667496,460606,,12206890,7690109
2023-07-10,289,4,2,15,38817660,12667320,460606,,12206714,7689965
2023-07-11,1789,34,20,59,38819449,12667197,460616,,12206581,7689891
2023-07-12,2317,51,52,84,38821766,12667097,460615,,12206482,7689840
2023-07-13,2280,52,68,67,38824046,12667001,460598,,12206403,7689780
2023-07-14,1944,65,48,59,38825990,12666936,460613,,12206323,7689726
2023-07-15,1935,53,56,77,38827925,12666855,460609,,12206246,7689687
2023-07-16,805,36,29,43,38828730,12666746,460616,,12206130,7689603
2023-07-17,193,5,1,11,38828923,12666633,460618,,12206015,7689510
2023-07-18,1303,42,44,56,38830226,12666548,460616,,12205932,7689458
2023-07-19,1776,56,50,56,38832002,12666491,460621,,12205870,7689421
2023-07-20,1588,77,57,60,38833590,12666454,460640,,12205814,7689375
2023-07-21,1728,54,40,50,38835318,12666389,460650,,12205739,7689318
2023-07-22,1505,39,62,75,38836823,12666320,460627,,12205693,7689289
2023-07-23,696,29,29,48,38837519,12666258,460626,,12205632,7689255
2023-07-24,235,12,2,14,38837754,12666184,460635,,12205549,7689192
2023-07-25,1077,48,25,50,38838831,12666106,460658,,12205448,7689126
2023-07-26,1343,51,48,41,38840174,12666062,460660,,12205402,7689081
2023-07-27,1277,69,45,55,38841451,12666048,460683,,12205365,7689060
2023-07-28,1438,46,47,58,38842889,12666001,460681,,12205320,7689035
2023-07-29,1293,50,49,69,38844182,12665980,460680,,12205300,7689044
2023-07-30,628,29,19,27,38844810,12665939,460689,,12205250,7689008
2023-07-31,228,6,4,15,38845038,12665885,460689,,12205196,7688969
2023-08-01,1112,47,33,35,38846150,12665868,460703,,12205165,7688943
2023-08-02,1424,71,55,56,38847574,12665877,460717,,12205160,7688948
2023-08-03,1096,62,37,47,38848670,12665879,460742,,12205137,7688940
2023-08-04,1271,48,47,58,38849941,12665875,460743,,12205132,7688952
2023-08-05,1299,45,49,48,38851240,12665912,460739,,12205173,7688993
2023-08-06,568,25,19,22,38851808,12665935,460745,,12205190,7689013
2023-08-07,240,7,4,9,38852048,12665942,460748,,12205194,7689022
2023-08-08,313,6,3,14,38852361,12665948,460751,,12205197,7689036
2023-08-09,1197,48,40,42,38853558,12665996,460759,,12205237,7689078
2023-08-10,1505,101,49,64,38855063,12666097,460811,,12205286,7689142
