"report_date","previous_day_total_doses_administered","previous_day_at_least_one","previous_day_fully_vaccinated","previous_day_3doses","total_doses_administered","total_individuals_at_least_one","total_individuals_partially_vaccinated","total_doses_in_fully_vaccinated_individuals","total_individuals_fully_vaccinated","total_individuals_3doses"
2021-01-01,6251,6241,2,,32188,32133,32122,22,11,
2021-01-02,4614,4602,6,,36802,36683,36670,26,13,
2021-01-03,5393,5386,3,,42195,42069,42053,32,16,
2021-01-04,5994,5992,0,,48189,48060,48045,30,15,
2021-01-05,9681,9657,19,,57870,57715,57682,66,33,
2021-01-06,12792,12327,450,,70662,70038,69559,958,479,
2021-01-07,16217,15505,697,,86879,85542,84366,2352,1176,
2021-01-08,18036,17021,1002,,104915,102563,100385,4356,2178,
2021-01-09,19499,18422,1064,,124414,120984,117742,6484,3242,
2021-01-10,11369,11330,37,,135783,132305,129027,6556,3278,
2021-01-11,11710,11661,48,,147493,143966,140640,6652,3326,
2021-01-12,14467,14160,298,,161960,158118,154494,7248,3624,
2021-01-13,15434,13812,1593,,177394,171916,166701,10430,5215,
2021-01-14,19181,16730,2436,,196575,188640,180990,15300,7650,
2021-01-15,20046,17990,2037,,216621,206619,196932,19374,9687,
2021-01-16,17115,15932,1170,,233736,222535,211678,21714,10857,
2021-01-17,11255,10012,1236,,244991,232532,220441,24182,12091,
2021-01-18,6790,6708,72,,251781,239217,227057,24320,12160,
2021-01-19,11824,9716,2094,,263605,248912,234658,28508,14254,
2021-01-20,10799,7210,3572,,274404,256099,238274,35650,17825,
2021-01-21,10968,6850,4091,,285372,262933,241017,43832,21916,
2021-01-22,9036,4319,4698,,294408,267215,240603,53224,26612,
2021-01-23,7447,3031,4388,,301855,270216,239217,61998,30999,
2021-01-24,4381,1825,2536,,306236,272023,238488,67070,33535,
2021-01-25,5318,1046,4263,,311554,273037,235240,75594,37797,
2021-01-26,9380,2857,6495,,320934,275862,231571,88582,44291,
2021-01-27,9893,2861,7004,,330827,278694,227400,102588,51294,
2021-01-28,13107,5732,7333,,343934,284393,225766,117254,58627,
2021-01-29,10683,3270,7379,,354617,287632,221627,132010,66005,
2021-01-30,9184,2725,6422,,363801,290315,217891,144848,72424,
2021-01-31,3372,1560,1767,,367173,291841,217651,148380,74190,
2021-02-01,2121,484,1609,,369294,292291,216496,151590,75795,
2021-02-02,4404,1351,2995,,373698,293604,214818,157572,78786,
2021-02-03,6232,1712,4458,,379930,295275,212038,166474,83237,
2021-02-04,9073,1705,7289,,389003,296937,206417,181040,90520,
2021-02-05,8436,1463,6902,,397439,298360,200944,194832,97416,
2021-02-06,10656,1862,8735,,408095,300167,194025,212284,106142,
2021-02-07,7569,1725,5796,,415664,301852,189926,223852,111926,
2021-02-08,8215,3093,5080,,423879,304897,187904,233986,116993,
2021-02-09,14996,3851,11079,,438875,308706,180650,256112,128056,
2021-02-10,15502,4924,10518,,454377,313578,175029,277098,138549,
2021-02-11,16359,3896,12407,,470736,317422,166497,301850,150925,
2021-02-12,17649,2094,15505,,488385,319478,153067,332822,166411,
2021-02-13,16200,2438,13746,,504585,321871,141733,360276,180138,
2021-02-14,12874,917,11925,,517459,322740,130707,384066,192033,
2021-02-15,7859,483,7328,,525318,323175,123840,398670,199335,
2021-02-16,5990,1040,4900,,531308,324172,119960,408424,204212,
2021-02-17,10160,1604,8522,,541468,325732,113026,425412,212706,
2021-02-18,13865,2951,10870,,555333,328635,105089,447092,223546,
2021-02-19,18484,6211,12206,,573817,334794,99073,471442,235721,
2021-02-20,22618,11127,11439,,596435,345858,98736,494244,247122,
2021-02-21,17231,10376,6821,,613666,356174,102273,507802,253901,
2021-02-22,13576,8750,4775,,627242,364854,106228,517252,258626,
2021-02-23,17854,11118,6665,,645096,375916,110661,530510,265255,
2021-02-24,18565,13606,4878,,663661,389466,119375,540182,270091,
2021-02-25,20800,16484,4259,,684461,405884,131582,548604,274302,
2021-02-26,24882,21827,2995,,709343,427651,150391,554520,277260,
2021-02-27,27447,23572,3834,,736790,451159,170113,562092,281046,
2021-02-28,20578,19139,1405,,757368,470244,187835,564818,282409,
2021-03-01,18214,17021,1148,,775582,487203,203693,567020,283510,
2021-03-02,24672,22269,2319,,800254,509411,223628,571566,285783,
2021-03-03,30585,27956,2576,,830839,537316,248990,576652,288326,
2021-03-04,34679,32453,2142,,865518,569703,279285,580836,290418,
2021-03-05,39974,38148,1778,,905492,607803,315641,584324,292162,
2021-03-06,44133,41931,2164,,949625,649679,355394,588570,294285,
2021-03-07,32725,31548,1173,,982350,681153,385753,590800,295400,
2021-03-08,24035,22161,1861,,1006385,703246,406039,594414,297207,
2021-03-09,33277,29830,3419,,1039662,733010,432430,601160,300580,
2021-03-10,38321,34061,4214,,1077983,766997,462251,609492,304746,
2021-03-11,43964,40693,3232,,1121947,807624,499698,615852,307926,
2021-03-12,47691,45979,1688,,1169638,853539,543975,619128,309564,
2021-03-13,57896,55025,2843,,1227534,908493,596140,624706,312353,
2021-03-14,43392,42159,1217,,1270926,950569,637067,627004,313502,
2021-03-15,32796,31100,1681,,1303722,981610,666470,630280,315140,
2021-03-16,53934,51642,2276,,1357656,1033187,715814,634746,317373,
2021-03-17,61049,58514,2492,,1418705,1091635,771820,639630,319815,
2021-03-18,61519,59066,2428,,1480224,1150629,828439,644380,322190,
2021-03-19,64447,61127,3267,,1544671,1211678,886274,650808,325404,
2021-03-20,62551,59967,2553,,1607222,1271589,943680,655818,327909,
2021-03-21,43981,42462,1533,,1651203,1313986,984581,658810,329405,
2021-03-22,30990,30028,974,,1682193,1343926,1013603,660646,330323,
2021-03-23,54599,51824,2724,,1736792,1395655,1062671,665968,332984,
2021-03-24,76409,73229,3132,,1813201,1468794,1132735,672118,336059,
2021-03-25,82894,80317,2530,,1896095,1549032,1210500,677064,338532,
2021-03-26,86984,83455,3490,,1983079,1632406,1290436,683940,341970,
2021-03-27,80834,77886,2864,,2063913,1710189,1365420,689538,344769,
2021-03-28,66980,65394,1553,,2130893,1775493,1429228,692530,346265,
2021-03-29,51725,49040,2651,,2182618,1824453,1475583,697740,348870,
2021-03-30,73559,70154,3347,,2256177,1894530,1542354,704352,352176,
2021-03-31,93137,89493,3577,,2349314,1983925,1628225,711400,355700,
2021-04-01,89295,85426,3832,,2438609,2069253,1709774,718958,359479,
2021-04-02,93063,88841,4206,,2531672,2158008,1794375,727266,363633,
2021-04-03,60981,59310,1729,,2592653,2217227,1851916,730622,365311,
2021-04-04,72320,70670,1646,,2664973,2287786,1920887,733798,366899,
2021-04-05,53725,53256,469,,2718698,2340958,1973638,734640,367320,
2021-04-06,79568,77705,1883,,2798266,2418562,2049412,738300,369150,
2021-04-07,107991,104930,3053,,2906257,2523367,2151222,744290,372145,
2021-04-08,114058,110095,4020,,3020315,2633351,2257242,752218,376109,
2021-04-09,109823,105608,4289,,3130138,2738841,2358508,760666,380333,
2021-04-10,109215,105466,3843,,3239353,2844179,2460069,768220,384110,
2021-04-11,98607,95497,3254,,3337960,2939551,2552246,774610,387305,
2021-04-12,76056,74996,1153,,3414016,3014399,2626009,776780,388390,
2021-04-13,99450,96077,3395,,3513466,3110367,2718630,783474,391737,
2021-04-14,117027,113269,3647,,3630493,3223518,2828174,790688,395344,
2021-04-15,113545,109494,3894,,3744038,3332886,2933705,798362,399181,
2021-04-16,118096,113728,4191,,3862134,3446504,3043176,806656,403328,
2021-04-17,112394,107813,4442,,3974528,3554183,3146472,815422,407711,
2021-04-18,88729,86498,2099,,4063257,3640558,3230802,819512,409756,
2021-04-19,68956,67430,1447,,4132213,3707858,3296706,822304,411152,
2021-04-20,101906,98586,3116,,4234119,3806282,3392079,828406,414203,
2021-04-21,141976,137712,4030,,4376095,3943820,3525655,836330,418165,
2021-04-22,139454,135316,3901,,4515549,4079007,3656997,844020,422010,
2021-04-23,138182,131784,6155,,4653731,4210637,3782530,856214,428107,
2021-04-24,130265,126215,3879,,4783996,4336704,3904774,863860,431930,
2021-04-25,102001,98600,3174,,4885997,4435156,4000119,870074,435037,
2021-04-26,70994,69292,1555,,4956991,4504317,4067785,873064,436532,
2021-04-27,98482,95411,2882,,5055473,4599567,4160216,878702,439351,
2021-04-28,120555,115943,4422,,5176028,4715342,4271641,887402,443701,
2021-04-29,124463,119273,5044,,5300491,4834448,4385772,897352,448676,
2021-04-30,115791,110552,5005,,5416282,4944827,4491223,907208,453604,
2021-05-01,111267,107416,3636,,5527549,5052062,4594899,914326,457163,
2021-05-02,79124,76153,2859,,5606673,5128058,4668102,919912,459956,
2021-05-03,56779,55114,1593,,5663452,5183017,4721528,922978,461489,
2021-05-04,91912,88545,3281,,5755364,5271384,4806691,929386,464693,
2021-05-05,137971,133275,4612,,5893335,5404490,4935248,938484,469242,
2021-05-06,141821,136871,4812,,6035156,5541177,5067185,947984,473992,
2021-05-07,150248,145225,4826,,6185404,5686242,5207483,957518,478759,
2021-05-08,142432,137755,4429,,6327836,5823802,5340693,966218,483109,
2021-05-09,124786,121142,3477,,6452622,5944780,5458258,973044,486522,
2021-05-10,97788,95814,1874,,6550410,6040405,5552076,976658,488329,
2021-05-11,113498,108836,4483,,6663908,6149039,5656298,985482,492741,
2021-05-12,145010,137996,6868,,6808918,6286856,5787313,999086,499543,
2021-05-13,142641,135295,7200,,6951559,6421976,5915307,1013338,506669,
2021-05-14,148859,138757,9934,,7100418,6560545,6044007,1033076,516538,
2021-05-15,159698,149667,9855,,7260116,6710025,6183707,1052636,526318,
2021-05-16,144342,136075,8063,,7404458,6845932,6311631,1068602,534301,
2021-05-17,114958,110863,3942,,7519416,6956606,6418439,1076334,538167,
2021-05-18,111293,100438,10655,,7630709,7056848,6508088,1097520,548760,
2021-05-19,149848,133449,16223,,7780557,7190145,6625236,1129818,564909,
2021-05-20,151526,131548,19768,,7932083,7321504,6736896,1169216,584608,
2021-05-21,165348,140854,24239,,8097431,7462177,6853407,1217540,608770,
2021-05-22,199392,172214,26953,,8296823,7634194,6998552,1271284,635642,
2021-05-23,139805,127439,12222,,8436628,7761455,7113653,1295604,647802,
2021-05-24,100280,93310,6825,,8536908,7854592,7200035,1309114,654557,
2021-05-25,90427,82948,7271,,8627335,7937377,7275616,1323522,661761,
2021-05-26,139745,112983,26498,,8767080,8050173,7361984,1376378,688189,
2021-05-27,152037,123021,28764,,8919117,8173037,7456153,1433768,716884,
2021-05-28,163831,132284,31243,,9082948,8305148,7557080,1496136,748068,
2021-05-29,153353,117100,36021,,9236301,8422099,7638066,1568066,784033,
2021-05-30,149695,118999,30472,,9385996,8540928,7726485,1628886,814443,
2021-05-31,99192,79799,19202,,9485188,8620557,7786976,1667162,833581,
2021-06-01,124156,90586,33237,,9609344,8710948,7844205,1733486,866743,
2021-06-02,145274,102122,42904,,9754618,8812889,7903311,1819156,909578,
2021-06-03,155329,99889,55164,,9909947,8912594,7947923,1929342,964671,
2021-06-04,181680,115513,65899,,10091627,9027908,7997426,2060964,1030482,
2021-06-05,171979,103404,68300,,10263606,9131114,8032417,2197394,1098697,
2021-06-06,163359,91839,71239,,10426965,9222775,8052909,2339732,1169866,
2021-06-07,119546,63039,56290,,10546511,9285617,8059536,2452162,1226081,
2021-06-08,161867,72429,89001,,10708378,9357857,8042855,2630004,1315002,
2021-06-09,181433,70787,110183,,10889811,9428467,8003363,2850208,1425104,
2021-06-10,185548,66404,118658,,11075359,9494668,7950997,3087342,1543671,
2021-06-11,204749,67493,136504,,11280108,9561975,7881882,3360186,1680093,
2021-06-12,199688,62649,136441,,11479796,9624442,7808000,3632884,1816442,
2021-06-13,190301,58862,130913,,11670097,9683129,7735854,3894550,1947275,
2021-06-14,137671,38684,98593,,11807768,9721617,7675854,4091526,2045763,
2021-06-15,189180,42583,146246,,11996948,9763982,7572070,4383824,2191912,
2021-06-16,206100,42416,163045,,12203048,9806202,7451348,4709708,2354854,
2021-06-17,210377,37918,171882,,12413425,9843905,7317261,5053288,2526644,
2021-06-18,217118,35339,181179,,12630543,9879054,7171323,5415462,2707731,
2021-06-19,215835,35477,179691,,12846378,9914325,7027015,5774620,2887310,
2021-06-20,186233,35544,150114,,13032611,9949671,6912355,6074632,3037316,
2021-06-21,120414,20818,99099,,13153025,9970294,6833971,6272646,3136323,
2021-06-22,204895,27488,176657,,13357920,9997588,6684717,6625742,3312871,
2021-06-23,230488,28610,201143,,13588408,10025998,6512092,7027812,3513906,
2021-06-24,227654,26661,200246,,13816062,10052463,6338421,7428084,3714042,
2021-06-25,251073,27963,222367,,14067135,10080225,6143934,7872582,3936291,
2021-06-26,261253,29987,230565,,14328388,10109987,5943271,8333432,4166716,
2021-06-27,204971,27774,176595,,14533359,10137579,5794378,8686402,4343201,
2021-06-28,199230,20948,177724,,14732589,10158329,5637529,9041600,4520800,
2021-06-29,250085,24480,224878,,14982674,10182568,5437044,9491048,4745524,
2021-06-30,275507,24164,250777,,15258181,10206529,5210357,9992344,4996172,
2021-07-01,271948,25296,246100,,15530129,10231607,4989474,10484266,5242133,
2021-07-02,144701,11578,132899,,15674830,10243011,4868081,10749860,5374930,
2021-07-03,216871,19917,196722,,15891701,10262706,4691203,11143006,5571503,
2021-07-04,196137,19395,176520,,16087838,10281915,4534011,11495808,5747904,
2021-07-05,148709,12437,136131,,16236547,10294163,4410255,11767816,5883908,
2021-07-06,220003,19982,199808,,16456550,10313929,4230359,12167140,6083570,
2021-07-07,246589,22961,223389,,16703139,10336664,4029853,12613622,6306811,
2021-07-08,231176,21341,209626,,16934315,10357799,3841497,13032604,6516302,
2021-07-09,226963,21497,205300,,17161278,10379094,3657624,13442940,6721470,
2021-07-10,209040,20531,188356,,17370318,10399421,3489732,13819378,6909689,
2021-07-11,171647,17566,153957,,17541965,10416786,3353287,14126998,7063499,
2021-07-12,123115,11441,111578,,17665080,10428038,3253098,14349880,7174940,
2021-07-13,178461,19013,159306,,17843541,10446829,3112738,14668182,7334091,
2021-07-14,180008,19291,160561,,18023549,10465905,2971416,14988978,7494489,
2021-07-15,167172,19577,147423,,18190721,10485271,2843523,15283496,7641748,
2021-07-16,169315,19884,149279,,18360036,10504953,2714079,15581748,7790874,
2021-07-17,172967,20249,152593,,18533003,10524953,2581678,15886550,7943275,
2021-07-18,133605,15917,117549,,18666608,10540686,2480010,16121352,8060676,
2021-07-19,91957,10409,81442,,18758565,10550882,2408939,16283886,8141943,
2021-07-20,133512,16936,116518,,18892077,10567578,2309293,16516570,8258285,
2021-07-21,140064,16975,123019,,19032141,10584338,2203196,16762284,8381142,
2021-07-22,125568,17623,107811,,19157709,10601737,2112961,16977552,8488776,
2021-07-23,120233,16979,103048,,19277942,10618475,2026850,17183250,8591625,
2021-07-24,126663,18321,108106,,19404605,10636593,1937025,17399136,8699568,
2021-07-25,103609,14846,88635,,19508214,10651215,1863193,17576044,8788022,
2021-07-26,66673,9880,56701,,19574887,10660877,1816335,17689084,8844542,
2021-07-27,92354,15311,76882,,19667241,10675927,1754720,17842414,8921207,
2021-07-28,93904,16443,77386,,19761145,10692135,1693733,17996804,8998402,
2021-07-29,89366,16692,72512,,19850511,10708595,1637869,18141452,9070726,
2021-07-30,84025,16087,67825,,19934536,10724454,1586091,18276726,9138363,
2021-07-31,83813,15693,67967,,20018349,10739929,1533789,18412280,9206140,
2021-08-01,61847,11306,50360,,20080196,10751009,1494700,18512618,9256309,
2021-08-02,42460,7397,34945,,20122656,10758208,1467120,18582176,9291088,
2021-08-03,33264,5945,27151,,20155920,10763920,1445891,18636058,9318029,
2021-08-04,61288,12360,48736,,20217208,10776045,1409478,18733134,9366567,
2021-08-05,59418,12521,46743,,20276626,10788358,1375212,18826292,9413146,
2021-08-06,55989,11841,43932,,20332615,10799939,1343090,18913698,9456849,
2021-08-07,62341,12118,50027,,20394956,10811796,1305138,19013316,9506658,
2021-08-08,48643,9246,39210,,20443599,10820814,1275151,19091326,9545663,
2021-08-09,30837,5928,24735,,20474436,10826528,1256317,19140422,9570211,
2021-08-10,49219,10493,38429,,20523655,10836741,1228347,19216788,9608394,
2021-08-11,48696,10756,37699,,20572351,10847250,1201373,19291754,9645877,
2021-08-12,49209,11178,37806,,20621560,10858177,1174703,19366948,9683474,
2021-08-13,49589,11716,37602,,20671149,10869652,1148787,19441730,9720865,
2021-08-14,51184,12121,38857,,20722333,10881523,1122025,19518996,9759498,
2021-08-15,41731,9836,31675,,20764064,10891157,1100156,19582002,9791001,
2021-08-16,26715,6170,20390,,20790779,10897104,1085910,19622388,9811194,
2021-08-17,40472,11041,29169,,20831251,10907895,1067758,19680274,9840137,
2021-08-18,41871,11956,29675,,20873122,10919609,1050007,19739204,9869602,
2021-08-19,45856,16511,29084,,20918978,10935869,1037406,19796926,9898463,
2021-08-20,46404,16269,29721,,20965382,10951882,1023927,19855910,9927955,
2021-08-21,47926,15136,32421,,21013308,10966758,1006609,19920298,9960149,
2021-08-22,34366,10797,23302,,21047674,10977309,994080,19966458,9983229,
2021-08-23,23209,7000,15992,,21070883,10984074,985067,19998014,9999007,
2021-08-24,37627,13359,23812,,21108510,10997179,974591,20045176,10022588,
2021-08-25,41301,14399,26297,,21149811,11011322,962674,20097296,10048648,
2021-08-26,39242,13548,24952,,21189053,11024594,951235,20146718,10073359,
2021-08-27,37630,12915,23672,,21226683,11037268,940451,20193634,10096817,
2021-08-28,40081,13405,25501,,21266764,11050395,928331,20244128,10122064,
2021-08-29,30522,10235,19933,,21297286,11060398,918614,20283568,10141784,
2021-08-30,18223,6135,11839,,21315509,11066285,912881,20306808,10153404,
2021-08-31,32687,11929,19609,,21348196,11077946,905173,20345546,10172773,
2021-09-01,36208,12931,21935,,21384404,11090644,896153,20388982,10194491,
2021-09-02,37736,15630,19648,,21422140,11106022,892110,20427824,10213912,
2021-09-03,46833,21064,22421,,21468973,11126838,890734,20472208,10236104,
2021-09-04,46851,20580,24759,,21515824,11147172,886532,20521280,10260640,
2021-09-05,33047,14198,18563,,21548871,11161126,882147,20557958,10278979,
2021-09-06,21689,9477,12025,,21570560,11170354,879582,20581544,10290772,
2021-09-07,14973,6713,8079,,21585533,11176810,878199,20597222,10298611,
2021-09-08,41116,17100,20923,,21626649,11193646,874358,20638576,10319288,
2021-09-09,41420,16961,19663,,21668069,11210330,871631,20677398,10338699,
2021-09-10,39607,15495,18979,,21707676,11225563,868129,20714868,10357434,
2021-09-11,42345,15925,23320,,21750021,11241209,860713,20760992,10380496,
2021-09-12,29942,11525,17857,,21779963,11252440,854351,20796178,10398089,
2021-09-13,16063,6396,9171,,21796026,11258602,851561,20814082,10407041,
2021-09-14,29878,11549,15277,,21825904,11269850,847806,20844088,10422044,
2021-09-15,39253,14013,19410,,21865157,11283604,842394,20882420,10441210,
2021-09-16,39322,13974,19234,,21904479,11297343,837111,20920464,10460232,
2021-09-17,38891,13594,19319,,21943370,11310694,831374,20958640,10479320,
2021-09-18,41194,14074,23500,,21984564,11324495,821927,21005136,10502568,
2021-09-19,30632,10821,18968,,22015196,11335057,813767,21042580,10521290,
2021-09-20,16722,6100,10170,,22031918,11340903,809674,21062458,10531229,
2021-09-21,31332,11203,16977,,22063250,11351841,803884,21095914,10547957,
2021-09-22,41788,14811,22912,,22105038,11366356,795762,21141188,10570594,
2021-09-23,47198,16127,26015,,22152236,11382220,785855,21192730,10596365,
2021-09-24,46272,15626,26628,,22198508,11397585,774834,21245502,10622751,
2021-09-25,48168,15245,29932,,22246676,11412577,760128,21304898,10652449,
2021-09-26,37475,12414,24470,,22284151,11424716,748051,21353330,10676665,
2021-09-27,19144,6527,12312,,22303295,11430989,742250,21377478,10688739,
2021-09-28,30929,11284,17864,,22334224,11442014,735658,21412712,10706356,
2021-09-29,37854,12465,21708,,22372078,11454208,726395,21455626,10727813,
2021-09-30,37312,11644,21360,,22409390,11465593,716660,21497866,10748933,
2021-10-01,30850,9803,18396,,22440240,11475170,708054,21534232,10767116,
2021-10-02,37111,11150,23570,,22477351,11486050,695616,21580868,10790434,
2021-10-03,27195,8160,18319,,22504546,11493969,685444,21617050,10808525,
2021-10-04,14863,4744,9801,,22519409,11498467,680369,21636196,10818098,
2021-10-05,26789,8584,15850,,22546198,11506790,673088,21667404,10833702,
2021-10-06,31639,9632,18493,,22577837,11516163,664219,21703888,10851944,
2021-10-07,30329,9387,17111,,22608166,11525299,656482,21737634,10868817,
2021-10-08,32811,10735,18837,,22640977,11535764,648367,21774794,10887397,
2021-10-09,34113,10653,21000,,22675090,11546154,638006,21816296,10908148,
2021-10-10,23392,7654,15074,,22698482,11553557,630574,21845966,10922983,
2021-10-11,11997,3837,7862,,22710479,11557144,626533,21861222,10930611,
2021-10-12,5093,1621,3258,,22715572,11558487,624881,21867212,10933606,
2021-10-13,29086,9187,18071,,22744658,11567384,615981,21902806,10951403,
2021-10-14,28996,8900,17738,,22773654,11576009,607133,21937752,10968876,
2021-10-15,29067,8819,18153,,22802721,11584565,597786,21973558,10986779,
2021-10-16,31126,8982,19864,,22833847,11593256,586892,22012728,11006364,
2021-10-17,23687,7255,15362,,22857534,11600257,578772,22042970,11021485,
2021-10-18,12300,3747,8144,,22869834,11603723,574363,22058720,11029360,
2021-10-19,21245,6618,12617,,22891079,11610059,568351,22083416,11041708,
2021-10-20,25629,7534,14899,,22916708,11617346,560973,22112746,11056373,
2021-10-21,23152,6674,13019,,22939860,11623751,554617,22138268,11069134,
2021-10-22,26089,7303,15093,,22965949,11630732,546811,22167842,11083921,
2021-10-23,28157,7599,17145,,22994106,11638069,537258,22201622,11100811,
2021-10-24,19336,5730,12586,,23013442,11643543,530390,22226306,11113153,
2021-10-25,9921,2710,6472,,23023363,11645984,526620,22238728,11119364,
2021-10-26,18885,5384,11089,,23042248,11651090,520906,22260368,11130184,
2021-10-27,22827,6070,13196,,23065075,11656905,513766,22286278,11143139,
2021-10-28,22284,5791,12631,,23087359,11662408,506915,22310986,11155493,
2021-10-29,22792,5727,13038,,23110151,11667834,499590,22336488,11168244,
2021-10-30,24081,6032,14597,,23134232,11673594,491013,22365162,11182581,
2021-10-31,16459,4590,10586,,23150691,11677890,485012,22385756,11192878,
2021-11-01,7863,2078,5053,,23158554,11679688,482024,22395328,11197664,
2021-11-02,15610,4362,7734,,23174164,11683759,478641,22410236,11205118,
2021-11-03,18604,5065,9596,,23192768,11688521,474100,22428842,11214421,
2021-11-04,19481,4867,10017,,23212249,11693112,468935,22448354,11224177,
2021-11-05,21439,4396,9510,,23233688,11697219,463807,22466824,11233412,
2021-11-06,25314,5199,12148,,23259002,11702149,456841,22490616,11245308,
2021-11-07,21431,4020,8910,,23280433,11705889,451939,22507900,11253950,
2021-11-08,11987,2109,4729,,23292420,11707703,449303,22516800,11258400,
2021-11-09,24101,3846,7634,,23316521,11711228,445505,22531446,11265723,
2021-11-10,28449,4503,8977,,23344970,11715453,441017,22548872,11274436,
2021-11-11,28734,4298,9083,,23373704,11719455,436223,22566464,11283232,
2021-11-12,26720,4161,8218,,23400424,11723325,432152,22582346,11291173,
2021-11-13,34278,5072,11393,,23434702,11728091,425822,22604538,11302269,
2021-11-14,23207,3898,8595,,23457909,11731726,421118,22621216,11310608,
2021-11-15,12695,2185,4490,,23470604,11733651,418805,22629692,11314846,
2021-11-16,26152,3924,7467,,23496756,11737318,415258,22644120,11322060,
2021-11-17,31138,4046,7793,,23527894,11741082,411501,22659162,11329581,
2021-11-18,32470,3855,7507,,23560364,11744631,407835,22673592,11336796,
2021-11-19,35442,3857,7737,,23595806,11748188,403943,22688490,11344245,
2021-11-20,40095,4380,8807,,23635901,11752289,399507,22705564,11352782,
2021-11-21,28099,3431,6940,,23664000,11755458,395984,22718948,11359474,
2021-11-22,14888,1949,3889,,23678888,11757131,394038,22726186,11363093,
2021-11-23,33041,3271,6002,,23711929,11760122,391299,22737646,11368823,
2021-11-24,42621,3750,6787,,23754550,11763568,388251,22750634,11375317,
2021-11-25,46013,3929,6553,,23800563,11767222,385624,22763196,11381598,
2021-11-26,52815,11342,6605,,23853378,11778294,390354,22775880,11387940,
2021-11-27,63491,22349,7023,,23916869,11800362,405670,22789384,11394692,
2021-11-28,51444,27737,5307,,23968313,11827807,428088,22799438,11399719,
2021-11-29,33515,18932,2874,,24001828,11846478,444135,22804686,11402343,
2021-11-30,55993,20670,5116,,24057821,11866867,459679,22814376,11407188,
2021-12-01,69514,26235,5621,,24127335,11892796,480279,22825034,11412517,
2021-12-02,71602,26484,5024,,24198937,11918982,501726,22834512,11417256,
2021-12-03,73388,25096,5153,,24272325,11943782,521663,22844238,11422119,
2021-12-04,81128,27783,6056,47270,24353453,11971272,543381,,11427891,807361
2021-12-05,62612,31926,4400,26266,24416065,12002903,570899,,11432004,833523
2021-12-06,38617,19141,2708,16753,24454682,12021755,587325,,11434430,850198
2021-12-07,60253,14846,4453,40941,24514935,12036330,597708,,11438622,891065
2021-12-08,73426,19053,4673,49698,24588361,12055106,612078,,11443028,940685
2021-12-09,74473,18271,4331,51852,24662834,12073068,626010,,11447058,992452
2021-12-10,77452,17586,4640,55218,24740286,12090373,638951,,11451422,1047589
2021-12-11,83150,20402,5814,56922,24823436,12110486,653525,,11456961,1104425
2021-12-12,60738,22695,4149,33852,24884174,12132901,672065,,11460836,1138188
2021-12-13,34915,11595,2404,20893,24919089,12144199,681246,,11462953,1158986
2021-12-14,101943,8996,3852,89052,25021032,12152885,686375,,11466510,1247918
2021-12-15,127664,12428,4499,110702,25148696,12165009,694294,,11470715,1358520
2021-12-16,139309,12450,4236,122611,25288005,12177173,702498,,11474675,1481032
2021-12-17,159134,12397,4503,142212,25447139,12189295,710383,,11478912,1623147
2021-12-18,175555,13521,4915,157076,25622694,12202522,718977,,11483545,1780128
2021-12-19,140409,18154,3928,118294,25763103,12220375,733195,,11487180,1898311
2021-12-20,106809,10305,2742,93717,25869912,12230412,740748,,11489664,1991930
2021-12-21,215200,12961,4306,197911,26085112,12243057,749396,,11493661,2189720
2021-12-22,237188,14419,5191,217693,26322300,12257178,758610,,11498568,2407296
2021-12-23,257394,11712,5075,240514,26579694,12268586,765241,,11503345,2647704
2021-12-24,223370,9443,4554,209311,26803064,12277732,770126,,11507606,2856899
2021-12-25,89688,3884,2500,83316,26892752,12281341,771505,,11509836,2940108
2021-12-26,11892,387,355,11140,26904644,12281436,771529,,11509907,2951118
2021-12-27,46925,1493,1111,44291,26951569,12282684,771904,,11510780,2995289
2021-12-28,144746,6099,3996,134592,27096315,12288489,773996,,11514493,3129750
2021-12-29,175446,9373,4571,161431,27271761,12297567,778794,,11518773,3291054
2021-12-30,200023,10126,5339,184516,27471784,12307390,783566,,11523824,3475436
2021-12-31,195176,10007,5793,179125,27666960,12317108,787771,,11529337,3654435
2022-01-01,96933,5378,3874,87356,27763893,12322177,789267,,11532910,3741642
2022-01-02,19434,938,923,17444,27783327,12322824,789273,,11533551,3758940
2022-01-03,88242,4773,4590,78798,27871569,12327287,789448,,11537839,3837585
2022-01-04,146341,5996,5311,134994,28017910,12332955,790120,,11542835,3972423
2022-01-05,177450,7614,7292,162372,28195360,12340215,790431,,11549784,4134635
2022-01-06,191491,7198,6781,176987,28386851,12347094,790837,,11556257,4311467
2022-01-07,191208,7949,6985,175464,28578059,12354699,791789,,11562910,4486758
2022-01-08,181622,8615,6630,165191,28759681,12362982,793761,,11569221,4651793
2022-01-09,131079,9861,7175,113952,28890760,12372521,796442,,11576079,4765585
2022-01-10,90548,5106,4489,80826,28981308,12377305,797049,,11580256,4846258
2022-01-11,138839,6148,6560,125425,29120147,12383106,796624,,11586482,4971493
2022-01-12,156988,8155,8045,138667,29277135,12390932,796729,,11594203,5109992
2022-01-13,162641,9206,9206,141521,29439776,12399776,796715,,11603061,5251330
2022-01-14,159823,10743,10370,136020,29599599,12410158,797083,,11613075,5387152
2022-01-15,161176,11008,11667,135867,29760775,12420796,796413,,11624383,5522826
2022-01-16,109757,9285,9669,89448,29870532,12429720,796022,,11633698,5612057
2022-01-17,65769,5933,6561,52634,29936301,12435318,795384,,11639934,5664506
2022-01-18,36088,2003,2124,31139,29972389,12436966,795252,,11641714,5695449
2022-01-19,101294,5580,6712,85942,30073683,12442146,794102,,11648044,5781164
2022-01-20,103575,6321,6998,85719,30177258,12448083,793417,,11654666,5866660
2022-01-21,102075,6228,8051,82483,30279333,12453907,791580,,11662327,5948915
2022-01-22,102553,8710,12065,78101,30381886,12462228,788218,,11674010,6026788
2022-01-23,76671,7305,13984,54782,30458557,12469190,781532,,11687658,6081348
2022-01-24,42252,3193,7934,30736,30500809,12472019,776773,,11695246,6111877
2022-01-25,62554,3756,8365,48114,30563363,12475397,772149,,11703248,6159773
2022-01-26,77866,4911,13165,55683,30641229,12479931,763890,,11716041,6215214
2022-01-27,78054,4893,13244,56032,30719283,12484452,755529,,11728923,6271009
2022-01-28,77263,4671,13670,53882,30796546,12488765,746517,,11742248,6324672
2022-01-29,84797,5527,17705,58103,30881343,12493929,734332,,11759597,6382531
2022-01-30,66489,5025,20621,40149,30947832,12498612,718722,,11779890,6422455
2022-01-31,34737,2175,9878,22345,30982569,12500468,711010,,11789458,6444611
2022-02-01,51340,3267,9658,36520,31033909,12503382,704609,,11798773,6480906
2022-02-02,57694,3844,12389,38675,31091603,12506896,696049,,11810847,6519382
2022-02-03,52571,3610,11506,34297,31144174,12510129,688141,,11821988,6553428
2022-02-04,43072,2945,10555,27276,31187246,12512764,680521,,11832243,6580510
2022-02-05,58703,3737,14469,37558,31245949,12516169,669777,,11846392,6617855
2022-02-06,49852,3638,16113,29571,31295801,12519484,657297,,11862187,6647202
2022-02-07,23225,1690,7807,13436,31319026,12520848,651167,,11869681,6660414
2022-02-08,33372,2353,7238,21965,31352398,12522871,646275,,11876596,6682146
2022-02-09,38865,2781,8911,24406,31391263,12525294,640139,,11885155,6706300
2022-02-10,37526,2763,8832,22548,31428789,12527721,634066,,11893655,6728618
2022-02-11,39430,2719,10287,22999,31468219,12530094,626489,,11903605,6751379
2022-02-12,42032,2954,11452,25309,31510251,12532714,617980,,11914734,6776464
2022-02-13,36306,2801,13138,19939,31546557,12535228,607640,,11927588,6796205
2022-02-14,16966,1175,6117,9466,31563523,12536128,602690,,11933438,6805471
2022-02-15,19337,1384,4743,11871,31582860,12537189,599321,,11937868,6817115
2022-02-16,26009,1764,7725,14945,31608869,12538656,593356,,11945300,6831859
2022-02-17,26749,1681,7518,14981,31635618,12539982,587510,,11952472,6846585
2022-02-18,23929,1353,6604,13671,31659547,12541018,582247,,11958771,6860047
2022-02-19,37829,1902,8334,26050,31697376,12542589,575810,,11966779,6885856
2022-02-20,32562,1493,7959,22802,31729938,12543782,569336,,11974446,6908454
2022-02-21,17499,913,3677,12755,31747437,12544400,566563,,11977837,6920998
2022-02-22,9097,428,1547,6953,31756534,12544539,565439,,11979100,6927741
2022-02-23,25323,1327,4788,17289,31781857,12545556,561971,,11983585,6944794
2022-02-24,24559,1396,5233,15475,31806416,12546631,558130,,11988501,6960026
2022-02-25,23089,1387,5134,14503,31829505,12547724,554376,,11993348,6974303
2022-02-26,25219,1383,5908,16550,31854724,12548797,549844,,11998953,6990627
2022-02-27,26947,1369,7366,17698,31881671,12549897,543836,,12006061,7008130
2022-02-28,10125,593,2528,6744,31891796,12550237,541893,,12008344,7014691
2022-03-01,13181,943,3145,8161,31904977,12550875,539681,,12011194,7022635
2022-03-02,15407,1163,3575,9614,31920384,12551777,537262,,12014515,7032072
2022-03-03,14292,1077,3224,8686,31934676,12552543,535108,,12017435,7040527
2022-03-04,14464,989,3441,8313,31949140,12553211,532652,,12020559,7048587
2022-03-05,18525,1276,4996,11180,31967665,12554178,528921,,12025257,7059543
2022-03-06,16507,1087,5522,9602,31984172,12554986,524480,,12030506,7068938
2022-03-07,5943,464,1858,3509,31990115,12555165,523079,,12032086,7072230
2022-03-08,7353,697,1936,4158,31997468,12555584,521833,,12033751,7076189
2022-03-09,11150,906,2735,6402,32008618,12556214,519998,,12036216,7082389
2022-03-10,12751,1044,3251,6833,32021369,12556981,517784,,12039197,7089009
2022-03-11,12882,903,3406,6862,32034251,12557595,515273,,12042322,7095655
2022-03-12,14677,1045,4178,8310,32048928,12558368,512137,,12046231,7103761
2022-03-13,14740,1089,4997,8329,32063668,12559166,508225,,12050941,7111853
2022-03-14,6329,448,2228,3497,32069997,12559344,506442,,12052902,7115136
2022-03-15,10195,791,2624,5972,32080192,12559845,504597,,12055248,7120894
2022-03-16,13049,932,3660,6950,32093241,12560489,501866,,12058623,7127614
2022-03-17,13177,1046,3957,6755,32106418,12561248,498948,,12062300,7134150
2022-03-18,11900,911,3144,6431,32118318,12561857,496705,,12065152,7140358
2022-03-19,14434,1002,4161,7899,32132752,12562580,493544,,12069036,7148039
2022-03-20,11737,989,3955,6367,32144489,12563298,490573,,12072725,7154198
2022-03-21,5056,414,1589,2813,32149545,12563453,489394,,12074059,7156808
2022-03-22,6700,551,1556,3886,32156245,12563718,488384,,12075334,7160479
2022-03-23,9962,784,2296,5191,32166207,12564187,486869,,12077318,7165429
2022-03-24,9284,723,2375,4606,32175491,12564646,485208,,12079438,7169831
2022-03-25,9215,781,2151,4746,32184706,12565164,483830,,12081334,7174365
2022-03-26,10919,933,2831,5503,32195625,12565820,481930,,12083890,7179649
2022-03-27,10221,909,3537,5299,32205846,12566470,479298,,12087172,7184737
2022-03-28,3577,319,1107,1986,32209423,12566550,478507,,12088043,7186530
2022-03-29,5334,498,1208,2687,32214757,12566764,477791,,12088973,7188996
2022-03-30,7847,747,1833,4120,32222604,12567233,476700,,12090533,7192892
2022-03-31,8646,689,1924,4412,32231250,12567633,475459,,12092174,7197082
2022-04-01,9298,801,1911,4884,32240548,12568142,474340,,12093802,7201727
2022-04-02,10426,886,2208,5566,32250974,12568741,473006,,12095735,7207076
2022-04-03,9196,878,2567,5063,32260170,12569365,471311,,12098054,7211940
2022-04-04,4196,387,1005,2406,32264366,12569491,470690,,12098801,7214143
2022-04-05,6060,598,1033,3049,32270426,12569749,470249,,12099500,7216918
2022-04-06,8367,715,1478,4373,32278793,12570173,469481,,12100692,7221064
2022-04-07,10332,732,1685,4835,32289125,12570606,468523,,12102083,7225657
2022-04-08,23983,811,1578,4834,32313108,12571139,467750,,12103389,7230275
2022-04-09,30475,969,1972,5893,32343583,12571810,466738,,12105072,7235945
2022-04-10,24849,976,2387,5331,32368432,12572529,465321,,12107208,7241076
2022-04-11,12568,385,874,2432,32381000,12572665,464828,,12107837,7243307
2022-04-12,28108,691,1017,3535,32409108,12573054,464495,,12108559,7246610
2022-04-13,37769,851,1556,4926,32446877,12573606,463786,,12109820,7251306
2022-04-14,37883,761,1610,4910,32484760,12574056,462934,,12111122,7255964
2022-04-15,43393,1230,2101,6726,32528153,12574988,462059,,12112929,7262453
2022-04-16,8087,358,650,1736,32536240,12575086,461765,,12113321,7263973
2022-04-17,21004,870,1923,4314,32557244,12575672,460705,,12114967,7268064
2022-04-18,5457,305,462,1288,32562701,12575691,460543,,12115148,7269112
2022-04-19,22645,615,770,3100,32585346,12576025,460379,,12115646,7271993
2022-04-20,40322,1063,1393,4617,32625668,12576762,460046,,12116716,7276346
2022-04-21,38745,941,1601,4678,32664413,12577408,459378,,12118030,7280790
2022-04-22,35610,1011,1428,4263,32700023,12578146,458954,,12119192,7284834
2022-04-23,34639,1004,1733,4711,32734662,12578868,458222,,12120646,7289308
2022-04-24,20805,1022,1882,3777,32755467,12579640,457359,,12122281,7292891
2022-04-25,8299,453,691,1707,32763766,12579824,457120,,12122704,7294382
2022-04-26,24600,732,942,3136,32788366,12580264,456904,,12123360,7297281
2022-04-27,33591,954,1368,3934,32821957,12580943,456482,,12124461,7300999
2022-04-28,32828,927,1412,3928,32854785,12581597,455988,,12125609,7304704
2022-04-29,32048,1098,1376,3908,32886833,12582398,455703,,12126695,7308384
2022-04-30,30271,923,1533,4020,32917104,12583024,455086,,12127938,7312168
2022-05-01,16746,768,1576,2969,32933850,12583496,454273,,12129223,7314895
2022-05-02,5933,309,524,1097,32939783,12583509,454054,,12129455,7315765
2022-05-03,20921,588,829,2345,32960704,12583792,453807,,12129985,7317871
2022-05-04,29410,800,1091,3293,32990114,12584283,453511,,12130772,7320915
2022-05-05,29090,872,1160,3124,33019204,12584843,453213,,12131630,7323795
2022-05-06,29081,1146,1279,2982,33048285,12585702,453075,,12132627,7326551
2022-05-07,28482,868,1260,3111,33076767,12586280,452678,,12133602,7329438
2022-05-08,15996,896,1309,2322,33092763,12586919,452263,,12134656,7331559
2022-05-09,5896,292,474,943,33098659,12586946,452075,,12134871,7332293
2022-05-10,21219,695,717,2119,33119878,12587324,452046,,12135278,7334153
2022-05-11,28940,836,1079,2654,33148818,12587829,451799,,12136030,7336535
2022-05-12,28230,800,1082,2509,33177048,12588332,451513,,12136819,7338803
2022-05-13,27589,878,1116,2468,33204637,12588900,451271,,12137629,7341014
2022-05-14,25683,808,1096,2607,33230320,12589392,450976,,12138416,7343366
2022-05-15,14843,751,1273,2054,33245163,12589873,450447,,12139426,7345203
2022-05-16,6381,325,532,1047,33251544,12589961,450236,,12139725,7346064
2022-05-17,19593,584,775,1741,33271137,12590231,450038,,12140193,7347557
2022-05-18,26538,877,1097,2272,33297675,12590844,449813,,12141031,7349614
2022-05-19,24428,681,1155,2159,33322103,12591258,449332,,12141926,7351556
2022-05-20,24260,801,1136,2215,33346363,12591792,448993,,12142799,7353554
2022-05-21,22394,691,1165,2345,33368757,12592175,448510,,12143665,7355658
2022-05-22,10554,551,888,1485,33379311,12592465,448168,,12144297,7356926
2022-05-23,4560,241,462,784,33383871,12592448,447945,,12144503,7357502
2022-05-24,2611,118,176,433,33386482,12592313,447885,,12144428,7357726
2022-05-25,19353,655,945,1952,33405835,12592703,447585,,12145118,7359469
2022-05-26,20635,662,948,1908,33426470,12593092,447293,,12145799,7361155
2022-05-27,21749,816,1056,2073,33448219,12593622,447050,,12146572,7362997
2022-05-28,19397,722,1164,2144,33467616,12594075,446605,,12147470,7364928
2022-05-29,12105,759,1280,1725,33479721,12594599,446077,,12148522,7366461
2022-05-30,4578,311,548,751,33484299,12594664,445837,,12148827,7367014
2022-05-31,13545,572,749,1666,33497844,12594934,445654,,12149280,7368440
2022-06-01,16606,702,970,1876,33514450,12595332,445384,,12149948,7370062
2022-06-02,14595,556,864,1672,33529045,12595576,445069,,12150507,7371493
2022-06-03,16097,697,1094,1813,33545142,12595997,444666,,12151331,7373089
2022-06-04,13315,648,1162,1842,33558457,12596389,444148,,12152241,7374730
2022-06-05,7866,587,1109,1432,33566323,12596727,443622,,12153105,7375970
2022-06-06,3293,206,444,641,33569616,12596687,443381,,12153306,7376412
2022-06-07,11209,474,725,1367,33580825,12596862,443125,,12153737,7377535
2022-06-08,14057,666,1012,1608,33594882,12597270,442774,,12154496,7378925
2022-06-09,13367,662,921,1673,33608249,12597644,442510,,12155134,7380366
2022-06-10,13845,684,1066,1694,33622094,12598042,442120,,12155922,7381830
2022-06-11,12975,613,1031,1863,33635069,12598370,441700,,12156670,7383471
2022-06-12,8093,644,1236,1499,33643162,12598758,441104,,12157654,7384765
2022-06-13,3186,284,422,709,33646348,12598776,440961,,12157815,7385265
2022-06-14,10125,511,666,1262,33656473,12598998,440800,,12158198,7386289
2022-06-15,13498,470,828,1620,33669971,12599175,440440,,12158735,7387674
2022-06-16,12534,493,855,1616,33682505,12599364,440073,,12159291,7389044
2022-06-17,11686,479,815,1652,33694191,12599558,439730,,12159828,7390462
2022-06-18,11445,436,873,1860,33705636,12599725,439290,,12160435,7392099
2022-06-19,6998,482,896,1420,33712634,12599959,438875,,12161084,7393309
2022-06-20,2286,147,301,643,33714920,12599886,438715,,12161171,7393784
2022-06-21,9538,358,614,1381,33724458,12599957,438454,,12161503,7394917
2022-06-22,13606,406,724,1702,33738064,12600091,438129,,12161962,7396394
2022-06-23,13693,400,772,1680,33751757,12600229,437754,,12162475,7397863
2022-06-24,15359,435,811,1670,33767116,12600404,437374,,12163030,7399318
2022-06-25,14464,424,851,1711,33781580,12600570,436936,,12163634,7400823
2022-06-26,8156,432,885,1280,33789736,12600744,436476,,12164268,7401889
2022-06-27,3210,171,363,593,33792946,12600667,436280,,12164387,7402276
2022-06-28,9615,370,556,1223,33802561,12600752,436090,,12164662,7403267
2022-06-29,13303,413,727,1628,33815864,12600876,435774,,12165102,7404656
2022-06-30,12223,482,845,1575,33828087,12601075,435409,,12165666,7405999
2022-07-01,13034,548,970,1946,33841121,12601368,434982,,12166386,7407740
2022-07-02,1609,110,115,362,33842730,12601202,434975,,12166227,7407870
2022-07-03,5157,261,492,958,33847887,12601208,434735,,12166473,7408614
2022-07-04,2756,131,279,614,33850643,12601093,434586,,12166507,7409032
2022-07-05,11139,372,598,1572,33861782,12601171,434352,,12166819,7410359
2022-07-06,15952,545,855,2007,33877734,12601422,434036,,12167386,7412125
2022-07-07,15655,521,831,1921,33893389,12601656,433725,,12167931,7413794
2022-07-08,17874,552,870,2243,33911263,12601904,433406,,12168498,7415788
2022-07-09,14132,449,596,1841,33925395,12602080,433258,,12168822,7417396
2022-07-10,8739,472,752,1501,33934134,12602306,432977,,12169329,7418692
2022-07-11,4093,199,331,870,33938227,12602241,432842,,12169399,7419343
2022-07-12,12103,413,522,1653,33950330,12602356,432728,,12169628,7420743
2022-07-13,16708,562,770,2141,33967038,12602624,432514,,12170110,7422643
2022-07-14,16854,486,674,2021,33983892,12602806,432315,,12170491,7424426
2022-07-15,28886,600,822,2180,34012778,12603106,432092,,12171014,7426365
2022-07-16,30284,584,771,2323,34043062,12603378,431896,,12171482,7428438
2022-07-17,22918,537,635,1881,34065980,12603679,431795,,12171884,7430126
2022-07-18,11387,187,254,852,34077367,12603598,431723,,12171875,7430756
2022-07-19,28943,592,590,2131,34106310,12603917,431722,,12172195,7432656
2022-07-20,37622,841,922,2584,34143932,12604481,431636,,12172845,7435005
2022-07-21,36346,732,809,2803,34180278,12604928,431552,,12173376,7437570
2022-07-22,35793,827,888,2682,34216071,12605470,431485,,12173985,7440016
2022-07-23,35134,819,913,2823,34251205,12605978,431383,,12174595,7442585
2022-07-24,21728,602,805,1768,34272933,12606319,431177,,12175142,7444130
2022-07-25,11932,308,311,1080,34284865,12606347,431169,,12175178,7444983
2022-07-26,26083,621,600,2209,34310948,12606686,431189,,12175497,7446950
2022-07-27,32461,810,844,2647,34343409,12607241,431153,,12176088,7449389
2022-07-28,31532,725,884,2603,34374941,12607673,430990,,12176683,7451745
2022-07-29,29986,1790,875,2640,34404927,12609173,431901,,12177272,7454136
2022-07-30,25820,2524,745,2431,34430747,12611424,433678,,12177746,7456340
2022-07-31,14290,1068,540,1561,34445037,12612227,434202,,12178025,7457676
2022-08-01,5911,336,223,681,34450948,12612305,434313,,12177992,7458134
2022-08-02,4472,305,135,599,34455420,12612340,434479,,12177861,7458511
2022-08-03,22927,2635,736,2234,34478347,12614702,436374,,12178328,7460512
2022-08-04,22222,2479,676,2128,34500569,12616856,438171,,12178685,7462379
2022-08-05,21788,2756,743,2063,34522357,12619333,440176,,12179157,7464216
2022-08-06,19641,2877,657,1990,34541998,12621902,442390,,12179512,7465951
2022-08-07,12697,2236,618,1418,34554695,12623866,444002,,12179864,7467154
2022-08-08,4766,570,188,603,34559461,12624154,444377,,12179777,7467525
2022-08-09,14002,1464,556,1589,34573463,12625334,445279,,12180055,7468875
2022-08-10,19119,2363,716,1988,34592582,12627425,446924,,12180501,7470636
2022-08-11,17072,2043,718,1850,34609654,12629195,448247,,12180948,7472256
2022-08-12,16978,2049,733,1850,34626632,12630958,449562,,12181396,7473879
2022-08-13,15943,2222,760,1805,34642575,12632901,451022,,12181879,7475448
2022-08-14,9523,1621,618,1081,34652098,12634235,452021,,12182214,7476295
2022-08-15,3867,388,268,476,34655965,12634372,452138,,12182234,7476564
2022-08-16,10801,1073,514,1355,34666766,12635147,452695,,12182452,7477670
2022-08-17,16090,1832,737,1778,34682856,12636693,453789,,12182904,7479213
2022-08-18,14920,1639,747,1685,34697776,12638011,454677,,12183334,7480630
2022-08-19,15305,1846,747,1544,34713081,12639583,455772,,12183811,7481942
2022-08-20,14277,1640,739,1543,34727358,12640935,456667,,12184268,7483248
2022-08-21,9894,1533,658,1162,34737252,12642208,457538,,12184670,7484197
2022-08-22,4161,481,269,561,34741413,12642393,457747,,12184646,7484505
2022-08-23,11127,1248,553,1491,34752540,12643337,458439,,12184898,7485745
2022-08-24,14751,1807,868,2185,34767291,12644876,459378,,12185498,7487702
2022-08-25,14026,1719,780,2119,34781317,12646310,460310,,12186000,7489578
2022-08-26,13923,1687,815,2090,34795240,12647708,461175,,12186533,7491423
2022-08-27,12409,1484,877,1996,34807649,12648869,461776,,12187093,7493155
2022-08-28,7920,1258,619,1396,34815569,12649873,462413,,12187460,7494336
2022-08-29,3394,504,283,681,34818963,12650105,462629,,12187476,7494791
2022-08-30,9902,1169,649,1853,34828865,12650921,463143,,12187778,7496345
2022-08-31,13505,1626,944,2310,34842370,12652264,463821,,12188443,7498418
2022-09-01,12898,1720,910,2138,34855268,12653693,464627,,12189066,7500314
2022-09-02,15040,1614,991,4919,34870308,12655037,465242,,12189795,7505012
2022-09-03,14708,1525,919,5513,34885016,12656291,465845,,12190446,7510300
2022-09-04,8660,1010,675,3234,34893676,12657045,466172,,12190873,7513318
2022-09-05,3549,321,229,1382,34897225,12657105,466261,,12190844,7514480
2022-09-06,2459,157,113,1126,34899684,12657016,466302,,12190714,7515403
2022-09-07,10919,1018,587,3490,34910603,12657744,466731,,12191013,7518647
2022-09-08,10863,1021,523,2790,34921466,12658444,467226,,12191218,7521167
2022-09-09,9580,1013,488,2500,34931046,12659172,467746,,12191426,7523434
2022-09-10,10628,1266,551,3162,34941674,12660168,468455,,12191713,7526368
2022-09-11,9402,982,667,3733,34951076,12660907,468764,,12192143,7529896
2022-09-12,3124,295,203,1079,34954200,12660926,468850,,12192076,7530743
2022-09-13,6009,542,281,1130,34960209,12661191,469102,,12192089,7531639
2022-09-14,14475,798,431,1843,34974684,12661678,469465,,12192213,7533221
2022-09-15,15742,780,408,1533,34990426,12662146,469833,,12192313,7534489
2022-09-16,17748,766,445,1690,35008174,12662659,470148,,12192511,7535963
2022-09-17,17604,722,456,1665,35025778,12663086,470410,,12192676,7537380
2022-09-18,11207,776,451,1684,35036985,12663607,470733,,12192874,7538846
2022-09-19,4977,403,288,670,35041962,12663746,470845,,12192901,7539306
2022-09-20,13749,438,327,941,35055711,12663877,470954,,12192923,7539987
2022-09-21,23021,643,406,1496,35078732,12664228,471186,,12193042,7541241
2022-09-22,22898,639,395,1377,35101630,12664569,471424,,12193145,7542363
2022-09-23,22934,726,599,1416,35124564,12665005,471547,,12193458,7543533
2022-09-24,21676,736,689,1497,35146240,12665452,471590,,12193862,7544797
2022-09-25,11312,595,702,1355,35157552,12665775,471478,,12194297,7545923
2022-09-26,4561,192,218,594,35162113,12665686,471446,,12194240,7546278
2022-09-27,37644,499,364,1498,35199757,12665925,471577,,12194348,7547556
2022-09-28,50952,730,670,1901,35250709,12666396,471636,,12194760,7549240
2022-09-29,47989,637,739,1835,35298698,12666725,471527,,12195198,7550808
2022-09-30,47265,679,806,2001,35345963,12667085,471398,,12195687,7552535
2022-10-01,34433,527,632,1545,35380396,12667313,471291,,12196022,7553822
2022-10-02,24236,738,1023,1710,35404632,12667769,471003,,12196766,7555290
2022-10-03,10861,239,231,610,35415493,12667728,471007,,12196721,7555671
2022-10-04,32178,478,458,1168,35447671,12667898,471023,,12196875,7556573
2022-10-05,40416,625,740,1559,35488087,12668222,470903,,12197319,7557880
2022-10-06,38675,609,652,1567,35526762,12668542,470858,,12197684,7559197
2022-10-07,42227,660,850,1742,35568989,12668868,470660,,12198208,7560649
2022-10-08,37379,787,1145,2119,35606368,12669345,470296,,12199049,7562510
2022-10-09,18811,549,727,1557,35625179,12669633,470115,,12199518,7563845
2022-10-10,6861,170,370,567,35632040,12669519,469913,,12199606,7564165
2022-10-11,4986,124,111,318,35637026,12669365,469921,,12199444,7564253
2022-10-12,35096,579,683,1426,35672122,12669624,469815,,12199809,7565403
2022-10-13,36747,644,857,1621,35708869,12669925,469600,,12200325,7566732
2022-10-14,36957,621,752,1539,35745826,12670232,469466,,12200766,7568002
2022-10-15,35443,716,1012,1624,35781269,12670680,469167,,12201513,7569398
2022-10-16,20660,654,1024,1594,35801929,12671080,468791,,12202289,7570772
2022-10-17,7349,206,477,538,35809278,12671016,468519,,12202497,7571080
2022-10-18,36413,459,499,1397,35845691,12671168,468475,,12202693,7572215
2022-10-19,49872,619,729,1983,35895563,12671498,468362,,12203136,7573957
2022-10-20,51262,623,648,2047,35946825,12671821,468335,,12203486,7575752
2022-10-21,52835,699,618,1938,35999660,12672208,468413,,12203795,7577430
2022-10-22,50853,752,905,2308,36050513,12672643,468255,,12204388,7579472
2022-10-23,30622,579,782,2118,36081135,12672921,468046,,12204875,7581336
2022-10-24,14130,231,270,979,36095265,12672866,468002,,12204864,7582069
2022-10-25,41340,474,488,1815,36136605,12673013,467985,,12205028,7583606
2022-10-26,51615,618,660,2122,36188220,12673310,467939,,12205371,7585459
2022-10-27,50090,610,768,2161,36238310,12673610,467775,,12205835,7587361
2022-10-28,49773,591,673,2093,36288083,12673861,467690,,12206171,7589159
2022-10-29,50579,737,778,2217,36338662,12674270,467645,,12206625,7591094
2022-10-30,28386,663,930,2034,36367048,12674673,467375,,12207298,7592900
2022-10-31,12436,200,234,776,36379484,12674616,467338,,12207278,7593459
2022-11-01,33067,342,196,1220,36412551,12674630,467478,,12207152,7594401
2022-11-02,44267,575,622,1904,36456818,12674899,467429,,12207470,7596027
2022-11-03,44171,540,604,1856,36500989,12675140,467362,,12207778,7597622
2022-11-04,44624,652,527,2024,36545613,12675508,467481,,12208027,7599407
2022-11-05,45188,648,755,2368,36590801,12675880,467371,,12208509,7601530
2022-11-06,26012,560,771,2096,36616813,12676122,467158,,12208964,7603349
2022-11-07,10710,243,235,876,36627523,12676117,467163,,12208954,7604019
2022-11-08,33462,488,395,1584,36660985,12676338,467253,,12209085,7605377
2022-11-09,40519,605,569,1965,36701504,12676656,467288,,12209368,7607098
2022-11-10,39160,626,547,1926,36740664,12676993,467363,,12209630,7608773
2022-11-11,43322,637,641,2205,36783986,12677347,467358,,12209989,7610734
2022-11-12,36831,640,592,2185,36820817,12677685,467398,,12210287,7612656
2022-11-13,24257,559,770,2276,36845074,12677975,467182,,12210793,7614701
2022-11-14,10961,233,204,1023,36856035,12677942,467210,,12210732,7615490
2022-11-15,33582,485,379,1691,36889617,12678100,467312,,12210788,7616904
2022-11-16,43517,801,581,2369,36933134,12678633,467527,,12211106,7619047
2022-11-17,38314,674,646,2241,36971448,12678989,467551,,12211438,7621017
2022-11-18,40599,725,530,2326,37012047,12679397,467742,,12211655,7623066
2022-11-19,39639,1016,1031,3076,37051686,12680102,467723,,12212379,7625868
2022-11-20,22410,661,717,2440,37074096,12680527,467666,,12212861,7628110
2022-11-21,8918,197,192,970,37083014,12680488,467667,,12212821,7628894
2022-11-22,26429,480,368,1512,37109443,12680655,467776,,12212879,7630132
2022-11-23,32052,686,666,2068,37141495,12681040,467794,,12213246,7631945
2022-11-24,31891,664,750,2081,37173386,12681421,467707,,12213714,7633786
2022-11-25,30744,764,829,1949,37204130,12681912,467636,,12214276,7635506
2022-11-26,30269,907,1190,2696,37234399,12682518,467346,,12215172,7637940
2022-11-27,18670,611,944,2087,37253069,12682862,467009,,12215853,7639795
2022-11-28,7535,191,280,786,37260604,12682791,466915,,12215876,7640347
2022-11-29,21013,421,451,1291,37281617,12682928,466882,,12216046,7641392
2022-11-30,27877,645,647,1840,37309494,12683296,466878,,12216418,7642990
2022-12-01,24792,594,681,1689,37334286,12683609,466789,,12216820,7644434
2022-12-02,25044,524,630,1771,37359330,12683851,466677,,12217174,7645957
2022-12-03,25537,588,779,1944,37384867,12684164,466479,,12217685,7647679
2022-12-04,15245,499,606,1699,37400112,12684380,466368,,12218012,7649125
2022-12-05,6869,168,156,743,37406981,12684295,466375,,12217920,7649651
2022-12-06,20332,421,351,1375,37427313,12684408,466444,,12217964,7650759
2022-12-07,24755,553,609,1668,37452068,12684704,466386,,12218318,7652204
2022-12-08,23147,563,523,1760,37475215,12685008,466425,,12218583,7653733
2022-12-09,23315,636,575,1631,37498530,12685381,466485,,12218896,7655141
2022-12-10,22565,512,600,1627,37521095,12685645,466396,,12219249,7656550
2022-12-11,14197,550,785,1567,37535292,12685989,466159,,12219830,7657934
2022-12-12,5506,150,157,593,37540798,12685905,466148,,12219757,7658331
2022-12-13,17784,378,367,1125,37558582,12686019,466159,,12219860,7659227
2022-12-14,21309,511,547,1452,37579891,12686318,466119,,12220199,7660491
2022-12-15,21949,530,600,1578,37601840,12686579,466048,,12220531,7661835
2022-12-16,16277,378,449,1030,37618117,12686703,465977,,12220726,7662647
2022-12-17,18689,560,505,1272,37636806,12687014,466031,,12220983,7663687
2022-12-18,12633,530,794,1303,37649439,12687319,465766,,12221553,7664786
2022-12-19,4585,133,115,448,37654024,12687196,465780,,12221416,7665006
2022-12-20,16200,501,449,1105,37670224,12687453,465829,,12221624,7665898
2022-12-21,18457,546,548,1298,37688681,12687771,465824,,12221947,7666993
2022-12-22,18586,576,589,1743,37707267,12688120,465811,,12222309,7668536
2022-12-23,15629,580,597,1712,37722896,12688422,465789,,12222633,7670015
2022-12-24,5329,223,171,671,37728225,12688403,465841,,12222562,7670465
2022-12-25,2441,153,152,480,37730666,12688319,465835,,12222484,7670738
2022-12-26,262,12,7,48,37730928,12688095,465836,,12222259,7670578
2022-12-27,2090,99,35,305,37733018,12687989,465898,,12222091,7670702
2022-12-28,8314,337,167,975,37741332,12688078,466066,,12222012,7671453
2022-12-29,13153,584,524,1600,37754485,12688414,466123,,12222291,7672835
2022-12-30,15811,671,657,1877,37770296,12688843,466134,,12222709,7674495
2022-12-31,11224,462,387,1353,37781520,12689029,466205,,12222824,7675604
2023-01-01,3905,204,219,561,37785425,12688996,466190,,12222806,7675957
2023-01-02,652,37,15,96,37786077,12688812,466212,,12222600,7675856
2023-01-03,8187,300,152,897,37794264,12688883,466355,,12222528,7676561
2023-01-04,14708,575,547,1545,37808972,12689237,466377,,12222860,7677912
2023-01-05,16100,653,533,1792,37825072,12689647,466494,,12223153,7679490
2023-01-06,18815,719,609,2043,37843887,12690146,466601,,12223545,7681336
2023-01-07,18507,708,638,2052,37862394,12690627,466668,,12223959,7683188
2023-01-08,11609,582,608,1630,37874003,12691009,466641,,12224368,7684639
2023-01-09,5296,216,196,664,37879299,12691000,466659,,12224341,7685108
2023-01-10,12155,421,315,780,37891454,12691181,466765,,12224416,7685674
2023-01-11,15536,459,370,1092,37906990,12691398,466852,,12224546,7686554
2023-01-12,14054,449,407,972,37921044,12691597,466893,,12224704,7687305
2023-01-13,14156,425,345,1035,37935200,12691828,466972,,12224856,7688161
2023-01-14,13360,479,452,1075,37948560,12692083,466996,,12225087,7689032
2023-01-15,9040,466,506,1049,37957600,12692349,466955,,12225394,7689910
2023-01-16,3744,148,130,479,37961344,12692278,466973,,12225305,7690188
2023-01-17,8843,270,179,651,37970187,12692280,467064,,12225216,7690610
2023-01-18,10237,352,273,756,37980424,12692407,467143,,12225264,7691159
2023-01-19,10571,318,318,760,37990995,12692492,467139,,12225353,7691718
2023-01-20,9822,320,272,715,38000817,12692592,467186,,12225406,7692232
2023-01-21,11301,358,398,904,38012118,12692734,467146,,12225588,7692951
2023-01-22,7564,346,404,816,38019682,12692873,467086,,12225787,7693575
2023-01-23,3378,144,131,288,38023060,12692836,467099,,12225737,7693704
2023-01-24,8277,228,165,549,38031337,12692824,467160,,12225664,7694042
2023-01-25,10309,349,296,660,38041646,12692958,467212,,12225746,7694513
2023-01-26,6720,236,203,469,38048366,12692972,467245,,12225727,7694793
2023-01-27,6900,241,197,491,38055266,12692974,467288,,12225686,7695079
2023-01-28,9329,311,337,693,38064595,12693064,467258,,12225806,7695577
2023-01-29,5958,235,341,689,38070553,12693080,467147,,12225933,7696069
2023-01-30,1899,89,79,216,38072452,12692958,467155,,12225803,7696094
2023-01-31,5867,156,150,412,38078319,12692876,467159,,12225717,7696292
2023-02-01,7288,251,248,488,38085607,12692930,467162,,12225768,7696608
2023-02-02,6461,294,239,499,38092068,12693038,467215,,12225823,7696952
2023-02-03,6539,197,191,462,38098607,12693041,467220,,12225821,7697241
2023-02-04,6707,232,305,540,38105314,12693093,467142,,12225951,7697628
2023-02-05,4173,198,291,483,38109487,12693086,467048,,12226038,7697940
2023-02-06,1834,91,98,211,38111321,12692971,467039,,12225932,7697962
2023-02-07,4958,161,181,383,38116279,12692915,467017,,12225898,7698158
2023-02-08,5766,214,206,429,38122045,12692946,467024,,12225922,7698423
2023-02-09,6111,215,243,437,38128156,12692979,466996,,12225983,7698704
2023-02-10,5075,158,207,369,38133231,12692995,466945,,12226050,7698948
2023-02-11,6033,183,257,456,38139264,12692984,466867,,12226117,7699227
2023-02-12,4073,215,342,408,38143337,12693011,466737,,12226274,7699464
2023-02-13,1480,56,87,146,38144817,12692903,466706,,12226197,7699471
2023-02-14,3932,131,178,308,38148749,12692831,466658,,12226173,7699598
2023-02-15,4537,119,191,285,38153286,12692773,466586,,12226187,7699724
2023-02-16,4912,174,285,400,38158198,12692766,466473,,12226293,7699962
2023-02-17,4976,180,210,342,38163174,12692790,466442,,12226348,7700167
2023-02-18,5105,230,295,487,38168279,12692846,466375,,12226471,7700500
2023-02-19,3349,133,243,373,38171628,12692815,466264,,12226551,7700736
2023-02-20,1417,62,54,157,38173045,12692718,466270,,12226448,7700756
2023-02-21,911,25,14,106,38173956,12692616,466281,,12226335,7700746
2023-02-22,4132,130,213,370,38178088,12692595,466194,,12226401,7700991
2023-02-23,4250,163,231,389,38182338,12692580,466120,,12226460,7701222
2023-02-24,3026,138,229,273,38185364,12692580,466027,,12226553,7701370
2023-02-25,5009,213,539,384,38190373,12692648,465701,,12226947,7701632
2023-02-26,3472,146,681,384,38193845,12692643,465165,,12227478,7701886
2023-02-27,1067,37,56,97,38194912,12692551,465143,,12227408,7701875
2023-02-28,2714,97,163,231,38197626,12692472,465075,,12227397,7701948
2023-03-01,3844,136,428,334,38201470,12692444,464782,,12227662,7702132
2023-03-02,4570,159,494,325,38206040,12692441,464445,,12227996,7702323
2023-03-03,4359,160,356,332,38210399,12692462,464247,,12228215,7702528
2023-03-04,4954,207,624,347,38215353,12692532,463828,,12228704,7702754
2023-03-05,2532,110,449,251,38217885,12692525,463488,,12229037,7702901
2023-03-06,1158,51,37,114,38219043,12692455,463500,,12228955,7702908
2023-03-07,3200,89,171,220,38222243,12692386,463416,,12228970,7702991
2023-03-08,4302,132,412,282,38226545,12692397,463136,,12229261,7703165
2023-03-09,4598,169,451,310,38231143,12692448,462851,,12229597,7703374
2023-03-10,3900,104,135,253,38235043,12692449,462820,,12229629,7703537
2023-03-11,4033,142,161,282,38239076,12692498,462800,,12229698,7703733
2023-03-12,2875,110,234,300,38241951,12692504,462674,,12229830,7703940
2023-03-13,857,32,32,103,38242808,12692449,462672,,12229777,7703967
2023-03-14,3047,100,108,255,38245855,12692447,462664,,12229783,7704136
2023-03-15,4056,146,160,303,38249911,12692520,462650,,12229870,7704371
2023-03-16,3982,173,234,273,38253893,12692599,462587,,12230012,7704569
2023-03-17,4253,172,202,305,38258146,12692696,462557,,12230139,7704802
2023-03-18,4295,151,193,293,38262441,12692786,462515,,12230271,7705041
2023-03-19,2699,131,233,253,38265140,12692890,462413,,12230477,7705269
2023-03-20,757,30,18,71,38265897,12692893,462425,,12230468,7705317
2023-03-21,2843,74,83,197,38268740,12692963,462416,,12230547,7705510
2023-03-22,3802,127,127,240,38272542,12693090,462416,,12230674,7705750
2023-03-23,3627,122,163,210,38276169,12693212,462375,,12230837,7705960
