"report_date","previous_day_total_doses_administered","previous_day_at_least_one","previous_day_fully_vaccinated","previous_day_3doses","total_doses_administered","total_individuals_at_least_one","total_individuals_partially_vaccinated","total_doses_in_fully_vaccinated_individuals","total_individuals_fully_vaccinated","total_individuals_3doses"
2021-01-01,6252,6242,2,,32218,32163,32152,22,11,
2021-01-02,4616,4604,6,,36834,36715,36702,26,13,
2021-01-03,5396,5389,3,,42230,42104,42088,32,16,
2021-01-04,5996,5993,0,,48226,48096,48081,30,15,
2021-01-05,9687,9662,21,,57913,57756,57721,70,35,
2021-01-06,12793,12328,450,,70706,70081,69599,964,482,
2021-01-07,16220,15508,698,,86926,85588,84408,2360,1180,
2021-01-08,18040,17024,1003,,104966,102612,100429,4366,2183,
2021-01-09,19504,18427,1064,,124470,121038,117791,6494,3247,
2021-01-10,11374,11333,39,,135844,132363,129077,6572,3286,
2021-01-11,11712,11661,48,,147556,144024,140690,6668,3334,
2021-01-12,14469,14162,298,,162025,158178,154546,7264,3632,
2021-01-13,15438,13814,1594,,177463,171978,166754,10448,5224,
2021-01-14,19194,16741,2437,,196657,188713,181053,15320,7660,
2021-01-15,20077,18019,2038,,216734,206721,197023,19396,9698,
2021-01-16,17121,15937,1171,,233855,222642,211773,21738,10869,
2021-01-17,11261,10017,1237,,245116,232644,220540,24208,12104,
2021-01-18,6797,6713,74,,251913,239334,227159,24350,12175,
2021-01-19,11830,9721,2095,,263743,249034,234764,28540,14270,
2021-01-20,10804,7215,3572,,274547,256226,238385,35682,17841,
2021-01-21,10977,6856,4093,,285524,263066,241132,43868,21934,
2021-01-22,9041,4324,4697,,294565,267353,240724,53258,26629,
2021-01-23,7462,3044,4390,,302027,270367,239349,62036,31018,
2021-01-24,4390,1833,2536,,306417,272182,238628,67108,33554,
2021-01-25,5324,1050,4265,,311741,273200,235382,75636,37818,
2021-01-26,9394,2867,6499,,321135,276035,231719,88632,44316,
2021-01-27,9899,2866,7004,,331034,278872,227553,102638,51319,
2021-01-28,13125,5746,7337,,344159,284585,225929,117312,58656,
2021-01-29,10710,3295,7379,,354869,287849,221815,132068,66034,
2021-01-30,9194,2733,6424,,364063,290540,218085,144910,72455,
2021-01-31,3386,1572,1768,,367449,292078,217856,148444,74222,
2021-02-01,2128,490,1610,,369577,292534,216706,151656,75828,
2021-02-02,4421,1368,2996,,373998,293864,215044,157640,78820,
2021-02-03,6242,1722,4458,,380240,295545,212274,166542,83271,
2021-02-04,9097,1725,7293,,389337,297227,206669,181116,90558,
2021-02-05,8449,1470,6904,,397786,298657,201201,194912,97456,
2021-02-06,10671,1873,8737,,408457,300475,194291,212368,106184,
2021-02-07,7580,1731,5796,,416037,302166,190198,223936,111968,
2021-02-08,8222,3096,5081,,424259,305214,188178,234072,117036,
2021-02-09,15011,3860,11083,,439270,309032,180929,256206,128103,
2021-02-10,15515,4936,10518,,454785,313916,175320,277192,138596,
2021-02-11,16366,3899,12409,,471151,317763,166789,301948,150974,
2021-02-12,17678,2099,15528,,488829,319823,153341,332964,166482,
2021-02-13,16214,2446,13752,,505043,322224,142009,360430,180215,
2021-02-14,12883,924,11926,,517926,323100,130989,384222,192111,
2021-02-15,7864,487,7328,,525790,323539,124126,398826,199413,
2021-02-16,5996,1042,4903,,531786,324538,120245,408586,204293,
2021-02-17,10170,1611,8525,,541956,326105,113315,425580,212790,
2021-02-18,13879,2960,10874,,555835,329017,105383,447268,223634,
2021-02-19,18492,6214,12211,,574327,335179,99365,471628,235814,
2021-02-20,22633,11136,11444,,596960,346252,99032,494440,247220,
2021-02-21,17245,10388,6823,,614205,356580,102579,508002,254001,
2021-02-22,13590,8759,4777,,627795,365270,106541,517458,258729,
2021-02-23,17870,11126,6673,,645665,376340,110974,530732,265366,
2021-02-24,18580,13615,4884,,664245,389899,119691,540416,270208,
2021-02-25,20813,16491,4265,,685058,406324,131899,548850,274425,
2021-02-26,24916,21842,3012,,709974,428106,150706,554800,277400,
2021-02-27,27469,23586,3840,,737443,451628,170436,562384,281192,
2021-02-28,20589,19147,1407,,758032,470721,188164,565114,282557,
2021-03-01,18227,17030,1148,,776259,487689,204031,567316,283658,
2021-03-02,24694,22282,2327,,800953,509910,223971,571878,285939,
2021-03-03,30602,27966,2579,,831555,537825,249340,576970,288485,
2021-03-04,34703,32469,2147,,866258,570228,279646,581164,290582,
2021-03-05,40010,38174,1787,,906268,608354,316019,584670,292335,
2021-03-06,44163,41953,2172,,950431,650252,355786,588932,294466,
2021-03-07,32739,31560,1175,,983170,681738,386155,591166,295583,
2021-03-08,24040,22164,1861,,1007210,703834,406444,594780,297390,
2021-03-09,33301,29850,3423,,1040511,733618,432851,601534,300767,
2021-03-10,38350,34086,4218,,1078861,767630,462693,609874,304937,
2021-03-11,43988,40715,3234,,1122849,808279,500160,616238,308119,
2021-03-12,47719,46007,1689,,1170568,854222,544464,619516,309758,
2021-03-13,57940,55062,2851,,1228508,909213,596658,625110,312555,
2021-03-14,43429,42189,1222,,1271937,951319,637610,627418,313709,
2021-03-15,32815,31117,1682,,1304752,982377,667029,630696,315348,
2021-03-16,53966,51666,2282,,1358718,1033978,716391,635174,317587,
2021-03-17,61071,58530,2497,,1419789,1092442,772408,640068,320034,
2021-03-18,61563,59097,2437,,1481352,1151467,829049,644836,322418,
2021-03-19,64486,61152,3276,,1545838,1212541,886900,651282,325641,
2021-03-20,62580,59988,2560,,1608418,1272473,944320,656306,328153,
2021-03-21,44009,42481,1541,,1652427,1314889,985232,659314,329657,
2021-03-22,31003,30036,978,,1683430,1344837,1014258,661158,330579,
2021-03-23,54626,51852,2723,,1738056,1396594,1063355,666478,333239,
2021-03-24,76442,73260,3134,,1814498,1469764,1133448,672632,336316,
2021-03-25,82923,80342,2534,,1897421,1550027,1211234,677586,338793,
2021-03-26,87023,83492,3491,,1984444,1633438,1291206,684464,342232,
2021-03-27,80871,77917,2868,,2065315,1711252,1366217,690070,345035,
2021-03-28,67002,65412,1555,,2132317,1776574,1430041,693066,346533,
2021-03-29,51741,49050,2652,,2184058,1825544,1476405,698278,349139,
2021-03-30,73591,70179,3350,,2257649,1895646,1543198,704896,352448,
2021-03-31,93165,89512,3587,,2350814,1985060,1629078,711964,355982,
2021-04-01,89331,85448,3841,,2440145,2070410,1710640,719540,359770,
2021-04-02,93101,88870,4213,,2533246,2159194,1795263,727862,363931,
2021-04-03,61012,59333,1735,,2594258,2218436,1852821,731230,365615,
2021-04-04,72335,70678,1651,,2666593,2289003,1921795,734416,367208,
2021-04-05,53735,53264,470,,2720328,2342183,1974553,735260,367630,
2021-04-06,79593,77719,1890,,2799921,2419800,2050334,738932,369466,
2021-04-07,108020,104950,3056,,2907941,2524625,2152161,744928,372464,
2021-04-08,114088,110111,4028,,3022029,2634625,2258189,752872,376436,
2021-04-09,109868,105633,4304,,3131897,2740140,2359465,761350,380675,
2021-04-10,109256,105492,3854,,3241153,2845504,2461041,768926,384463,
2021-04-11,98634,95515,3259,,3339787,2940894,2553231,775326,387663,
2021-04-12,76077,75012,1158,,3415864,3015758,2627005,777506,388753,
2021-04-13,99486,96100,3402,,3515350,3111749,2719642,784214,392107,
2021-04-14,117057,113291,3651,,3632407,3224922,2829204,791436,395718,
2021-04-15,113573,109509,3900,,3745980,3334305,2934744,799122,399561,
2021-04-16,118093,113718,4195,,3864073,3447913,3044201,807424,403712,
2021-04-17,112428,107834,4454,,3976501,3555613,3147506,816214,408107,
2021-04-18,88753,86514,2102,,4065254,3642004,3231849,820310,410155,
2021-04-19,68979,67444,1453,,4134233,3709318,3297761,823114,411557,
2021-04-20,102124,98795,3122,,4236357,3807951,3393337,829228,414614,
2021-04-21,142058,137775,4046,,4378415,3945552,3526960,837184,418592,
2021-04-22,139511,135354,3915,,4517926,4080777,3658326,844902,422451,
2021-04-23,138231,131803,6179,,4656157,4212426,3783854,857144,428572,
2021-04-24,130305,126236,3894,,4786462,4338514,3906104,864820,432410,
2021-04-25,102025,98613,3180,,4888487,4436979,4001456,871046,435523,
2021-04-26,71008,69302,1558,,4959495,4506150,4069129,874042,437021,
2021-04-27,98523,95429,2900,,5058018,4601418,4161560,879716,439858,
2021-04-28,120590,115960,4437,,5178608,4717210,4272987,888446,444223,
2021-04-29,124502,119297,5051,,5303110,4836340,4387135,898410,449205,
2021-04-30,115838,110580,5015,,5418948,4946747,4492604,908286,454143,
2021-05-01,111319,107440,3656,,5530267,5054006,4596284,915444,457722,
2021-05-02,79151,76173,2865,,5609418,5130022,4669501,921042,460521,
2021-05-03,56797,55125,1599,,5666215,5184992,4722932,924120,462060,
2021-05-04,91940,88567,3285,,5758155,5273381,4808113,930536,465268,
2021-05-05,138011,133300,4619,,5896166,5406512,4936688,939648,469824,
2021-05-06,141845,136888,4819,,6038011,5543216,5068635,949162,474581,
2021-05-07,150305,145257,4840,,6188316,5688313,5208951,958724,479362,
2021-05-08,142482,137789,4441,,6330798,5825906,5342182,967448,483724,
2021-05-09,124822,121166,3485,,6455620,5946908,5459763,974290,487145,
2021-05-10,97818,95827,1885,,6553438,6042546,5553583,977926,488963,
2021-05-11,113553,108866,4499,,6666991,6151210,5657819,986782,493391,
2021-05-12,145065,138027,6887,,6812056,6289058,5788846,1000424,500212,
2021-05-13,142724,135329,7238,,6954780,6424212,5916836,1014752,507376,
2021-05-14,148884,138790,9922,,7103664,6562814,6045581,1034466,517233,
2021-05-15,159758,149706,9871,,7263422,6712333,6185304,1054058,527029,
2021-05-16,144374,136103,8064,,7407796,6848268,6313255,1070026,535013,
2021-05-17,114991,110891,3946,,7522787,6958970,6420087,1077766,538883,
2021-05-18,111358,100489,10666,,7634145,7059263,6509776,1098974,549487,
2021-05-19,149896,133478,16239,,7784041,7192589,6626937,1131304,565652,
2021-05-20,151592,131593,19778,,7935633,7323993,6738632,1170722,585361,
2021-05-21,165411,140900,24251,,8101044,7464712,6855177,1219070,609535,
2021-05-22,199470,172266,26976,,8300514,7636780,7000350,1272860,636430,
2021-05-23,139851,127475,12229,,8440365,7764077,7115480,1297194,648597,
2021-05-24,100305,93333,6827,,8540670,7857237,7201883,1310708,655354,
2021-05-25,90489,83000,7277,,8631159,7940074,7277510,1325128,662564,
2021-05-26,139804,113031,26509,,8770963,8052918,7363915,1378006,689003,
2021-05-27,152077,123056,28769,,8923040,8175817,7458114,1435406,717703,
2021-05-28,163887,132326,31252,,9086927,8307969,7559074,1497790,748895,
2021-05-29,153407,117142,36031,,9240334,8424961,7640091,1569740,784870,
2021-05-30,149739,119031,30479,,9390073,8543822,7728535,1630574,815287,
2021-05-31,99227,79832,19202,,9489300,8623484,7789059,1668850,834425,
2021-06-01,124221,90630,33252,,9613521,8713919,7846317,1735204,867602,
2021-06-02,145338,102167,42918,,9758859,8815905,7905454,1820902,910451,
2021-06-03,155391,99932,55178,,9914250,8915652,7950094,1931116,965558,
2021-06-04,181741,115550,65918,,10095991,9031003,7999615,2062776,1031388,
2021-06-05,172052,103449,68319,,10268043,9134254,8034632,2199244,1099622,
2021-06-06,163408,91881,71246,,10431451,9225957,8055159,2341596,1170798,
2021-06-07,119573,63065,56290,,10551024,9288825,8061812,2454026,1227013,
2021-06-08,161920,72469,89010,,10712944,9361105,8045162,2631886,1315943,
2021-06-09,181484,70821,110191,,10894428,9431749,8005696,2852106,1426053,
2021-06-10,185606,66438,118675,,11080034,9497984,7953347,3089274,1544637,
2021-06-11,204816,67532,136522,,11284850,9565330,7884253,3362154,1681077,
2021-06-12,199763,62692,136468,,11484613,9627840,7810387,3634906,1817453,
2021-06-13,190360,58906,130920,,11674973,9686571,7738278,3896586,1948293,
2021-06-14,137700,38702,98596,,11812673,9725077,7678293,4093568,2046784,
2021-06-15,189576,42630,146587,,12002249,9767488,7574214,4386548,2193274,
2021-06-16,206278,42445,163185,,12208527,9809737,7453381,4712712,2356356,
2021-06-17,210497,37956,171954,,12419024,9847478,7319260,5056436,2528218,
2021-06-18,217224,35376,181243,,12636248,9882664,7173295,5418738,2709369,
2021-06-19,215916,35509,179728,,12852164,9917967,7028982,5777970,2888985,
2021-06-20,186294,35583,150133,,13038458,9953352,6914342,6078020,3039010,
2021-06-21,120447,20838,99103,,13158905,9973995,6835974,6276042,3138021,
2021-06-22,204966,27534,176672,,13363871,10001335,6686751,6629168,3314584,
2021-06-23,230565,28647,201167,,13594436,10029782,6514139,7031286,3515643,
2021-06-24,227733,26692,200275,,13822169,10056278,6340470,7431616,3715808,
2021-06-25,251147,28007,222387,,14073316,10084083,6146007,7876152,3938076,
2021-06-26,261331,30023,230598,,14334647,10113880,5945347,8337066,4168533,
2021-06-27,205029,27810,176611,,14539676,10141508,5796474,8690068,4345034,
2021-06-28,199266,20959,177738,,14738942,10162269,5639622,9045294,4522647,
2021-06-29,250135,24505,224892,,14989077,10186533,5439148,9494770,4747385,
2021-06-30,275565,24185,250811,,15264642,10210515,5212448,9996134,4998067,
2021-07-01,271987,25315,246116,,15536629,10235612,4991568,10488088,5244044,
2021-07-02,144742,11597,132913,,15681371,10247035,4870180,10753710,5376855,
2021-07-03,216915,19940,196744,,15898286,10266753,4693303,11146900,5573450,
2021-07-04,196243,19476,176540,,16094529,10286043,4536172,11499742,5749871,
2021-07-05,148733,12453,136135,,16243262,10298306,4412428,11771756,5885878,
2021-07-06,220055,20003,199833,,16463317,10318093,4232528,12171130,6085565,
2021-07-07,246636,22976,223413,,16709953,10340843,4032013,12617660,6308830,
2021-07-08,231237,21375,209646,,16941190,10362012,3843671,13036682,6518341,
2021-07-09,227025,21520,205333,,17168215,10383330,3659788,13447084,6723542,
2021-07-10,209081,20546,188377,,17377296,10403672,3491890,13823564,6911782,
2021-07-11,171692,17590,153974,,17548988,10421061,3355452,14131218,7065609,
2021-07-12,123139,11445,111593,,17672127,10432317,3255252,14354130,7177065,
2021-07-13,178540,19051,159345,,17850667,10451146,3114891,14672510,7336255,
2021-07-14,180054,19309,160586,,18030721,10470240,2973562,14993356,7496678,
2021-07-15,167227,19596,147454,,18197948,10489625,2845657,15287936,7643968,
2021-07-16,169387,19926,149306,,18367335,10509349,2716228,15586242,7793121,
2021-07-17,173039,20283,152625,,18540374,10529383,2583829,15891108,7945554,
2021-07-18,133653,15946,117568,,18674027,10545145,2482171,16125948,8062974,
2021-07-19,91994,10423,81463,,18766021,10555355,2411093,16288524,8144262,
2021-07-20,133559,16965,116539,,18899580,10572080,2311455,16521250,8260625,
2021-07-21,140096,16988,123037,,19039676,10588853,2205353,16767000,8383500,
2021-07-22,125658,17674,107844,,19165334,10606303,2115136,16982334,8491167,
2021-07-23,120298,17005,103084,,19285632,10623067,2029015,17188104,8594052,
2021-07-24,126712,18340,108135,,19412344,10641204,1939180,17404048,8702024,
2021-07-25,103663,14874,88658,,19516007,10655854,1865353,17581002,8790501,
2021-07-26,66703,9896,56712,,19582710,10665533,1818500,17694066,8847033,
2021-07-27,92407,15331,76916,,19675117,10680603,1756871,17847464,8923732,
2021-07-28,93964,16479,77415,,19769081,10696847,1695891,18001912,9000956,
2021-07-29,89423,16716,72545,,19858504,10713331,1640018,18146626,9073313,
2021-07-30,84089,16112,67863,,19942593,10729215,1588227,18281976,9140988,
2021-07-31,83888,15742,67998,,20026481,10744739,1535943,18417592,9208796,
2021-08-01,61891,11329,50376,,20088372,10755842,1496861,18517962,9258981,
2021-08-02,42509,7428,34958,,20130881,10763072,1469299,18587546,9293773,
2021-08-03,33314,5968,27174,,20164195,10768807,1448070,18641474,9320737,
2021-08-04,61342,12383,48767,,20225537,10780955,1411649,18738612,9369306,
2021-08-05,59479,12564,46764,,20285016,10793311,1377405,18831812,9415906,
2021-08-06,56041,11865,43962,,20341057,10804916,1345277,18919278,9459639,
2021-08-07,62391,12139,50057,,20403448,10816794,1307316,19018956,9509478,
2021-08-08,48720,9289,39239,,20452168,10825855,1277343,19097024,9548512,
2021-08-09,30869,5943,24748,,20483037,10831584,1258511,19146146,9573073,
2021-08-10,49286,10524,38457,,20532323,10841828,1230544,19222568,9611284,
2021-08-11,48736,10771,37714,,20581059,10852352,1203570,19297564,9648782,
2021-08-12,49274,11212,37828,,20630333,10863313,1176912,19372802,9686401,
2021-08-13,49652,11743,37634,,20679985,10874815,1150991,19447648,9723824,
2021-08-14,51246,12144,38890,,20731231,10886709,1124219,19524980,9762490,
2021-08-15,41794,9864,31700,,20773025,10896371,1102353,19588036,9794018,
2021-08-16,26754,6194,20408,,20799779,10902342,1088113,19628458,9814229,
2021-08-17,40523,11067,29187,,20840302,10913159,1069969,19686380,9843190,
2021-08-18,41918,11983,29690,,20882220,10924900,1052230,19745340,9872670,
2021-08-19,45915,16547,29103,,20928135,10941196,1039646,19803100,9901550,
2021-08-20,46472,16309,29750,,20974607,10957249,1026178,19862142,9931071,
2021-08-21,47972,15154,32451,,21022579,10972143,1008848,19926590,9963295,
2021-08-22,34415,10818,23324,,21056994,10982714,996318,19972792,9986396,
2021-08-23,23229,7008,16002,,21080223,10989487,987303,20004368,10002184,
2021-08-24,37663,13380,23825,,21117886,11002613,976835,20051556,10025778,
2021-08-25,41380,14430,26337,,21159266,11016787,964909,20103756,10051878,
2021-08-26,39294,13563,24986,,21198560,11030074,953451,20153246,10076623,
2021-08-27,37693,12955,23692,,21236253,11042788,942687,20200202,10100101,
2021-08-28,40146,13432,25532,,21276399,11055941,930563,20250756,10125378,
2021-08-29,30571,10257,19948,,21306970,11065966,920853,20290226,10145113,
2021-08-30,18245,6144,11848,,21325215,11071862,915120,20313484,10156742,
2021-08-31,32725,11943,19626,,21357940,11083537,907409,20352256,10176128,
2021-09-01,36271,12959,21966,,21394211,11096263,898386,20395754,10197877,
2021-09-02,37797,15651,19678,,21432008,11111662,894334,20434656,10217328,
2021-09-03,46908,21105,22449,,21478916,11132518,892971,20479094,10239547,
2021-09-04,46898,20596,24784,,21525814,11152868,888760,20528216,10264108,
2021-09-05,33097,14211,18589,,21558911,11166835,884362,20564946,10282473,
2021-09-06,21730,9494,12043,,21580641,11176080,881796,20588568,10294284,
2021-09-07,15023,6733,8104,,21595664,11182556,880408,20604296,10302148,
2021-09-08,41159,17118,20941,,21636823,11199410,876567,20645686,10322843,
2021-09-09,41479,16993,19688,,21678302,11216126,873847,20684558,10342279,
2021-09-10,39683,15524,19021,,21717985,11231387,870332,20722110,10361055,
2021-09-11,42401,15944,23344,,21760386,11247052,862911,20768282,10384141,
2021-09-12,29990,11537,17882,,21790376,11258295,856536,20803518,10401759,
2021-09-13,16098,6408,9189,,21806474,11264469,853740,20821458,10410729,
2021-09-14,29925,11567,15301,,21836399,11275734,849979,20851510,10425755,
2021-09-15,39290,14027,19427,,21875689,11289501,844563,20889876,10444938,
2021-09-16,39364,13995,19253,,21915053,11303261,839282,20927958,10463979,
2021-09-17,38954,13621,19352,,21954007,11316639,833539,20966200,10483100,
2021-09-18,41274,14093,23557,,21995281,11330459,824054,21012810,10506405,
2021-09-19,30675,10833,18989,,22025956,11341033,815885,21050296,10525148,
2021-09-20,16738,6101,10179,,22042694,11346880,811784,21070192,10535096,
2021-09-21,31372,11218,16998,,22074066,11357833,805988,21103690,10551845,
2021-09-22,41824,14820,22933,,22115890,11372357,797854,21149006,10574503,
2021-09-23,47240,16141,26036,,22163130,11388233,787940,21200586,10600293,
2021-09-24,46339,15643,26672,,22209469,11403616,776892,21253448,10626724,
2021-09-25,48215,15260,29958,,22257684,11418623,762175,21312896,10656448,
2021-09-26,37522,12426,24499,,22295206,11430774,750081,21361386,10680693,
2021-09-27,19166,6532,12327,,22314372,11437052,744270,21385564,10692782,
2021-09-28,30974,11297,17894,,22345346,11448090,737661,21420858,10710429,
2021-09-29,37901,12478,21737,,22383247,11460297,728382,21463830,10731915,
2021-09-30,37360,11661,21382,,22420607,11471699,718642,21506114,10753057,
2021-10-01,30892,9812,18421,,22451499,11481284,710020,21542528,10771264,
2021-10-02,37151,11161,23594,,22488650,11492175,697569,21589212,10794606,
2021-10-03,27212,8167,18326,,22515862,11500101,687397,21625408,10812704,
2021-10-04,14870,4748,9803,,22530732,11504602,682324,21644556,10822278,
2021-10-05,26856,8604,15890,,22557588,11512945,675023,21675844,10837922,
2021-10-06,31685,9643,18525,,22589273,11522329,666133,21712392,10856196,
2021-10-07,30364,9405,17126,,22619637,11531483,658399,21746168,10873084,
2021-10-08,32854,10746,18862,,22652491,11541958,650269,21783378,10891689,
2021-10-09,34162,10671,21028,,22686653,11552366,639898,21824936,10912468,
2021-10-10,23424,7662,15092,,22710077,11559777,632456,21854642,10927321,
2021-10-11,12010,3840,7871,,22722087,11563367,628409,21869916,10934958,
2021-10-12,5129,1633,3278,,22727216,11564722,626749,21875946,10937973,
2021-10-13,29128,9194,18103,,22756344,11573626,617824,21911604,10955802,
2021-10-14,29029,8905,17759,,22785373,11582255,608960,21946590,10973295,
2021-10-15,29112,8833,18177,,22814485,11590825,599603,21982444,10991222,
2021-10-16,31147,8989,19874,,22845632,11599523,588706,22021634,11010817,
2021-10-17,23725,7264,15388,,22869357,11606533,580569,22051928,11025964,
2021-10-18,12315,3747,8155,,22881672,11609999,576149,22067700,11033850,
2021-10-19,21293,6632,12647,,22902965,11616348,570121,22092454,11046227,
2021-10-20,25680,7542,14929,,22928645,11623643,562721,22121844,11060922,
2021-10-21,23193,6687,13040,,22951838,11630061,556357,22147408,11073704,
2021-10-22,26142,7319,15127,,22977980,11637057,548533,22177048,11088524,
2021-10-23,28197,7607,17167,,23006177,11644402,538966,22210872,11105436,
2021-10-24,19364,5729,12609,,23025541,11649875,532074,22235602,11117801,
2021-10-25,9933,2710,6477,,23035474,11652316,528299,22248034,11124017,
2021-10-26,18936,5396,11113,,23054410,11657434,522573,22269722,11134861,
2021-10-27,22872,6082,13225,,23077282,11663261,515416,22295690,11147845,
2021-10-28,22318,5793,12650,,23099600,11668766,508548,22320436,11160218,
2021-10-29,22827,5733,13060,,23122427,11674197,501206,22345982,11172991,
2021-10-30,24136,6051,14628,,23146563,11679976,492617,22374718,11187359,
2021-10-31,16494,4597,10611,,23163057,11684279,486598,22395362,11197681,
2021-11-01,7880,2085,5058,,23170937,11686084,483612,22404944,11202472,
2021-11-02,15634,4365,7750,,23186571,11690160,480216,22419888,11209944,
2021-11-03,18638,5070,9610,,23205209,11694927,475666,22438522,11219261,
2021-11-04,19518,4876,10042,,23224727,11699527,470485,22458084,11229042,
2021-11-05,21477,4405,9527,,23246204,11703643,465349,22476588,11238294,
2021-11-06,25345,5211,12158,,23271549,11708585,458385,22500400,11250200,
2021-11-07,21464,4027,8932,,23293013,11712331,453468,22517726,11258863,
2021-11-08,11996,2111,4736,,23305009,11714147,450827,22526640,11263320,
2021-11-09,24142,3855,7658,,23329151,11717681,447014,22541334,11270667,
2021-11-10,28492,4510,9007,,23357643,11721915,442503,22558824,11279412,
2021-11-11,28784,4312,9109,,23386427,11725930,437697,22576466,11288233,
2021-11-12,26760,4167,8249,,23413187,11729806,433601,22592410,11296205,
2021-11-13,34324,5084,11417,,23447511,11734584,427259,22614650,11307325,
2021-11-14,23232,3901,8614,,23470743,11738222,422539,22631366,11315683,
2021-11-15,12705,2187,4496,,23483448,11740149,420222,22639854,11319927,
2021-11-16,26195,3935,7492,,23509643,11743828,416661,22654334,11327167,
2021-11-17,31188,4046,7835,,23540831,11747592,412862,22669460,11334730,
2021-11-18,32519,3868,7537,,23573350,11751153,409179,22683948,11341974,
2021-11-19,35490,3866,7761,,23608840,11754718,405272,22698892,11349446,
2021-11-20,40126,4384,8826,,23648966,11758820,400821,22715998,11357999,
2021-11-21,28133,3440,6957,,23677099,11761998,397290,22729416,11364708,
2021-11-22,14903,1951,3897,,23692002,11763672,395338,22736668,11368334,
2021-11-23,33071,3280,6020,,23725073,11766672,392590,22748164,11374082,
2021-11-24,42682,3762,6820,,23767755,11770130,389521,22761218,11380609,
2021-11-25,46054,3936,6579,,23813809,11773791,386875,22773832,11386916,
2021-11-26,52875,11348,6621,,23866684,11784868,391595,22786546,11393273,
2021-11-27,63533,22361,7043,,23930217,11806948,406903,22800090,11400045,
2021-11-28,51469,27742,5324,,23981686,11834398,429309,22810178,11405089,
2021-11-29,33533,18933,2888,,24015219,11853070,445343,22815454,11407727,
2021-11-30,56062,20693,5145,,24071281,11873482,460881,22825202,11412601,
2021-12-01,69557,26244,5648,,24140838,11899420,481463,22835914,11417957,
2021-12-02,71646,26489,5042,,24212484,11925611,502897,22845428,11422714,
2021-12-03,73438,25101,5176,,24285922,11950416,522816,22855200,11427600,
2021-12-04,81172,27786,6083,47283,24367094,11977908,544510,,11433398,807815
2021-12-05,62645,31934,4420,26270,24429739,12009547,572016,,11437531,833981
2021-12-06,38633,19145,2715,16758,24468372,12028402,588439,,11439963,850661
2021-12-07,60305,14853,4487,40951,24528677,12042983,598795,,11444188,891538
2021-12-08,73460,19058,4686,49713,24602137,12061764,613157,,11448607,941173
2021-12-09,74516,18280,4349,51867,24676653,12079735,627080,,11452655,992955
2021-12-10,77518,17590,4662,55254,24754171,12097044,640003,,11457041,1048128
2021-12-11,83210,20410,5845,56943,24837381,12117165,654554,,11462611,1104985
2021-12-12,60771,22700,4164,33864,24898152,12139585,673084,,11466501,1138760
2021-12-13,34940,11603,2415,20899,24933092,12150891,682262,,11468629,1159564
2021-12-14,101994,9002,3877,89071,25035086,12159582,687372,,11472210,1248515
2021-12-15,127709,12430,4516,110725,25162795,12171708,695276,,11476432,1359140
2021-12-16,139378,12470,4257,122634,25302173,12183892,703479,,11480413,1481675
2021-12-17,159194,12408,4527,142237,25461367,12196025,711351,,11484674,1623815
2021-12-18,175605,13523,4930,157105,25636972,12209254,719932,,11489322,1780825
2021-12-19,140451,18161,3937,118315,25777423,12227114,734148,,11492966,1899029
2021-12-20,106828,10305,2748,93727,25884251,12237151,741695,,11495456,1992658
2021-12-21,215406,12966,4325,198093,26099657,12249801,750329,,11499472,2190630
2021-12-22,237275,14429,5207,217755,26336932,12263930,759537,,11504393,2408267
2021-12-23,257801,11734,5098,240870,26594733,12275358,766167,,11509191,2649031
2021-12-24,223652,9466,4580,209538,26818385,12284527,771049,,11513478,2858453
2021-12-25,89743,3893,2515,83347,26908128,12288145,772422,,11515723,2941693
2021-12-26,11901,389,360,11142,26920029,12288242,772443,,11515799,2952705
2021-12-27,46950,1491,1116,44312,26966979,12289488,772811,,11516677,2996897
2021-12-28,144794,6101,4013,134617,27111773,12295295,774888,,11520407,3131383
2021-12-29,175483,9378,4591,161445,27287256,12304377,779671,,11524706,3292700
2021-12-30,200090,10138,5359,184550,27487346,12314212,784435,,11529777,3477116
2021-12-31,195229,10010,5814,179152,27682575,12323933,788622,,11535311,3656142
2022-01-01,96965,5384,3888,87366,27779540,12329008,790110,,11538898,3743359
2022-01-02,19458,945,934,17449,27798998,12329662,790112,,11539550,3760662
2022-01-03,88262,4774,4596,78811,27887260,12334126,790282,,11543844,3839320
2022-01-04,146391,6004,5328,135020,28033651,12339802,790945,,11548857,3974184
2022-01-05,177536,7638,7305,162419,28211187,12347086,791267,,11555819,4136443
2022-01-06,191567,7218,6792,177030,28402754,12353985,791682,,11562303,4313318
2022-01-07,191321,7972,7012,175523,28594075,12361613,792630,,11568983,4488668
2022-01-08,181710,8635,6650,165236,28775785,12369916,794602,,11575314,4653748
2022-01-09,131121,9872,7196,113960,28906906,12379466,797273,,11582193,4767548
2022-01-10,90569,5108,4490,80840,28997475,12384251,797881,,11586370,4848235
2022-01-11,138919,6169,6586,125458,29136394,12390073,797451,,11592622,4973503
2022-01-12,157058,8171,8064,138700,29293452,12397915,797553,,11600362,5112035
2022-01-13,162704,9217,9223,141553,29456156,12406770,797533,,11609237,5253405
2022-01-14,159917,10759,10393,136074,29616073,12417167,797894,,11619273,5389281
2022-01-15,161222,11017,11679,135892,29777295,12427812,797221,,11630591,5524980
2022-01-16,109796,9297,9680,89458,29887091,12436747,796831,,11639916,5614220
2022-01-17,65795,5942,6569,52642,29952886,12442353,796194,,11646159,5666677
2022-01-18,36137,2011,2140,31163,29989023,12444009,796054,,11647955,5697644
2022-01-19,101345,5592,6726,85967,30090368,12449201,794902,,11654299,5783384
2022-01-20,103626,6330,7012,85746,30193994,12455147,794212,,11660935,5868907
2022-01-21,102125,6237,8060,82516,30296119,12460980,792375,,11668605,5951195
2022-01-22,102608,8729,12078,78124,30398727,12469320,789019,,11680301,6029091
2022-01-23,76716,7314,14001,54802,30475443,12476291,782325,,11693966,6083671
2022-01-24,42271,3199,7938,30746,30517714,12479126,777568,,11701558,6114210
2022-01-25,62588,3764,8377,48126,30580302,12482508,772940,,11709568,6162116
2022-01-26,77902,4920,13172,55699,30658204,12487051,764683,,11722368,6217573
2022-01-27,78094,4900,13252,56056,30736298,12491579,756321,,11735258,6273392
2022-01-28,77306,4680,13681,53906,30813604,12495901,747307,,11748594,6327079
2022-01-29,84841,5535,17720,58122,30898445,12501072,735115,,11765957,6384956
2022-01-30,66527,5030,20638,40162,30964972,12505760,719493,,11786267,6424893
2022-01-31,34761,2180,9891,22351,30999733,12507621,711773,,11795848,6447055
2022-02-01,51363,3271,9665,36532,31051096,12510539,705369,,11805170,6483362
2022-02-02,57734,3852,12408,38686,31108830,12514060,696798,,11817262,6521848
2022-02-03,52594,3613,11516,34305,31161424,12517296,688883,,11828413,6555902
2022-02-04,43109,2948,10572,27289,31204533,12519932,681249,,11838683,6582996
2022-02-05,58738,3752,14476,37566,31263271,12523352,670513,,11852839,6620349
2022-02-06,49870,3643,16121,29575,31313141,12526672,658030,,11868642,6649700
2022-02-07,23248,1695,7812,13448,31336389,12528041,651900,,11876141,6662924
2022-02-08,33417,2364,7257,21977,31369806,12530075,647000,,11883075,6684668
2022-02-09,38902,2789,8925,24414,31408708,12532505,640858,,11891647,6708830
2022-02-10,37557,2767,8844,22560,31446265,12534935,634777,,11900158,6731159
2022-02-11,39455,2725,10297,23007,31485720,12537312,627195,,11910117,6753927
2022-02-12,42062,2961,11462,25321,31527782,12539939,618683,,11921256,6779024
2022-02-13,36336,2806,13148,19944,31564118,12542458,608338,,11934120,6798770
2022-02-14,16988,1177,6125,9475,31581106,12543360,603382,,11939978,6808045
2022-02-15,19380,1391,4760,11884,31600486,12544427,600003,,11944424,6819702
2022-02-16,26039,1767,7742,14952,31626525,12545897,594024,,11951873,6834453
2022-02-17,26779,1685,7530,14987,31653304,12547227,588170,,11959057,6849185
2022-02-18,23965,1357,6620,13683,31677269,12548267,582895,,11965372,6862659
2022-02-19,37847,1904,8344,26057,31715116,12549838,576450,,11973388,6888473
2022-02-20,32588,1500,7969,22809,31747704,12551037,569973,,11981064,6911077
2022-02-21,17507,914,3679,12760,31765211,12551655,567199,,11984456,6923625
2022-02-22,9115,431,1555,6958,31774326,12551796,566070,,11985726,6930372
2022-02-23,25354,1328,4803,17300,31799680,12552814,562588,,11990226,6947436
2022-02-24,24587,1403,5234,15488,31824267,12553895,558752,,11995143,6962681
2022-02-25,23115,1397,5138,14510,31847382,12554998,555004,,11999994,6976965
2022-02-26,25243,1386,5912,16560,31872625,12556074,550471,,12005603,6993299
2022-02-27,26967,1372,7375,17706,31899592,12557177,544457,,12012720,7010810
2022-02-28,10130,594,2531,6745,31909722,12557518,542512,,12015006,7017372
2022-03-01,13207,950,3152,8168,31922929,12558163,540300,,12017863,7025323
2022-03-02,15423,1165,3579,9622,31938352,12559066,537879,,12021187,7034767
2022-03-03,14308,1081,3229,8690,31952660,12559835,535723,,12024112,7043226
2022-03-04,14486,993,3446,8322,31967146,12560507,533266,,12027241,7051295
2022-03-05,18544,1277,5001,11190,31985690,12561474,529531,,12031943,7062261
2022-03-06,16524,1090,5526,9610,32002214,12562283,525089,,12037194,7071664
2022-03-07,5952,469,1862,3509,32008166,12562467,523689,,12038778,7074956
2022-03-08,7376,702,1947,4160,32015542,12562891,522437,,12040454,7078917
2022-03-09,11180,909,2741,6407,32026722,12563524,520599,,12042925,7085122
2022-03-10,12774,1047,3261,6843,32039496,12564294,518378,,12045916,7091752
2022-03-11,12896,906,3412,6867,32052392,12564911,515864,,12049047,7098403
2022-03-12,14696,1049,4192,8310,32067088,12565688,512718,,12052970,7106509
2022-03-13,14757,1091,5000,8336,32081845,12566488,508805,,12057683,7114608
2022-03-14,6337,451,2230,3500,32088182,12566667,507023,,12059644,7117894
2022-03-15,10205,793,2628,5975,32098387,12567169,505176,,12061993,7123654
2022-03-16,13074,937,3671,6954,32111461,12567816,502439,,12065377,7130377
2022-03-17,13204,1050,3966,6759,32124665,12568578,499516,,12069062,7136916
2022-03-18,11914,917,3149,6433,32136579,12569192,497274,,12071918,7143125
2022-03-19,14444,1005,4163,7903,32151023,12569917,494114,,12075803,7150809
2022-03-20,11756,993,3961,6374,32162779,12570638,491141,,12079497,7156975
2022-03-21,5060,416,1590,2814,32167839,12570795,489963,,12080832,7159586
2022-03-22,6718,552,1560,3894,32174557,12571060,488949,,12082111,7163265
2022-03-23,9979,789,2304,5197,32184536,12571533,487431,,12084102,7168221
2022-03-24,9299,723,2377,4615,32193835,12571992,485768,,12086224,7172632
2022-03-25,9238,782,2159,4757,32203073,12572511,484383,,12088128,7177177
2022-03-26,10936,938,2838,5507,32214009,12573172,482481,,12090691,7182465
2022-03-27,10231,912,3539,5302,32224240,12573824,479850,,12093974,7187556
2022-03-28,3586,322,1109,1989,32227826,12573905,479060,,12094845,7189350
2022-03-29,5353,500,1217,2693,32233179,12574120,478337,,12095783,7191821
2022-03-30,7860,748,1841,4124,32241039,12574588,477239,,12097349,7195719
2022-03-31,8658,690,1926,4415,32249697,12574989,475997,,12098992,7199912
2022-04-01,9322,803,1919,4890,32259019,12575500,474872,,12100628,7204563
2022-04-02,10449,887,2217,5573,32269468,12576100,473530,,12102570,7209919
2022-04-03,9213,880,2569,5067,32278681,12576723,471835,,12104888,7214784
2022-04-04,4206,388,1006,2408,32282887,12576849,471214,,12105635,7216988
2022-04-05,6085,601,1039,3054,32288972,12577109,470770,,12106339,7219766
2022-04-06,8388,717,1482,4384,32297360,12577535,470000,,12107535,7223923
2022-04-07,10358,733,1691,4839,32307718,12577968,469037,,12108931,7228519
2022-04-08,24001,812,1586,4837,32331719,12578502,468257,,12110245,7233140
2022-04-09,30505,972,1979,5894,32362224,12579176,467241,,12111935,7238811
2022-04-10,24873,976,2394,5336,32387097,12579893,465817,,12114076,7243945
2022-04-11,12578,386,877,2432,32399675,12580028,465322,,12114706,7246175
2022-04-12,28139,693,1024,3538,32427814,12580417,464984,,12115433,7249480
2022-04-13,37787,853,1562,4928,32465601,12580971,464271,,12116700,7254178
2022-04-14,37913,764,1620,4916,32503514,12581421,463412,,12118009,7258840
2022-04-15,43405,1234,2104,6726,32546919,12582357,462538,,12119819,7265329
2022-04-16,8099,357,651,1744,32555018,12582454,462242,,12120212,7266857
2022-04-17,21028,871,1925,4319,32576046,12583041,461181,,12121860,7270953
2022-04-18,5466,306,465,1290,32581512,12583060,461017,,12122043,7272002
2022-04-19,22663,615,775,3103,32604175,12583392,460848,,12122544,7274885
2022-04-20,40348,1063,1404,4620,32644523,12584129,460504,,12123625,7279241
2022-04-21,38763,944,1600,4685,32683286,12584777,459839,,12124938,7283692
2022-04-22,35643,1018,1438,4271,32718929,12585523,459412,,12126111,7287745
2022-04-23,34663,1005,1742,4715,32753592,12586244,458672,,12127572,7292221
2022-04-24,20819,1021,1891,3777,32774411,12587015,457799,,12129216,7295804
2022-04-25,8300,453,691,1707,32782711,12587199,457560,,12129639,7297295
2022-04-26,24625,734,948,3145,32807336,12587641,457340,,12130301,7300203
2022-04-27,33608,955,1373,3940,32840944,12588318,456914,,12131404,7303925
2022-04-28,32847,930,1421,3931,32873791,12588975,456414,,12132561,7307633
2022-04-29,32068,1098,1383,3910,32905859,12589775,456122,,12133653,7311314
2022-04-30,30296,926,1542,4025,32936155,12590403,455499,,12134904,7315103
2022-05-01,16759,770,1582,2970,32952914,12590874,454682,,12136192,7317829
2022-05-02,5937,309,526,1099,32958851,12590887,454461,,12136426,7318701
2022-05-03,20936,589,835,2348,32979787,12591171,454209,,12136962,7320810
2022-05-04,29418,800,1093,3290,33009205,12591661,453911,,12137750,7323851
2022-05-05,29102,871,1167,3125,33038307,12592219,453605,,12138614,7326731
2022-05-06,29102,1147,1287,2988,33067409,12593077,453460,,12139617,7329492
2022-05-07,28497,871,1267,3113,33095906,12593658,453059,,12140599,7332381
2022-05-08,16003,895,1310,2324,33111909,12594296,452642,,12141654,7334504
2022-05-09,5898,293,474,944,33117807,12594322,452454,,12141868,7335238
2022-05-10,21232,698,724,2120,33139039,12594702,452421,,12142281,7337098
2022-05-11,28957,838,1088,2656,33167996,12595208,452167,,12143041,7339483
2022-05-12,28249,799,1088,2517,33196245,12595710,451874,,12143836,7341759
2022-05-13,27599,879,1119,2469,33223844,12596278,451629,,12144649,7343971
2022-05-14,25699,807,1101,2612,33249543,12596772,451328,,12145444,7346329
2022-05-15,14855,751,1278,2059,33264398,12597251,450794,,12146457,7348169
2022-05-16,6387,326,533,1048,33270785,12597339,450583,,12146756,7349030
2022-05-17,19607,590,781,1743,33290392,12597613,450385,,12147228,7350524
2022-05-18,26549,876,1101,2279,33316941,12598224,450155,,12148069,7352587
2022-05-19,24447,684,1159,2164,33341388,12598641,449673,,12148968,7354534
2022-05-20,24273,801,1141,2218,33365661,12599171,449329,,12149842,7356532
2022-05-21,22408,692,1168,2351,33388069,12599553,448844,,12150709,7358640
2022-05-22,10565,549,895,1489,33398634,12599841,448493,,12151348,7359912
2022-05-23,4577,242,465,796,33403211,12599823,448268,,12151555,7360499
2022-05-24,2630,120,183,442,33405841,12599687,448203,,12151484,7360730
2022-05-25,19374,655,952,1955,33425215,12600075,447896,,12152179,7362474
2022-05-26,20660,665,953,1915,33445875,12600465,447602,,12152863,7364166
2022-05-27,21769,819,1063,2076,33467644,12600995,447355,,12153640,7366008
2022-05-28,19424,723,1169,2152,33487068,12601447,446906,,12154541,7367945
2022-05-29,12115,761,1285,1727,33499183,12601973,446375,,12155598,7369480
2022-05-30,4581,311,550,752,33503764,12602037,446132,,12155905,7370034
2022-05-31,13560,574,756,1669,33517324,12602309,445944,,12156365,7371463
2022-06-01,16619,704,976,1879,33533943,12602710,445670,,12157040,7373089
2022-06-02,14616,557,869,1680,33548559,12602955,445351,,12157604,7374528
2022-06-03,16112,699,1096,1818,33564671,12603371,444948,,12158423,7376124
2022-06-04,13330,647,1168,1846,33578001,12603760,444422,,12159338,7377768
2022-06-05,7871,587,1113,1432,33585872,12604098,443892,,12160206,7379008
2022-06-06,3295,207,446,641,33589167,12604056,443650,,12160406,7379447
2022-06-07,11234,477,729,1378,33600401,12604233,443393,,12160840,7380581
2022-06-08,14073,670,1014,1612,33614474,12604642,443044,,12161598,7381973
2022-06-09,13390,664,929,1679,33627864,12605018,442774,,12162244,7383420
2022-06-10,13860,686,1071,1700,33641724,12605416,442380,,12163036,7384890
2022-06-11,12989,616,1031,1849,33654713,12605746,441963,,12163783,7386516
2022-06-12,8100,643,1238,1504,33662813,12606130,441364,,12164766,7387813
2022-06-13,3193,284,423,714,33666006,12606146,441220,,12164926,7388317
2022-06-14,10135,514,668,1266,33676141,12606371,441060,,12165311,7389345
2022-06-15,13514,475,834,1622,33689655,12606549,440699,,12165850,7390728
2022-06-16,12554,498,858,1620,33702209,12606740,440333,,12166407,7392101
2022-06-17,11695,480,819,1653,33713904,12606931,439987,,12166944,7393516
2022-06-18,11457,438,876,1862,33725361,12607098,439546,,12167552,7395154
2022-06-19,7007,485,900,1420,33732368,12607329,439130,,12168199,7396358
2022-06-20,2287,147,301,643,33734655,12607252,438970,,12168282,7396831
2022-06-21,9551,359,617,1387,33744206,12607324,438707,,12168617,7397970
2022-06-22,13623,407,730,1709,33757829,12607459,438377,,12169082,7399454
2022-06-23,13709,404,777,1684,33771538,12607596,438001,,12169595,7400924
2022-06-24,15371,438,813,1675,33786909,12607774,437622,,12170152,7402384
2022-06-25,14476,427,854,1714,33801385,12607939,437184,,12170755,7403888
2022-06-26,8161,432,886,1280,33809546,12608109,436723,,12171386,7404951
2022-06-27,3214,171,365,594,33812760,12608030,436525,,12171505,7405337
2022-06-28,9620,369,560,1226,33822380,12608112,436330,,12171782,7406329
2022-06-29,13329,416,733,1635,33835709,12608237,436011,,12172226,7407724
2022-06-30,12237,482,848,1581,33847946,12608434,435643,,12172791,7409071
2022-07-01,13043,550,972,1949,33860989,12608726,435216,,12173510,7410814
2022-07-02,1621,111,119,366,33862610,12608561,435206,,12173355,7410948
2022-07-03,5168,260,495,964,33867778,12608562,434962,,12173600,7411695
2022-07-04,2758,132,279,615,33870536,12608447,434814,,12173633,7412113
2022-07-05,11151,372,601,1577,33881687,12608521,434577,,12173944,7413442
2022-07-06,15963,549,860,2011,33897650,12608773,434260,,12174513,7415209
2022-07-07,15672,521,832,1928,33913322,12609005,433948,,12175057,7416884
2022-07-08,17894,555,871,2248,33931216,12609255,433631,,12175624,7418883
2022-07-09,14154,452,597,1852,33945370,12609428,433485,,12175943,7420497
2022-07-10,8753,475,755,1506,33954123,12609653,433204,,12176449,7421795
2022-07-11,4095,199,331,871,33958218,12609585,433069,,12176516,7422444
2022-07-12,12113,411,527,1659,33970331,12609697,432948,,12176749,7423849
2022-07-13,16724,565,773,2144,33987055,12609964,432734,,12177230,7425748
2022-07-14,16864,483,677,2024,34003919,12610141,432529,,12177612,7427532
2022-07-15,28904,598,825,2187,34032823,12610438,432301,,12178137,7429477
2022-07-16,30307,586,775,2332,34063130,12610710,432104,,12178606,7431556
2022-07-17,22939,539,637,1895,34086069,12611010,432003,,12179007,7433255
2022-07-18,11398,189,255,857,34097467,12610930,431932,,12178998,7433889
2022-07-19,28965,593,592,2142,34126432,12611247,431930,,12179317,7435799
2022-07-20,37650,839,925,2599,34164082,12611805,431839,,12179966,7438159
2022-07-21,36372,734,812,2813,34200454,12612250,431754,,12180496,7440730
2022-07-22,35814,824,896,2690,34236268,12612784,431675,,12181109,7443182
2022-07-23,35163,821,915,2839,34271431,12613289,431573,,12181716,7445764
2022-07-24,21745,599,806,1780,34293176,12613625,431363,,12182262,7447319
2022-07-25,11938,307,311,1083,34305114,12613646,431354,,12182292,7448170
2022-07-26,26103,621,604,2218,34331217,12613982,431370,,12182612,7450144
2022-07-27,32484,810,850,2656,34363701,12614533,431328,,12183205,7452588
2022-07-28,31547,724,884,2612,34395248,12614958,431164,,12183794,7454947
2022-07-29,30007,1791,875,2652,34425255,12616455,432076,,12184379,7457347
2022-07-30,25845,2526,747,2443,34451100,12618699,433853,,12184846,7459556
2022-07-31,14321,1067,541,1573,34465421,12619495,434375,,12185120,7460900
2022-08-01,5918,337,223,685,34471339,12619572,434487,,12185085,7461362
2022-08-02,4492,307,138,609,34475831,12619608,434652,,12184956,7461748
2022-08-03,22955,2640,742,2244,34498786,12621971,436546,,12185425,7463756
2022-08-04,22246,2481,684,2138,34521032,12624123,438337,,12185786,7465629
2022-08-05,21804,2755,747,2074,34542836,12626596,440337,,12186259,7467474
2022-08-06,19658,2875,657,2003,34562494,12629158,442549,,12186609,7469217
2022-08-07,12712,2236,621,1425,34575206,12631118,444158,,12186960,7470423
2022-08-08,4766,570,188,603,34579972,12631399,444533,,12186866,7470788
2022-08-09,14025,1466,560,1603,34593997,12632576,445433,,12187143,7472149
2022-08-10,19137,2363,717,1999,34613134,12634664,447077,,12187587,7473918
2022-08-11,17085,2042,718,1860,34630219,12636430,448399,,12188031,7475545
2022-08-12,16989,2049,735,1853,34647208,12638190,449712,,12188478,7477169
2022-08-13,15961,2227,766,1810,34663169,12640130,451171,,12188959,7478736
2022-08-14,9534,1621,620,1088,34672703,12641460,452168,,12189292,7479587
2022-08-15,3876,388,271,482,34676579,12641591,452282,,12189309,7479859
2022-08-16,10812,1076,517,1356,34687391,12642364,452839,,12189525,7480962
2022-08-17,16113,1834,740,1789,34703504,12643908,453931,,12189977,7482514
2022-08-18,14939,1640,752,1699,34718443,12645223,454815,,12190408,7483941
2022-08-19,15321,1848,750,1553,34733764,12646792,455909,,12190883,7485260
2022-08-20,14290,1641,742,1548,34748054,12648139,456802,,12191337,7486567
2022-08-21,9909,1533,661,1166,34757963,12649406,457670,,12191736,7487516
2022-08-22,4167,481,272,563,34762130,12649582,457876,,12191706,7487819
2022-08-23,11144,1248,555,1500,34773274,12650521,458565,,12191956,7489066
2022-08-24,14770,1807,873,2192,34788044,12652056,459499,,12192557,7491026
2022-08-25,14032,1716,780,2126,34802076,12653482,460428,,12193054,7492905
2022-08-26,13931,1687,816,2094,34816007,12654871,461292,,12193579,7494749
2022-08-27,12422,1487,878,2003,34828429,12656030,461895,,12194135,7496485
2022-08-28,7928,1260,622,1398,34836357,12657028,462531,,12194497,7497662
2022-08-29,3401,503,286,684,34839758,12657249,462743,,12194506,7498111
2022-08-30,9908,1167,652,1857,34849666,12658057,463252,,12194805,7499664
2022-08-31,13519,1627,946,2317,34863185,12659389,463929,,12195460,7501735
2022-09-01,12911,1721,915,2143,34876096,12660814,464730,,12196084,7503632
2022-09-02,15050,1616,996,4917,34891146,12662153,465342,,12196811,7508321
2022-09-03,14723,1526,924,5518,34905869,12663392,465941,,12197451,7513602
2022-09-04,8672,1009,677,3241,34914541,12664134,466263,,12197871,7516621
2022-09-05,3557,321,229,1387,34918098,12664187,466352,,12197835,7517784
2022-09-06,2473,157,116,1134,34920571,12664087,466390,,12197697,7518708
2022-09-07,10929,1020,588,3494,34931500,12664806,466818,,12197988,7521948
2022-09-08,10875,1023,528,2792,34942375,12665499,467310,,12198189,7524462
2022-09-09,9588,1013,489,2505,34951963,12666223,467829,,12198394,7526730
2022-09-10,10638,1265,553,3168,34962601,12667208,468534,,12198674,7529662
2022-09-11,9413,980,667,3739,34972014,12667937,468841,,12199096,7533190
2022-09-12,3128,295,205,1080,34975142,12667947,468924,,12199023,7534032
2022-09-13,6022,546,284,1133,34981164,12668203,469177,,12199026,7534919
2022-09-14,14484,799,436,1844,34995648,12668681,469536,,12199145,7536495
2022-09-15,15765,782,413,1536,35011413,12669142,469900,,12199242,7537759
2022-09-16,17762,767,448,1693,35029175,12669645,470213,,12199432,7539227
2022-09-17,17625,723,459,1669,35046800,12670060,470473,,12199587,7540639
2022-09-18,11214,773,451,1688,35058014,12670569,470793,,12199776,7542101
2022-09-19,4980,404,288,670,35062994,12670699,470904,,12199795,7542556
2022-09-20,13775,444,332,948,35076769,12670828,471014,,12199814,7543241
2022-09-21,23047,648,410,1501,35099816,12671164,471247,,12199917,7544485
2022-09-22,22921,636,399,1383,35122737,12671490,471478,,12200012,7545605
2022-09-23,22953,727,603,1420,35145690,12671912,471597,,12200315,7546766
2022-09-24,21698,738,690,1499,35167388,12672355,471641,,12200714,7548029
2022-09-25,11322,595,703,1358,35178710,12672667,471527,,12201140,7549149
2022-09-26,4565,191,220,594,35183275,12672565,471492,,12201073,7549497
2022-09-27,37655,497,366,1498,35220930,12672791,471619,,12201172,7550767
2022-09-28,50973,731,670,1903,35271903,12673252,471679,,12201573,7552443
2022-09-29,48014,637,742,1838,35319917,12673564,471566,,12201998,7554001
2022-09-30,47275,677,806,2006,35367192,12673913,471435,,12202478,7555725
2022-10-01,34456,527,634,1549,35401648,12674130,471326,,12202804,7557006
2022-10-02,24247,736,1028,1712,35425895,12674568,471031,,12203537,7558464
2022-10-03,10871,238,231,613,35436766,12674513,471034,,12203479,7558838
2022-10-04,32199,477,461,1170,35468965,12674667,471046,,12203621,7559728
2022-10-05,40443,633,742,1562,35509408,12674976,470930,,12204046,7561023
2022-10-06,38698,610,653,1570,35548106,12675280,470885,,12204395,7562330
2022-10-07,42246,662,852,1743,35590352,12675594,470687,,12204907,7563771
2022-10-08,37403,782,1145,2122,35627755,12676043,470318,,12205725,7565617
2022-10-09,18814,549,728,1556,35646569,12676311,470136,,12206175,7566932
2022-10-10,6867,165,371,567,35653436,12676176,469927,,12206249,7567237
2022-10-11,4997,126,111,318,35658433,12676006,469937,,12206069,7567316
2022-10-12,35119,579,686,1429,35693552,12676249,469828,,12206421,7568453
2022-10-13,36765,643,859,1621,35730317,12676520,469608,,12206912,7569761
2022-10-14,36980,623,755,1541,35767297,12676807,469472,,12207335,7571020
2022-10-15,35456,714,1013,1628,35802753,12677226,469170,,12208056,7572397
2022-10-16,20663,654,1024,1593,35823416,12677607,468794,,12208813,7573757
2022-10-17,7357,206,477,541,35830773,12677523,468521,,12209002,7574054
2022-10-18,36432,455,504,1402,35867205,12677654,468467,,12209187,7575182
2022-10-19,49905,618,730,1983,35917110,12677968,468351,,12209617,7576913
2022-10-20,51296,621,650,2050,35968406,12678271,468319,,12209952,7578695
2022-10-21,52855,695,620,1936,36021261,12678635,468388,,12210247,7580360
2022-10-22,50871,750,905,2313,36072132,12679049,468228,,12210821,7582393
2022-10-23,30646,571,787,2122,36102778,12679302,468005,,12211297,7584250
2022-10-24,14134,232,271,978,36116912,12679228,467961,,12211267,7584967
2022-10-25,41376,472,489,1821,36158288,12679346,467941,,12211405,7586487
2022-10-26,51660,615,660,2124,36209948,12679622,467892,,12211730,7588328
2022-10-27,50121,603,768,2164,36260069,12679894,467719,,12212175,7590217
2022-10-28,49810,591,676,2096,36309879,12680121,467629,,12212492,7592002
2022-10-29,50611,733,779,2222,36360490,12680500,467579,,12212921,7593919
2022-10-30,28405,661,930,2038,36388895,12680871,467306,,12213565,7595709
2022-10-31,12441,200,234,777,36401336,12680783,467268,,12213515,7596245
2022-11-01,33099,339,199,1221,36434435,12680773,467402,,12213371,7597173
2022-11-02,44294,574,625,1903,36478729,12681010,467347,,12213663,7598772
2022-11-03,44197,540,606,1857,36522926,12681216,467276,,12213940,7600340
2022-11-04,44647,648,528,2030,36567573,12681556,467389,,12214167,7602113
2022-11-05,45214,647,754,2369,36612787,12681896,467279,,12214617,7604211
2022-11-06,26021,558,771,2098,36638808,12682108,467063,,12215045,7606008
2022-11-07,10712,242,235,877,36649520,12682055,467067,,12214988,7606641
2022-11-08,33492,487,399,1586,36683012,12682248,467152,,12215096,7607980
2022-11-09,40533,604,570,1966,36723545,12682526,467184,,12215342,7609669
2022-11-10,39181,619,548,1928,36762726,12682820,467249,,12215571,7611318
2022-11-11,43356,637,643,2209,36806082,12683133,467241,,12215892,7613248
2022-11-12,36856,638,594,2185,36842938,12683444,467277,,12216167,7615148
2022-11-13,24271,557,771,2278,36867209,12683699,467057,,12216642,7617167
2022-11-14,10968,232,205,1024,36878177,12683632,467083,,12216549,7617930
2022-11-15,33639,484,380,1696,36911816,12683744,467181,,12216563,7619311
2022-11-16,43544,799,585,2371,36955360,12684236,467389,,12216847,7621424
2022-11-17,38342,674,647,2241,36993702,12684566,467412,,12217154,7623372
2022-11-18,40632,723,530,2336,37034334,12684937,467601,,12217336,7625404
2022-11-19,39666,1004,1031,3061,37074000,12685589,467567,,12218022,7628156
2022-11-20,22425,658,719,2445,37096425,12685960,467502,,12218458,7630364
2022-11-21,8922,196,193,968,37105347,12685887,467500,,12218387,7631121
2022-11-22,26443,481,370,1513,37131790,12685998,467606,,12218392,7632311
2022-11-23,32089,685,668,2071,37163879,12686342,467620,,12218722,7634094
2022-11-24,31914,662,754,2086,37195793,12686683,467526,,12219157,7635912
2022-11-25,30757,762,827,1955,37226550,12687128,467455,,12219673,7637600
2022-11-26,30296,908,1195,2699,37256846,12687688,467159,,12220529,7640002
2022-11-27,18681,607,943,2088,37275527,12687981,466817,,12221164,7641826
2022-11-28,7543,191,282,788,37283070,12687862,466718,,12221144,7642345
2022-11-29,21029,421,454,1293,37304099,12687943,466681,,12221262,7643352
2022-11-30,27894,643,649,1841,37331993,12688258,466673,,12221585,7644908
2022-12-01,24819,594,682,1693,37356812,12688517,466581,,12221936,7646310
2022-12-02,25060,523,630,1777,37381872,12688702,466468,,12222234,7647797
2022-12-03,25564,587,781,1949,37407436,12688956,466264,,12222692,7649473
2022-12-04,15253,494,606,1703,37422689,12689107,466146,,12222961,7650876
2022-12-05,6877,167,157,746,37429566,12688973,466151,,12222822,7651368
2022-12-06,20356,419,353,1379,37449922,12689013,466211,,12222802,7652427
2022-12-07,24792,553,612,1673,37474714,12689238,466144,,12223094,7653821
2022-12-08,23164,564,520,1767,37497878,12689474,466186,,12223288,7655301
2022-12-09,23335,637,576,1633,37521213,12689769,466243,,12223526,7656650
2022-12-10,22583,510,605,1631,37543796,12689950,466145,,12223805,7657995
2022-12-11,14206,548,787,1567,37558002,12690222,465903,,12224319,7659326
2022-12-12,5507,149,156,595,37563509,12690070,465891,,12224179,7659675
2022-12-13,17801,375,371,1125,37581310,12690115,465893,,12224222,7660520
2022-12-14,21328,511,547,1455,37602638,12690320,465851,,12224469,7661722
2022-12-15,21978,531,604,1579,37624616,12690496,465776,,12224720,7662996
2022-12-16,16296,378,451,1031,37640912,12690543,465700,,12224843,7663748
2022-12-17,18705,554,510,1279,37659617,12690764,465742,,12225022,7664734
2022-12-18,12647,531,795,1307,37672264,12691004,465477,,12225527,7665781
2022-12-19,4587,131,116,450,37676851,12690790,465488,,12225302,7665937
2022-12-20,16219,499,450,1112,37693070,12690961,465529,,12225432,7666776
2022-12-21,18481,542,552,1303,37711551,12691189,465515,,12225674,7667806
2022-12-22,18608,574,591,1748,37730159,12691457,465498,,12225959,7669288
2022-12-23,15654,577,602,1716,37745813,12691667,465468,,12226199,7670700
2022-12-24,5341,224,173,675,37751154,12691566,465518,,12226048,7671083
2022-12-25,2445,153,154,480,37753599,12691403,465507,,12225896,7671292
2022-12-26,262,12,7,48,37753861,12691104,465507,,12225597,7671080
2022-12-27,2099,98,37,307,37755960,12690907,465564,,12225343,7671144
2022-12-28,8322,337,168,975,37764282,12690918,465728,,12225190,7671837
2022-12-29,13167,583,529,1601,37777449,12691152,465778,,12225374,7673137
2022-12-30,15824,666,659,1881,37793273,12691499,465782,,12225717,7674734
2022-12-31,11238,459,389,1356,37804511,12691591,465848,,12225743,7675775
2023-01-01,3910,201,219,562,37808421,12691468,465828,,12225640,7676054
2023-01-02,652,37,13,97,37809073,12691202,465851,,12225351,7675891
2023-01-03,8197,297,151,902,37817270,12691193,465991,,12225202,7676535
2023-01-04,14724,573,547,1548,37831994,12691466,466010,,12225456,7677822
2023-01-05,16120,643,535,1797,37848114,12691793,466109,,12225684,7679346
2023-01-06,18840,715,613,2048,37866954,12692193,466208,,12225985,7681121
2023-01-07,18525,701,639,2057,37885479,12692602,466265,,12226337,7682923
2023-01-08,11613,579,608,1633,37897092,12692912,466232,,12226680,7684322
2023-01-09,5299,215,196,664,37902391,12692808,466248,,12226560,7684717
2023-01-10,12164,414,317,787,37914555,12692903,466343,,12226560,7685227
2023-01-11,15549,457,370,1098,37930104,12693021,466424,,12226597,7686040
2023-01-12,14085,444,409,973,37944189,12693141,466458,,12226683,7686739
2023-01-13,14178,419,344,1042,37958367,12693284,466530,,12226754,7687541
2023-01-14,13394,471,451,1079,37971761,12693432,466544,,12226888,7688338
2023-01-15,9049,459,508,1055,37980810,12693590,466494,,12227096,7689139
2023-01-16,3747,146,131,479,37984557,12693442,466509,,12226933,7689360
2023-01-17,8855,265,179,654,37993412,12693357,466591,,12226766,7689719
2023-01-18,10270,349,273,763,38003682,12693393,466663,,12226730,7690204
2023-01-19,10594,315,318,761,38014276,12693396,466655,,12226741,7690702
2023-01-20,9842,321,275,717,38024118,12693418,466699,,12226719,7691156
2023-01-21,11313,354,403,905,38035431,12693453,466649,,12226804,7691792
2023-01-22,7572,343,406,820,38043003,12693516,466582,,12226934,7692367
2023-01-23,3383,143,131,288,38046386,12693405,466593,,12226812,7692431
2023-01-24,8291,226,166,553,38054677,12693295,466650,,12226645,7692692
2023-01-25,10312,346,299,664,38064989,12693355,466693,,12226662,7693115
2023-01-26,6728,236,206,469,38071717,12693282,466719,,12226563,7693327
2023-01-27,6914,237,197,499,38078631,12693193,466756,,12226437,7693549
2023-01-28,9355,314,339,696,38087986,12693203,466725,,12226478,7693985
2023-01-29,5974,234,342,694,38093960,12693141,466612,,12226529,7694418
2023-01-30,1901,88,80,215,38095861,12692926,466618,,12226308,7694368
2023-01-31,5885,156,152,414,38101746,12692756,466617,,12226139,7694495
2023-02-01,7304,248,250,494,38109050,12692731,466612,,12226119,7694759
2023-02-02,6488,296,242,505,38115538,12692736,466663,,12226073,7695027
2023-02-03,6552,197,195,463,38122090,12692652,466661,,12225991,7695245
2023-02-04,6732,233,307,545,38128822,12692602,466581,,12226021,7695550
2023-02-05,4178,199,291,485,38133000,12692505,466484,,12226021,7695790
2023-02-06,1834,90,98,212,38134834,12692284,466473,,12225811,7695728
2023-02-07,4967,160,182,384,38139801,12692121,466448,,12225673,7695843
2023-02-08,5771,212,206,430,38145572,12692035,466449,,12225586,7696015
2023-02-09,6126,212,245,439,38151698,12691947,466415,,12225532,7696199
2023-02-10,5093,158,208,374,38156791,12691858,466360,,12225498,7696363
2023-02-11,6056,186,261,458,38162847,12691745,466281,,12225464,7696551
2023-02-12,4085,220,342,409,38166932,12691697,466155,,12225542,7696724
2023-02-13,1483,57,87,146,38168415,12691487,466123,,12225364,7696645
2023-02-14,3949,131,179,310,38172364,12691317,466073,,12225244,7696687
2023-02-15,4542,119,191,286,38176906,12691150,465998,,12225152,7696731
2023-02-16,4917,175,284,400,38181823,12691026,465885,,12225141,7696873
2023-02-17,4984,180,211,344,38186807,12690937,465850,,12225087,7696990
2023-02-18,5119,233,295,487,38191926,12690890,465786,,12225104,7697238
2023-02-19,3355,132,244,373,38195281,12690740,465669,,12225071,7697376
2023-02-20,1424,63,54,158,38196705,12690533,465675,,12224858,7697305
2023-02-21,916,27,15,107,38197621,12690296,465682,,12224614,7697181
2023-02-22,4137,131,212,370,38201758,12690146,465594,,12224552,7697321
2023-02-23,4283,162,231,393,38206041,12690018,465518,,12224500,7697466
2023-02-24,3035,136,232,274,38209076,12689873,465417,,12224456,7697487
2023-02-25,5025,213,541,386,38214101,12689819,465087,,12224732,7697651
2023-02-26,3473,146,681,384,38217574,12689678,464548,,12225130,7697796
2023-02-27,1075,37,56,97,38218649,12689455,464523,,12224932,7697677
2023-02-28,2734,99,163,232,38221383,12689250,464457,,12224793,7697639
2023-03-01,3850,137,428,336,38225233,12689061,464159,,12224902,7697687
2023-03-02,4595,158,495,329,38229828,12688883,463811,,12225072,7697739
2023-03-03,4371,159,357,334,38234199,12688749,463610,,12225139,7697814
2023-03-04,4970,208,623,350,38239169,12688656,463192,,12225464,7697906
2023-03-05,2537,110,450,251,38241706,12688446,462850,,12225596,7697881
2023-03-06,1157,48,37,114,38242863,12688213,462858,,12225355,7697751
2023-03-07,3222,88,172,225,38246085,12687960,462769,,12225191,7697691
2023-03-08,4320,133,412,284,38250405,12687773,462488,,12225285,7697690
2023-03-09,4626,174,454,313,38255031,12687641,462202,,12225439,7697741
2023-03-10,3942,99,139,255,38258973,12687470,462158,,12225312,7697768
2023-03-11,4065,139,172,286,38263038,12687357,462121,,12225236,7697833
2023-03-12,2894,109,234,302,38265932,12687176,461986,,12225190,7697889
2023-03-13,862,29,32,106,38266794,12686945,461978,,12224967,7697768
2023-03-14,3082,99,109,259,38269876,12686751,461968,,12224783,7697777
2023-03-15,4099,138,163,313,38273975,12686615,461940,,12224675,7697850
2023-03-16,4028,176,234,278,38278003,12686447,461873,,12224574,7697846
2023-03-17,4295,169,203,311,38282298,12686296,461835,,12224461,7697875
2023-03-18,4364,144,194,298,38286662,12686146,461784,,12224362,7697915
2023-03-19,2722,128,233,256,38289384,12686031,461676,,12224355,7697955
2023-03-20,774,31,19,74,38290158,12685775,461685,,12224090,7697785
2023-03-21,2900,69,86,201,38293058,12685558,461663,,12223895,7697745
2023-03-22,3895,130,134,248,38296953,12685385,461656,,12223729,7697723
2023-03-23,3813,116,172,226,38300766,12685190,461594,,12223596,7697684
2023-03-24,3694,102,116,238,38304460,12685017,461578,,12223439,7697693
2023-03-25,4274,108,171,252,38308734,12684839,461508,,12223331,7697699
2023-03-26,2480,112,213,202,38311214,12684671,461401,,12223270,7697663
2023-03-27,915,48,32,68,38312129,12684476,461416,,12223060,7697518
2023-03-28,3109,87,79,203,38315238,12684260,461415,,12222845,7697466
2023-03-29,4173,125,137,225,38319411,12684092,461397,,12222695,7697440
2023-03-30,3838,108,164,211,38323249,12683910,461339,,12222571,7697390
2023-03-31,3987,140,109,222,38327236,12683754,461369,,12222385,7697364
2023-04-01,4196,135,147,226,38331432,12683594,461354,,12222240,7697344
2023-04-02,2187,61,123,172,38333619,12683346,461288,,12222058,7697251
2023-04-03,781,24,12,53,38334400,12683103,461297,,12221806,7697070
2023-04-04,3420,74,76,169,38337820,12682907,461293,,12221614,7696997
2023-04-05,4374,94,109,250,38342194,12682696,461274,,12221422,7696989
2023-04-06,3703,108,109,190,38345897,12682530,461270,,12221260,7696943
2023-04-07,4599,104,115,244,38350496,12682340,461256,,12221084,7696938
2023-04-08,836,23,11,54,38351332,12682109,461263,,12220846,7696774
2023-04-09,2443,81,103,161,38353775,12681952,461238,,12220714,7696734
2023-04-10,360,9,6,20,38354135,12681690,461235,,12220455,7696533
2023-04-11,2774,33,28,122,38356909,12681422,461238,,12220184,7696388
2023-04-12,6347,105,96,188,38363256,12681257,461240,,12220017,7696355
2023-04-13,7000,106,129,207,38370256,12681073,461209,,12219864,7696308
2023-04-14,6514,88,103,206,38376770,12680889,461186,,12219703,7696294
2023-04-15,6950,107,149,230,38383720,12680718,461141,,12219577,7696292
2023-04-16,3277,83,144,166,38386997,12680509,461076,,12219433,7696207
2023-04-17,864,12,13,49,38387861,12680279,461072,,12219207,7696057
2023-04-18,4786,101,77,161,38392647,12680084,461093,,12218991,7695963
2023-04-19,6568,117,99,177,38399215,12679913,461108,,12218805,7695888
2023-04-20,6395,102,153,210,38405610,12679756,461054,,12218702,7695876
2023-04-21,5774,85,76,133,38411384,12679563,461060,,12218503,7695773
2023-04-22,6392,95,91,180,38417776,12679389,461061,,12218328,7695730
2023-04-23,3301,119,147,170,38421077,12679256,461032,,12218224,7695680
2023-04-24,955,4,12,59,38422032,12679004,461022,,12217982,7695530
2023-04-25,4813,69,70,187,38426845,12678801,461021,,12217780,7695476
2023-04-26,6593,108,93,208,38433438,12678660,461035,,12217625,7695465
2023-04-27,6899,118,152,207,38440337,12678506,460996,,12217510,7695437
2023-04-28,6639,86,86,186,38446976,12678332,460993,,12217339,7695390
2023-04-29,6534,121,111,200,38453510,12678190,460999,,12217191,7695362
2023-04-30,2643,95,129,145,38456153,12678049,460964,,12217085,7695298
2023-05-01,1030,20,17,30,38457183,12677799,460961,,12216838,7695096
2023-05-02,4352,67,58,107,38461535,12677584,460964,,12216620,7694964
2023-05-03,5620,108,107,176,38467155,12677426,460958,,12216468,7694917
2023-05-04,8088,87,85,135,38475243,12677235,460957,,12216278,7694823
2023-05-05,13055,90,99,168,38488298,12677072,460943,,12216129,7694773
2023-05-06,15659,112,96,157,38503957,12676951,460957,,12215994,7694718
2023-05-07,6075,56,96,106,38510032,12676770,460912,,12215858,7694620
2023-05-08,2168,16,4,37,38512200,12676539,460919,,12215620,7694447
2023-05-09,12576,56,49,129,38524776,12676335,460920,,12215415,7694359
2023-05-10,14788,70,79,157,38539564,12676145,460907,,12215238,7694295
2023-05-11,13368,76,72,156,38552932,12675984,460910,,12215074,7694241
2023-05-12,13498,84,80,177,38566430,12675826,460911,,12214915,7694204
2023-05-13,11451,79,76,147,38577881,12675611,460909,,12214702,7694094
2023-05-14,4188,68,95,94,38582069,12675440,460878,,12214562,7693996
2023-05-15,1055,9,6,38,38583124,12675219,460875,,12214344,7693837
2023-05-16,8949,56,48,93,38592073,12675016,460876,,12214140,7693708
2023-05-17,11134,99,83,141,38603207,12674846,460886,,12213960,7693602
2023-05-18,10838,81,69,144,38614045,12674653,460896,,12213757,7693510
2023-05-19,10517,95,97,154,38624562,12674484,460888,,12213596,7693431
2023-05-20,9412,91,89,167,38633974,12674291,460887,,12213404,7693345
2023-05-21,3084,47,86,95,38637058,12674107,460846,,12213261,7693238
2023-05-22,971,14,11,30,38638029,12673873,460848,,12213025,7693053
2023-05-23,754,8,3,16,38638783,12673646,460852,,12212794,7692871
2023-05-24,8035,57,80,105,38646818,12673440,460828,,12212612,7692738
2023-05-25,9352,74,93,162,38656170,12673250,460807,,12212443,7692668
2023-05-26,8002,67,71,124,38664172,12673085,460802,,12212283,7692586
2023-05-27,8237,110,76,126,38672409,12672939,460833,,12212106,7692499
2023-05-28,2905,56,72,101,38675314,12672772,460813,,12211959,7692403
2023-05-29,972,13,11,30,38676286,12672549,460812,,12211737,7692222
2023-05-30,6075,58,50,113,38682361,12672340,460818,,12211522,7692101
2023-05-31,8175,92,94,122,38690536,12672154,460811,,12211343,7691995
2023-06-01,7405,69,92,125,38697941,12671971,460785,,12211186,7691901
2023-06-02,6342,52,49,121,38704283,12671760,460787,,12210973,7691783
2023-06-03,5500,70,63,123,38709783,12671556,460793,,12210763,7691671
2023-06-04,2063,47,78,77,38711846,12671375,460756,,12210619,7691549
2023-06-05,601,11,7,18,38712447,12671151,460757,,12210394,7691366
2023-06-06,4470,39,39,79,38716917,12670933,460754,,12210179,7691222
2023-06-07,5827,63,66,120,38722744,12670776,460746,,12210030,7691157
2023-06-08,5758,58,68,112,38728502,12670633,460732,,12209901,7691096
2023-06-09,6192,77,81,122,38734694,12670472,460724,,12209748,7691011
2023-06-10,5352,76,95,116,38740046,12670296,460699,,12209597,7690909
2023-06-11,2010,55,62,105,38742056,12670142,460687,,12209455,7690838
2023-06-12,691,11,7,38,38742747,12669943,460688,,12209255,7690695
2023-06-13,4228,54,58,104,38746975,12669764,460682,,12209082,7690602
2023-06-14,5471,72,83,119,38752446,12669587,460670,,12208917,7690507
2023-06-15,5118,72,75,122,38757564,12669399,460663,,12208736,7690404
2023-06-16,5704,70,64,121,38763268,12669241,460665,,12208576,7690327
2023-06-17,4123,63,62,114,38767391,12669076,460666,,12208410,7690242
2023-06-18,1561,41,61,98,38768952,12668904,460644,,12208260,7690155
2023-06-19,373,6,2,16,38769325,12668697,460646,,12208051,7689987
2023-06-20,3207,51,42,89,38772532,12668507,460652,,12207855,7689864
2023-06-21,3696,42,57,89,38776228,12668346,460633,,12207713,7689769
2023-06-22,3981,75,73,118,38780209,12668212,460633,,12207579,7689702
2023-06-23,4510,54,44,90,38784719,12668082,460641,,12207441,7689630
2023-06-24,3699,49,61,73,38788418,12667894,460626,,12207268,7689501
2023-06-25,1521,31,52,93,38789939,12667728,460603,,12207125,7689423
2023-06-26,511,11,9,24,38790450,12667562,460602,,12206960,7689285
2023-06-27,3121,80,45,91,38793571,12667422,460634,,12206788,7689187
2023-06-28,4075,69,60,91,38797646,12667288,460642,,12206646,7689095
2023-06-29,3984,64,72,84,38801630,12667164,460628,,12206536,7689018
2023-06-30,3836,74,61,128,38805466,12667030,460636,,12206394,7688960
2023-07-01,3224,52,88,118,38808690,12666862,460598,,12206264,7688890
2023-07-02,272,10,5,15,38808962,12666676,460602,,12206074,7688735
2023-07-03,381,8,5,26,38809343,12666512,460604,,12205908,7688615
2023-07-04,1244,18,14,49,38810587,12666331,460608,,12205723,7688488
2023-07-05,2391,56,40,70,38812978,12666196,460622,,12205574,7688396
2023-07-06,2535,38,69,85,38815513,12666014,460589,,12205425,7688288
2023-07-07,2825,53,46,72,38818338,12665890,460594,,12205296,7688207
2023-07-08,2422,63,44,94,38820760,12665746,460612,,12205134,7688118
2023-07-09,916,31,45,37,38821676,12665593,460598,,12204995,7687988
2023-07-10,289,4,2,15,38821965,12665382,460598,,12204784,7687817
2023-07-11,1793,34,20,59,38823758,12665217,460608,,12204609,7687709
2023-07-12,2323,49,53,87,38826081,12665078,460604,,12204474,7687628
2023-07-13,2291,52,68,67,38828372,12664936,460586,,12204350,7687528
2023-07-14,2030,64,49,60,38830402,12664820,460598,,12204222,7687432
2023-07-15,1946,52,56,77,38832348,12664697,460593,,12204104,7687357
2023-07-16,806,36,30,43,38833154,12664528,460599,,12203929,7687222
2023-07-17,193,5,1,11,38833347,12664365,460600,,12203765,7687087
2023-07-18,1308,42,44,56,38834655,12664193,460597,,12203596,7686962
2023-07-19,1801,55,53,57,38836456,12664066,460596,,12203470,7686868
2023-07-20,1667,77,57,61,38838123,12663966,460614,,12203352,7686764
2023-07-21,1738,54,40,50,38839861,12663837,460623,,12203214,7686651
2023-07-22,1512,38,62,76,38841373,12663702,460599,,12203103,7686563
2023-07-23,699,28,31,49,38842072,12663553,460594,,12202959,7686456
2023-07-24,235,11,2,15,38842307,12663385,460602,,12202783,7686308
2023-07-25,1087,48,25,51,38843394,12663219,460625,,12202594,7686166
2023-07-26,1347,48,49,42,38844741,12663099,460622,,12202477,7686055
2023-07-27,1287,67,47,55,38846028,12662998,460641,,12202357,7685960
2023-07-28,1449,46,47,58,38847477,12662847,460639,,12202208,7685843
2023-07-29,1310,50,49,69,38848787,12662708,460636,,12202072,7685749
2023-07-30,648,29,19,29,38849435,12662566,460645,,12201921,7685629
2023-07-31,229,6,4,15,38849664,12662406,460643,,12201763,7685495
2023-08-01,1117,47,32,35,38850781,12662275,460657,,12201618,7685372
2023-08-02,1436,73,55,56,38852217,12662145,460672,,12201473,7685259
2023-08-03,1159,61,38,47,38853376,12662022,460694,,12201328,7685142
2023-08-04,1299,46,48,60,38854675,12661878,460691,,12201187,7685029
2023-08-05,1319,49,50,49,38855994,12661747,460689,,12201058,7684919
2023-08-06,577,25,20,23,38856571,12661626,460694,,12200932,7684807
2023-08-07,245,8,4,9,38856816,12661471,460694,,12200777,7684674
2023-08-08,330,8,4,15,38857146,12661300,460695,,12200605,7684530
2023-08-09,1260,45,43,45,38858406,12661165,460696,,12200469,7684421
2023-08-10,1608,96,52,70,38860014,12661107,460738,,12200369,7684354
2023-08-11,1681,57,47,63,38861695,12661008,460748,,12200260,7684280
2023-08-12,1658,65,47,68,38863353,12660929,460766,,12200163,7684223
2023-08-13,798,29,32,32,38864151,12660811,460763,,12200048,7684124
2023-08-14,248,6,1,6,38864399,12660678,460766,,12199912,7684009
2023-08-15,1295,38,27,40,38865694,12660509,460774,,12199735,7683869
2023-08-16,1639,60,50,49,38867333,12660417,460782,,12199635,7683780
2023-08-17,1710,77,66,63,38869043,12660344,460791,,12199553,7683712
2023-08-18,1691,86,60,51,38870734,12660275,460815,,12199460,7683622
2023-08-19,1715,81,54,65,38872449,12660194,460841,,12199353,7683546
2023-08-20,839,57,44,32,38873288,12660115,460851,,12199264,7683461
2023-08-21,230,4,2,8,38873518,12659931,460851,,12199080,7683307
2023-08-22,1252,57,47,48,38874770,12659809,460860,,12198949,7683200
2023-08-23,1535,67,50,53,38876305,12659723,460876,,12198847,7683114
2023-08-24,1583,95,68,72,38877888,12659650,460903,,12198747,7683034
2023-08-25,1451,87,44,52,38879339,12659580,460945,,12198635,7682947
2023-08-26,1645,80,55,68,38880984,12659513,460968,,12198545,7682885
2023-08-27,794,29,44,49,38881778,12659409,460949,,12198460,7682816
2023-08-28,190,5,3,9,38881968,12659282,460949,,12198333,7682702
2023-08-29,927,51,31,43,38882895,12659192,460968,,12198224,7682616
2023-08-30,1379,121,69,71,38884274,12659188,461020,,12198168,7682574
2023-08-31,1467,97,91,82,38885741,12659146,461024,,12198122,7682541
2023-09-01,1489,98,82,99,38887230,12659146,461039,,12198107,7682557
2023-09-02,1276,77,62,66,38888506,12659100,461052,,12198048,7682513
2023-09-03,668,47,41,32,38889174,12659040,461058,,12197982,7682449
2023-09-04,147,2,0,9,38889321,12658928,461058,,12197870,7682361
2023-09-05,131,5,2,6,38889452,12658819,461060,,12197759,7682273
2023-09-06,990,46,39,57,38890442,12658733,461066,,12197667,7682211
2023-09-07,1218,54,38,73,38891660,12658690,461082,,12197608,7682198
2023-09-08,1052,70,43,47,38892712,12658660,461109,,12197551,7682155
2023-09-09,1201,62,41,70,38893913,12658625,461130,,12197495,7682137
2023-09-10,822,56,38,47,38894735,12658595,461148,,12197447,7682105
2023-09-11,130,5,3,8,38894865,12658516,461149,,12197367,7682039
2023-09-12,902,31,23,36,38895767,12658455,461157,,12197298,7681996
2023-09-13,1314,78,53,66,38897081,12658443,461180,,12197263,7681981
2023-09-14,1032,61,51,51,38898113,12658446,461190,,12197256,7681978
2023-09-15,1084,76,25,64,38899197,12658454,461240,,12197214,7681982
2023-09-16,1108,83,44,61,38900305,12658485,461279,,12197206,7681997
2023-09-17,687,57,31,48,38900992,12658507,461304,,12197203,7682016
2023-09-18,140,5,2,6,38901132,12658476,461307,,12197169,7681990
2023-09-19,808,62,31,49,38901940,12658527,461338,,12197189,7682029
2023-09-20,947,86,33,47,38902887,12658613,461391,,12197222,7682076
2023-09-21,811,67,27,51,38903698,12658680,461431,,12197249,7682127
