"report_date","previous_day_total_doses_administered","previous_day_at_least_one","previous_day_fully_vaccinated","previous_day_3doses","total_doses_administered","total_individuals_at_least_one","total_individuals_partially_vaccinated","total_doses_in_fully_vaccinated_individuals","total_individuals_fully_vaccinated","total_individuals_3doses"
2021-01-01,6249,6239,2,,32171,32116,32105,22,11,
2021-01-02,4612,4600,6,,36783,36664,36651,26,13,
2021-01-03,5393,5386,3,,42176,42050,42034,32,16,
2021-01-04,5994,5992,0,,48170,48041,48026,30,15,
2021-01-05,9680,9656,19,,57850,57695,57662,66,33,
2021-01-06,12792,12327,450,,70642,70018,69539,958,479,
2021-01-07,16216,15504,697,,86858,85521,84345,2352,1176,
2021-01-08,18034,17019,1002,,104892,102540,100362,4356,2178,
2021-01-09,19498,18421,1064,,124390,120960,117718,6484,3242,
2021-01-10,11366,11327,36,,135756,132278,129001,6554,3277,
2021-01-11,11709,11661,47,,147465,143939,140615,6648,3324,
2021-01-12,14463,14158,296,,161928,158089,154469,7240,3620,
2021-01-13,15428,13810,1591,,177356,171885,166676,10418,5209,
2021-01-14,19180,16730,2435,,196536,188609,180966,15286,7643,
2021-01-15,20044,17989,2036,,216580,206587,196908,19358,9679,
2021-01-16,17114,15931,1170,,233694,222502,211653,21698,10849,
2021-01-17,11253,10010,1236,,244947,232497,220414,24166,12083,
2021-01-18,6788,6708,70,,251735,239182,227032,24300,12150,
2021-01-19,11822,9714,2094,,263557,248875,234631,28488,14244,
2021-01-20,10794,7205,3572,,274351,256057,238242,35630,17815,
2021-01-21,10962,6847,4088,,285313,262888,240985,43806,21903,
2021-01-22,9031,4316,4697,,294344,267167,240569,53196,26598,
2021-01-23,7443,3028,4387,,301787,270165,239181,61968,30984,
2021-01-24,4377,1822,2535,,306164,271969,238450,67038,33519,
2021-01-25,5316,1045,4262,,311480,272982,235202,75560,37780,
2021-01-26,9374,2851,6495,,320854,275801,231527,88548,44274,
2021-01-27,9892,2860,7004,,330746,278632,227355,102554,51277,
2021-01-28,13102,5728,7332,,343848,284327,225718,117218,58609,
2021-01-29,10676,3264,7378,,354524,287560,221574,131972,65986,
2021-01-30,9180,2721,6422,,363704,290239,217834,144810,72405,
2021-01-31,3368,1558,1767,,367072,291763,217592,148342,74171,
2021-02-01,2118,481,1609,,369190,292210,216434,151552,75776,
2021-02-02,4398,1345,2995,,373588,293517,214750,157534,78767,
2021-02-03,6227,1709,4456,,379815,295185,211969,166432,83216,
2021-02-04,9067,1698,7290,,388882,296840,206340,181000,90500,
2021-02-05,8424,1452,6901,,397306,298252,200857,194790,97395,
2021-02-06,10651,1857,8735,,407957,300054,193933,212242,106121,
2021-02-07,7563,1720,5795,,415520,301735,189830,223810,111905,
2021-02-08,8214,3092,5080,,423734,304779,187807,233944,116972,
2021-02-09,14995,3851,11079,,438729,308588,180553,256070,128035,
2021-02-10,15497,4921,10518,,454226,313457,174929,277056,138528,
2021-02-11,16354,3894,12405,,470580,317299,166397,301804,150902,
2021-02-12,17646,2091,15505,,488226,319352,152964,332776,166388,
2021-02-13,16197,2435,13746,,504423,321742,141627,360230,180115,
2021-02-14,12868,912,11925,,517291,322606,130596,384020,192010,
2021-02-15,7860,484,7328,,525151,323042,123730,398624,199312,
2021-02-16,5986,1038,4899,,531137,324037,119849,408376,204188,
2021-02-17,10159,1604,8522,,541296,325597,112915,425364,212682,
2021-02-18,13860,2950,10866,,555156,328499,104981,447036,223518,
2021-02-19,18476,6207,12204,,573632,334654,98963,471382,235691,
2021-02-20,22612,11125,11436,,596244,345716,98627,494178,247089,
2021-02-21,17224,10372,6818,,613468,356028,102163,507730,253865,
2021-02-22,13573,8748,4774,,627041,364706,106117,517178,258589,
2021-02-23,17843,11110,6662,,644884,375760,110545,530430,265215,
2021-02-24,18555,13600,4875,,663439,389304,119256,540096,270048,
2021-02-25,20792,16478,4257,,684231,405716,131459,548514,274257,
2021-02-26,24869,21819,2991,,709100,427475,150264,554422,277211,
2021-02-27,27445,23572,3833,,736545,450983,169987,561992,280996,
2021-02-28,20574,19136,1404,,757119,470065,187707,564716,282358,
2021-03-01,18213,17020,1148,,775332,487024,203564,566920,283460,
2021-03-02,24662,22264,2314,,799994,509227,223499,571456,285728,
2021-03-03,30573,27947,2575,,830567,537123,248853,576540,288270,
2021-03-04,34669,32443,2142,,865236,569500,279138,580724,290362,
2021-03-05,39958,38137,1775,,905194,607589,315486,584206,292103,
2021-03-06,44125,41923,2164,,949319,649457,355231,588452,294226,
2021-03-07,32716,31540,1172,,982035,680923,385583,590680,295340,
2021-03-08,24029,22155,1861,,1006064,703010,405863,594294,297147,
2021-03-09,33266,29823,3415,,1039330,732767,432251,601032,300516,
2021-03-10,38315,34056,4214,,1077645,766749,462067,609364,304682,
2021-03-11,43959,40688,3232,,1121604,807371,499509,615724,307862,
2021-03-12,47679,45969,1687,,1169283,853276,543777,618998,309499,
2021-03-13,57876,55009,2841,,1227159,908214,595928,624572,312286,
2021-03-14,43377,42149,1213,,1270536,950280,636849,626862,313431,
2021-03-15,32797,31101,1681,,1303333,981322,666253,630138,315069,
2021-03-16,53926,51635,2275,,1357259,1032892,715591,634602,317301,
2021-03-17,61033,58503,2489,,1418292,1091329,771589,639480,319740,
2021-03-18,61508,59057,2426,,1479800,1150314,828201,644226,322113,
2021-03-19,64434,61116,3266,,1544234,1211352,886026,650652,325326,
2021-03-20,62532,59952,2549,,1606766,1271248,943421,655654,327827,
2021-03-21,43970,42457,1527,,1650736,1313640,984323,658634,329317,
2021-03-22,30988,30026,975,,1681724,1343578,1013342,660472,330236,
2021-03-23,54583,51812,2722,,1736307,1395295,1062400,665790,332895,
2021-03-24,76394,73218,3128,,1812701,1468423,1132457,671932,335966,
2021-03-25,82879,80303,2529,,1895580,1548647,1210209,676876,338438,
2021-03-26,86960,83436,3485,,1982540,1632002,1290131,683742,341871,
2021-03-27,80823,77877,2863,,2063363,1709776,1365107,689338,344669,
2021-03-28,66971,65385,1552,,2130334,1775071,1428907,692328,346164,
2021-03-29,51720,49036,2650,,2182054,1824027,1475259,697536,348768,
2021-03-30,73545,70145,3343,,2255599,1894095,1542025,704140,352070,
2021-03-31,93132,89490,3575,,2348731,1983487,1627895,711184,355592,
2021-04-01,89273,85409,3827,,2438004,2068798,1709432,718732,359366,
2021-04-02,93048,88829,4205,,2531052,2157541,1794022,727038,363519,
2021-04-03,60965,59294,1729,,2592017,2216744,1851547,730394,365197,
2021-04-04,72308,70662,1642,,2664325,2287295,1920514,733562,366781,
2021-04-05,53726,53258,468,,2718051,2340469,1973268,734402,367201,
2021-04-06,79557,77698,1878,,2797608,2418066,2049040,738052,369026,
2021-04-07,107973,104916,3050,,2905581,2522857,2150839,744036,372018,
2021-04-08,114049,110090,4018,,3019630,2632836,2256856,751960,375980,
2021-04-09,109807,105596,4286,,3129437,2738314,2358113,760402,380201,
2021-04-10,109196,105452,3839,,3238633,2843638,2459664,767948,383974,
2021-04-11,98597,95489,3253,,3337230,2939002,2551834,774336,387168,
2021-04-12,76048,74989,1152,,3413278,3013843,2625591,776504,388252,
2021-04-13,99438,96069,3392,,3512716,3109803,2718207,783192,391596,
2021-04-14,117011,113255,3645,,3629727,3222940,2827739,790402,395201,
2021-04-15,113531,109483,3892,,3743258,3332297,2933261,798072,399036,
2021-04-16,118094,113732,4187,,3861352,3445919,3042740,806358,403179,
2021-04-17,112375,107801,4437,,3973727,3553586,3146029,815114,407557,
2021-04-18,88714,86491,2093,,4062441,3639954,3230358,819192,409596,
2021-04-19,68944,67424,1442,,4131385,3707248,3296261,821974,410987,
2021-04-20,101894,98578,3113,,4233279,3805664,3391629,828070,414035,
2021-04-21,141955,137702,4022,,4375234,3943192,3525203,835978,417989,
2021-04-22,139440,135303,3900,,4514674,4078366,3656533,843666,421833,
2021-04-23,138152,131771,6142,,4652826,4209983,3782066,855834,427917,
2021-04-24,130248,126207,3871,,4783074,4336042,3904310,863464,431732,
2021-04-25,101991,98595,3167,,4885065,4434489,3999657,869664,434832,
2021-04-26,70982,69286,1551,,4956047,4503644,4067321,872646,436323,
2021-04-27,98469,95407,2875,,5054516,4598890,4159755,878270,439135,
2021-04-28,120543,115935,4422,,5175059,4714657,4271172,886970,443485,
2021-04-29,124439,119258,5037,,5299498,4833748,4385295,896906,448453,
2021-04-30,115773,110536,5003,,5415271,4944111,4490732,906758,453379,
2021-05-01,111246,107404,3631,,5526517,5051334,4594401,913866,456933,
2021-05-02,79110,76145,2853,,5605627,5127322,4667602,919440,459720,
2021-05-03,56764,55107,1589,,5662391,5182275,4721026,922498,461249,
2021-05-04,91895,88539,3276,,5754286,5270636,4806188,928896,464448,
2021-05-05,137965,133272,4609,,5892251,5403739,4934745,937988,468994,
2021-05-06,141797,136856,4806,,6034048,5540411,5066673,947476,473738,
2021-05-07,150228,145211,4822,,6184276,5685462,5206961,957002,478501,
2021-05-08,142415,137746,4421,,6326691,5823013,5340170,965686,482843,
2021-05-09,124777,121138,3475,,6451468,5943987,5457733,972508,486254,
2021-05-10,97782,95810,1873,,6549250,6039608,5551548,976120,488060,
2021-05-11,113464,108810,4478,,6662714,6148216,5655749,984934,492467,
2021-05-12,144984,137981,6859,,6807698,6286018,5786758,998520,499260,
2021-05-13,142616,135279,7195,,6950314,6421122,5914741,1012762,506381,
2021-05-14,148858,138745,9946,,7099172,6559679,6043417,1032524,516262,
2021-05-15,159684,149660,9850,,7258856,6709152,6183115,1052074,526037,
2021-05-16,144333,136067,8063,,7403189,6845051,6311031,1068040,534020,
2021-05-17,114945,110853,3940,,7518134,6955715,6417831,1075768,537884,
2021-05-18,111267,100416,10652,,7629401,7055935,6507461,1096948,548474,
2021-05-19,149823,133432,16217,,7779224,7189215,6624598,1129234,564617,
2021-05-20,151494,131527,19758,,7930718,7320553,6736247,1168612,584306,
2021-05-21,165309,140827,24230,,8096027,7461199,6852740,1216918,608459,
2021-05-22,199348,172181,26945,,8295375,7633183,6997860,1270646,635323,
2021-05-23,139778,127412,12223,,8435153,7760417,7112933,1294968,647484,
2021-05-24,100257,93295,6821,,8535410,7853539,7199304,1308470,654235,
2021-05-25,90389,82921,7260,,8625799,7936297,7274869,1322856,661428,
2021-05-26,139715,112962,26491,,8765514,8049072,7361223,1375698,687849,
2021-05-27,152005,122995,28760,,8917519,8171910,7455370,1433080,716540,
2021-05-28,163795,132260,31235,,9081314,8303997,7556281,1495432,747716,
2021-05-29,153320,117073,36015,,9234634,8420921,7637246,1567350,783675,
2021-05-30,149675,118976,30475,,9384309,8539727,7725639,1628176,814088,
2021-05-31,99172,79782,19202,,9483481,8619339,7786113,1666452,833226,
2021-06-01,124117,90553,33234,,9607598,8709697,7843312,1732770,866385,
2021-06-02,145250,102103,42901,,9752848,8811619,7902402,1818434,909217,
2021-06-03,155288,99854,55158,,9908136,8911289,7946985,1928608,964304,
2021-06-04,181648,115492,65889,,10089784,9026582,7996477,2060210,1030105,
2021-06-05,171946,103378,68294,,10261730,9129762,8031448,2196628,1098314,
2021-06-06,163335,91823,71234,,10425065,9221407,8051929,2338956,1169478,
2021-06-07,119534,63030,56289,,10544599,9284240,8058548,2451384,1225692,
2021-06-08,161843,72411,88998,,10706442,9356462,8041852,2629220,1314610,
2021-06-09,181398,70764,110174,,10887840,9427050,8002346,2849408,1424704,
2021-06-10,185517,66381,118650,,11073357,9493228,7949965,3086526,1543263,
2021-06-11,204737,67484,136500,,11278094,9560526,7880845,3359362,1679681,
2021-06-12,199656,62637,136427,,11477750,9622981,7806965,3632032,1816016,
2021-06-13,190268,58838,130907,,11668018,9681644,7734801,3893686,1946843,
2021-06-14,137645,38666,98590,,11805663,9720114,7674786,4090656,2045328,
2021-06-15,189161,42567,146245,,11994824,9762463,7570987,4382952,2191476,
2021-06-16,206068,42399,163033,,12200892,9804666,7450260,4708812,2354406,
2021-06-17,210339,37906,171864,,12411231,9842357,7316179,5052356,2526178,
2021-06-18,217086,35325,181161,,12628317,9877492,7170245,5414494,2707247,
2021-06-19,215799,35461,179681,,12844116,9912747,7025931,5773632,2886816,
2021-06-20,186207,35531,150107,,13030323,9948080,6911265,6073630,3036815,
2021-06-21,120395,20810,99092,,13150718,9968695,6832880,6271630,3135815,
2021-06-22,204868,27478,176646,,13355586,9995979,6683627,6624704,3312352,
2021-06-23,230452,28592,201132,,13586038,10024371,6510995,7026752,3513376,
2021-06-24,227626,26648,200236,,13813664,10050823,6337321,7427004,3713502,
2021-06-25,251040,27949,222357,,14064704,10078571,6142830,7871482,3935741,
2021-06-26,261220,29965,230557,,14325924,10108311,5942153,8332316,4166158,
2021-06-27,204934,27754,176585,,14530858,10135883,5793250,8685266,4342633,
2021-06-28,199210,20942,177715,,14730068,10156627,5636404,9040446,4520223,
2021-06-29,250048,24464,224869,,14980116,10180850,5435912,9489876,4744938,
2021-06-30,275471,24151,250758,,15255587,10204798,5209231,9991134,4995567,
2021-07-01,271919,25286,246085,,15527506,10229866,4988353,10483026,5241513,
2021-07-02,144672,11562,132887,,15672178,10241254,4866956,10748596,5374298,
2021-07-03,216838,19897,196714,,15889016,10260929,4690066,11141726,5570863,
2021-07-04,196103,19369,176516,,16085119,10280112,4532852,11494520,5747260,
2021-07-05,148689,12431,136118,,16233808,10292354,4409103,11766502,5883251,
2021-07-06,219976,19966,199797,,16453784,10312104,4229202,12165804,6082902,
2021-07-07,246561,22947,223380,,16700345,10334825,4028691,12612268,6306134,
2021-07-08,231153,21329,209616,,16931498,10355948,3840333,13031230,6515615,
2021-07-09,226942,21488,205288,,17158440,10377234,3656463,13441542,6720771,
2021-07-10,209004,20518,188333,,17367444,10397548,3488581,13817934,6908967,
2021-07-11,171636,17562,153951,,17539080,10414909,3352138,14125542,7062771,
2021-07-12,123108,11438,111574,,17662188,10426158,3251950,14348416,7174208,
2021-07-13,178422,18993,159286,,17840610,10444929,3111590,14666678,7333339,
2021-07-14,179986,19276,160553,,18020596,10463991,2970262,14987458,7493729,
2021-07-15,167151,19569,147411,,18187747,10483349,2842373,15281952,7640976,
2021-07-16,169292,19869,149274,,18357039,10503016,2712919,15580194,7790097,
2021-07-17,172926,20231,152572,,18529965,10522998,2580521,15884954,7942477,
2021-07-18,133581,15909,117536,,18663546,10538723,2478858,16119730,8059865,
2021-07-19,91945,10403,81436,,18755491,10548913,2407787,16282252,8141126,
2021-07-20,133484,16921,116503,,18888975,10565594,2308141,16514906,8257453,
2021-07-21,140037,16962,123004,,19029012,10582341,2202046,16760590,8380295,
2021-07-22,125545,17615,107798,,19154557,10599732,2111816,16975832,8487916,
2021-07-23,120195,16961,103029,,19274752,10616452,2025706,17181492,8590746,
2021-07-24,126638,18314,108089,,19401390,10634563,1935891,17397344,8698672,
2021-07-25,103582,14831,88624,,19504972,10649170,1862055,17574230,8787115,
2021-07-26,66655,9874,56691,,19571627,10658826,1815201,17687250,8843625,
2021-07-27,92334,15296,76877,,19663961,10673861,1753576,17840570,8920285,
2021-07-28,93883,16431,77377,,19757844,10690057,1692586,17994942,8997471,
2021-07-29,89328,16671,72496,,19847172,10706496,1636717,18139558,9069779,
2021-07-30,83994,16073,67813,,19931166,10722341,1584937,18274808,9137404,
2021-07-31,83765,15668,67945,,20014931,10737791,1532632,18410318,9205159,
2021-08-01,61835,11303,50351,,20076766,10748868,1493549,18510638,9255319,
2021-08-02,42445,7395,34934,,20119211,10756065,1465978,18580174,9290087,
2021-08-03,33233,5931,27135,,20152444,10761763,1444751,18634024,9317012,
2021-08-04,61266,12352,48727,,20213710,10773880,1408339,18731082,9365541,
2021-08-05,59399,12514,46734,,20273109,10786186,1374075,18824222,9412111,
2021-08-06,55961,11831,43916,,20329070,10797757,1341959,18911596,9455798,
2021-08-07,62324,12113,50015,,20391394,10809609,1304014,19011190,9505595,
2021-08-08,48609,9231,39193,,20440003,10818612,1274029,19089166,9544583,
2021-08-09,30831,5925,24732,,20470834,10824323,1255195,19138256,9569128,
2021-08-10,49191,10478,38418,,20520025,10834522,1227222,19214600,9607300,
2021-08-11,48663,10745,37679,,20568688,10845020,1200257,19289526,9644763,
2021-08-12,49191,11171,37798,,20617879,10855941,1173588,19364706,9682353,
2021-08-13,49567,11706,37593,,20667446,10867406,1147671,19439470,9719735,
2021-08-14,51157,12112,38840,,20718603,10879268,1120917,19516702,9758351,
2021-08-15,41704,9823,31662,,20760307,10888889,1099048,19579682,9789841,
2021-08-16,26697,6159,20383,,20787004,10894825,1084798,19620054,9810027,
2021-08-17,40437,11025,29155,,20827441,10905600,1066644,19677912,9838956,
2021-08-18,41845,11942,29663,,20869286,10917300,1048891,19736818,9868409,
2021-08-19,45828,16498,29073,,20915114,10933547,1036288,19794518,9897259,
2021-08-20,46378,16262,29709,,20961492,10949553,1022814,19853478,9926739,
2021-08-21,47899,15123,32409,,21009391,10964416,1005495,19917842,9958921,
2021-08-22,34347,10792,23291,,21043738,10974962,992972,19963980,9981990,
2021-08-23,23198,6992,15987,,21066936,10981719,983956,19995526,9997763,
2021-08-24,37607,13353,23805,,21104543,10994818,973481,20042674,10021337,
2021-08-25,41265,14385,26283,,21145808,11008947,961564,20094766,10047383,
2021-08-26,39216,13537,24938,,21185024,11022208,950128,20144160,10072080,
2021-08-27,37602,12895,23667,,21222626,11034862,939329,20191066,10095533,
2021-08-28,40050,13398,25481,,21262676,11047983,927222,20241522,10120761,
2021-08-29,30504,10231,19924,,21293180,11057982,917510,20280944,10140472,
2021-08-30,18209,6128,11835,,21311389,11063862,911774,20304176,10152088,
2021-08-31,32662,11921,19595,,21344051,11075516,904072,20342888,10171444,
2021-09-01,36176,12918,21921,,21380227,11088201,895053,20386296,10193148,
2021-09-02,37696,15614,19626,,21417923,11103563,891016,20425094,10212547,
2021-09-03,46803,21050,22405,,21464726,11124365,889642,20469446,10234723,
2021-09-04,46827,20577,24737,,21511553,11144697,885459,20518476,10259238,
2021-09-05,33020,14192,18544,,21544573,11158645,881087,20555116,10277558,
2021-09-06,21668,9473,12014,,21566241,11167869,878529,20578680,10289340,
2021-09-07,14956,6708,8067,,21581197,11174320,877153,20594334,10297167,
2021-09-08,41097,17091,20916,,21622294,11191147,873310,20635674,10317837,
2021-09-09,41392,16954,19642,,21663686,11207824,870597,20674454,10337227,
2021-09-10,39587,15488,18968,,21703273,11223050,867099,20711902,10355951,
2021-09-11,42325,15916,23311,,21745598,11238687,859683,20758008,10379004,
2021-09-12,29929,11524,17847,,21775527,11249917,853330,20793174,10396587,
2021-09-13,16051,6392,9167,,21791578,11256075,850540,20811070,10405535,
2021-09-14,29857,11543,15266,,21821435,11267317,846790,20841054,10420527,
2021-09-15,39234,14005,19402,,21860669,11281063,841378,20879370,10439685,
2021-09-16,39301,13964,19226,,21899970,11294792,836093,20917398,10458699,
2021-09-17,38876,13593,19307,,21938846,11308142,830367,20955550,10477775,
2021-09-18,41172,14070,23482,,21980018,11321939,820934,21002010,10501005,
2021-09-19,30607,10819,18949,,22010625,11332499,812791,21039416,10519708,
2021-09-20,16714,6096,10168,,22027339,11338342,808696,21059292,10529646,
2021-09-21,31319,11199,16968,,22058658,11349276,802911,21092730,10546365,
2021-09-22,41773,14806,22904,,22100431,11363786,794792,21137988,10568994,
2021-09-23,47182,16124,26004,,22147613,11379647,784893,21189508,10594754,
2021-09-24,46242,15618,26607,,22193855,11395004,773885,21242238,10621119,
2021-09-25,48151,15244,29918,,22242006,11409995,759192,21301606,10650803,
2021-09-26,37442,12408,24445,,22279448,11422128,747134,21349988,10674994,
2021-09-27,19141,6528,12309,,22298589,11428402,741337,21374130,10687065,
2021-09-28,30908,11280,17847,,22329497,11439423,734758,21409330,10704665,
2021-09-29,37846,12463,21701,,22367343,11451615,725500,21452230,10726115,
2021-09-30,37287,11634,21342,,22404630,11462990,715773,21494434,10747217,
2021-10-01,30825,9798,18379,,22435455,11472562,707179,21530766,10765383,
2021-10-02,37096,11147,23561,,22472551,11483439,694747,21577384,10788692,
2021-10-03,27189,8158,18315,,22499740,11491356,684577,21613558,10806779,
2021-10-04,14861,4743,9798,,22514601,11495853,679504,21632698,10816349,
2021-10-05,26770,8579,15838,,22541371,11504171,672230,21663882,10831941,
2021-10-06,31627,9630,18485,,22572998,11513542,663367,21700350,10850175,
2021-10-07,30310,9383,17097,,22603308,11522675,655640,21734070,10867035,
2021-10-08,32788,10729,18825,,22636096,11533134,647531,21771206,10885603,
2021-10-09,34095,10648,20987,,22670191,11543519,637178,21812682,10906341,
2021-10-10,23378,7654,15062,,22693569,11550923,629758,21842330,10921165,
2021-10-11,11989,3838,7857,,22705558,11554511,625723,21857576,10928788,
2021-10-12,5080,1620,3247,,22710638,11555853,624081,21863544,10931772,
2021-10-13,29074,9183,18064,,22739712,11564746,615184,21899124,10949562,
2021-10-14,28983,8898,17729,,22768695,11573369,606343,21934052,10967026,
2021-10-15,29049,8815,18144,,22797744,11581921,597001,21969840,10984920,
2021-10-16,31117,8978,19858,,22828861,11590608,586109,22008998,11004499,
2021-10-17,23670,7247,15355,,22852531,11597601,577988,22039226,11019613,
2021-10-18,12296,3746,8141,,22864827,11601066,573581,22054970,11027485,
2021-10-19,21236,6616,12610,,22886063,11607400,567574,22079652,11039826,
2021-10-20,25620,7533,14891,,22911683,11614686,560203,22108966,11054483,
2021-10-21,23144,6672,13014,,22934827,11621089,553850,22134478,11067239,
2021-10-22,26077,7298,15087,,22960904,11628065,546045,22164040,11082020,
2021-10-23,28140,7594,17135,,22989044,11635397,536497,22197800,11098900,
2021-10-24,19321,5729,12573,,23008365,11640870,529641,22222458,11111229,
2021-10-25,9915,2709,6469,,23018280,11643310,525873,22234874,11117437,
2021-10-26,18853,5375,11067,,23037133,11648407,520172,22256470,11128235,
2021-10-27,22807,6066,13184,,23059940,11654218,513040,22282356,11141178,
2021-10-28,22271,5790,12621,,23082211,11659720,506198,22307044,11153522,
2021-10-29,22773,5725,13025,,23104984,11665144,498884,22332520,11166260,
2021-10-30,24074,6030,14595,,23129058,11670902,490307,22361190,11180595,
2021-10-31,16450,4586,10584,,23145508,11675194,484304,22381780,11190890,
2021-11-01,7853,2071,5048,,23153361,11676985,481314,22391342,11195671,
2021-11-02,15602,4362,7730,,23168963,11681056,477935,22406242,11203121,
2021-11-03,18597,5065,9590,,23187560,11685818,473400,22424836,11212418,
2021-11-04,19470,4863,10011,,23207030,11690405,468237,22444336,11222168,
2021-11-05,21430,4393,9507,,23228460,11694510,463109,22462802,11231401,
2021-11-06,25307,5198,12145,,23253767,11699439,456145,22486588,11243294,
2021-11-07,21422,4019,8902,,23275189,11703178,451250,22503856,11251928,
2021-11-08,11982,2108,4727,,23287171,11704991,448615,22512752,11256376,
2021-11-09,24085,3842,7622,,23311256,11708512,444825,22527374,11263687,
2021-11-10,28437,4500,8971,,23339693,11712734,440340,22544788,11272394,
2021-11-11,28719,4293,9075,,23368412,11716731,435549,22562364,11281182,
2021-11-12,26709,4155,8215,,23395121,11720595,431475,22578240,11289120,
2021-11-13,34269,5069,11390,,23429390,11725358,425145,22600426,11300213,
2021-11-14,23183,3895,8586,,23452573,11728990,420447,22617086,11308543,
2021-11-15,12687,2186,4485,,23465260,11730916,418140,22625552,11312776,
2021-11-16,26138,3920,7460,,23491398,11734579,414596,22639966,11319983,
2021-11-17,31125,4046,7784,,23522523,11738343,410848,22654990,11327495,
2021-11-18,32455,3846,7503,,23554978,11741884,407177,22669414,11334707,
2021-11-19,35424,3854,7729,,23590402,11745438,403290,22684296,11342148,
2021-11-20,40087,4380,8806,,23630489,11749539,398855,22701368,11350684,
2021-11-21,28083,3431,6933,,23658572,11752708,395339,22714738,11357369,
2021-11-22,14879,1947,3885,,23673451,11754379,393395,22721968,11360984,
2021-11-23,33022,3269,5989,,23706473,11757368,390667,22733402,11366701,
2021-11-24,42604,3747,6779,,23749077,11760811,387624,22746374,11373187,
2021-11-25,45999,3928,6543,,23795076,11764465,385006,22758918,11379459,
2021-11-26,52799,11340,6594,,23847875,11775535,389745,22771580,11385790,
2021-11-27,63473,22344,7014,,23911348,11797598,405065,22785066,11392533,
2021-11-28,51428,27732,5301,,23962776,11825038,427484,22795108,11397554,
2021-11-29,33507,18931,2871,,23996283,11843708,443533,22800350,11400175,
2021-11-30,55973,20663,5110,,24052256,11864090,459076,22810028,11405014,
2021-12-01,69497,26234,5613,,24121753,11890018,479683,22820670,11410335,
2021-12-02,71582,26478,5013,,24193335,11916199,501135,22830128,11415064,
2021-12-03,73369,25090,5143,,24266704,11940993,521076,22839834,11419917,
2021-12-04,81107,27780,6047,47257,24347811,11968480,542800,,11425680,807194
2021-12-05,62602,31926,4393,26264,24410413,12000111,570325,,11429786,833354
2021-12-06,38610,19138,2706,16751,24449023,12018961,586750,,11432211,850027
2021-12-07,60241,14846,4447,40937,24509264,12033536,597139,,11436397,890890
2021-12-08,73408,19052,4665,49689,24582672,12052311,611516,,11440795,940501
2021-12-09,74456,18269,4328,51840,24657128,12070272,625449,,11444823,992257
2021-12-10,77423,17586,4626,55203,24734551,12087577,638404,,11449173,1047379
2021-12-11,83137,20400,5809,56916,24817688,12107688,652981,,11454707,1104209
2021-12-12,60722,22691,4142,33847,24878410,12130099,671524,,11458575,1137967
2021-12-13,34905,11592,2400,20891,24913315,12141394,680706,,11460688,1158763
2021-12-14,101916,8995,3840,89039,25015231,12150080,685847,,11464233,1247682
2021-12-15,127644,12420,4492,110696,25142875,12162196,693765,,11468431,1358278
2021-12-16,139293,12446,4227,122609,25282168,12174356,701974,,11472382,1480788
2021-12-17,159116,12387,4500,142206,25441284,12186470,709852,,11476618,1622897
2021-12-18,175536,13518,4909,157067,25616820,12199694,718449,,11481245,1779869
2021-12-19,140393,18155,3920,118285,25757213,12217548,732676,,11484872,1898043
2021-12-20,106795,10305,2740,93707,25864008,12227585,740231,,11487354,1991652
2021-12-21,215178,12962,4299,197896,26079186,12240231,748887,,11491344,2189427
2021-12-22,237151,14417,5177,217675,26316337,12254350,758113,,11496237,2406985
2021-12-23,257370,11706,5069,240500,26573707,12265753,764744,,11501009,2647379
2021-12-24,223338,9438,4540,209299,26797045,12274894,769638,,11505256,2856562
2021-12-25,89681,3886,2496,83311,26886726,12278505,771023,,11507482,2939766
2021-12-26,11890,387,354,11140,26898616,12278600,771048,,11507552,2950776
2021-12-27,46913,1495,1107,44283,26945529,12279850,771429,,11508421,2994939
2021-12-28,144720,6096,3984,134579,27090249,12285654,773530,,11512124,3129387
2021-12-29,175417,9376,4561,161413,27265666,12294735,778341,,11516394,3290673
2021-12-30,199993,10127,5330,184495,27465659,12304559,783123,,11521436,3475034
2021-12-31,195150,10006,5783,179111,27660809,12314276,787337,,11526939,3654019
2022-01-01,96915,5375,3869,87346,27757724,12319343,788835,,11530508,3741217
2022-01-02,19430,938,923,17440,27777154,12319990,788841,,11531149,3758511
2022-01-03,88236,4772,4588,78794,27865390,12324452,789017,,11535435,3837152
2022-01-04,146316,5997,5302,134977,28011706,12330122,789699,,11540423,3971974
2022-01-05,177411,7608,7278,162353,28189117,12337376,790018,,11547358,4134167
2022-01-06,191469,7197,6777,176971,28380586,12344254,790427,,11553827,4310983
2022-01-07,191173,7948,6970,175446,28571759,12351859,791393,,11560466,4486256
2022-01-08,181593,8612,6623,165172,28753352,12360139,793369,,11566770,4651272
2022-01-09,131062,9859,7168,113944,28884414,12369677,796055,,11573622,4765056
2022-01-10,90544,5105,4487,80825,28974958,12374460,796663,,11577797,4845728
2022-01-11,138821,6149,6555,125411,29113779,12380263,796244,,11584019,4970950
2022-01-12,156962,8154,8036,138654,29270741,12388089,796357,,11591732,5109436
2022-01-13,162604,9200,9197,141499,29433345,12396929,796347,,11600582,5250753
2022-01-14,159787,10740,10350,136007,29593132,12407311,796732,,11610579,5386564
2022-01-15,161154,11003,11665,135854,29754286,12417944,796059,,11621885,5522225
2022-01-16,109739,9282,9669,89434,29864025,12426865,795665,,11631200,5611442
2022-01-17,65752,5934,6552,52625,29929777,12432466,795037,,11637429,5663883
2022-01-18,36066,2000,2114,31131,29965843,12434113,794913,,11639200,5694819
2022-01-19,101264,5573,6708,85924,30067107,12439287,793760,,11645527,5780517
2022-01-20,103549,6323,6993,85700,30170656,12445227,793082,,11652145,5865995
2022-01-21,102059,6225,8048,82472,30272715,12451049,791245,,11659804,5948240
2022-01-22,102535,8708,12064,78087,30375250,12459368,787882,,11671486,6026099
2022-01-23,76655,7305,13976,54774,30451905,12466331,781204,,11685127,6080651
2022-01-24,42239,3190,7927,30734,30494144,12469157,776449,,11692708,6111178
2022-01-25,62528,3754,8361,48096,30556672,12472532,771827,,11700705,6159056
2022-01-26,77846,4912,13160,55668,30634518,12477069,763574,,11713495,6214483
2022-01-27,78035,4894,13236,56020,30712553,12481592,755222,,11726370,6270266
2022-01-28,77245,4666,13667,53871,30789798,12485900,746208,,11739692,6323918
2022-01-29,84777,5529,17698,58091,30874575,12491067,734032,,11757035,6381765
2022-01-30,66475,5024,20619,40138,30941050,12495750,718423,,11777327,6421679
2022-01-31,34720,2172,9873,22335,30975770,12497604,710713,,11786891,6443826
2022-02-01,51323,3265,9649,36515,31027093,12500517,704319,,11796198,6480116
2022-02-02,57682,3845,12388,38664,31084775,12504033,695761,,11808272,6518582
2022-02-03,52565,3609,11503,34294,31137340,12507266,687855,,11819411,6552625
2022-02-04,43055,2942,10551,27268,31180395,12509899,680236,,11829663,6579700
2022-02-05,58688,3737,14462,37551,31239083,12513307,669499,,11843808,6617040
2022-02-06,49841,3638,16109,29565,31288924,12516624,657023,,11859601,6646381
2022-02-07,23212,1686,7801,13432,31312136,12517985,650895,,11867090,6659589
2022-02-08,33359,2350,7235,21958,31345495,12520006,646003,,11874003,6681314
2022-02-09,38853,2779,8906,24401,31384348,12522428,639870,,11882558,6705463
2022-02-10,37515,2762,8827,22544,31421863,12524854,633801,,11891053,6727777
2022-02-11,39410,2714,10283,22991,31461273,12527222,626223,,11900999,6750530
2022-02-12,42021,2954,11451,25300,31503294,12529845,617715,,11912130,6775607
2022-02-13,36294,2799,13136,19934,31539588,12532358,607375,,11924983,6795343
2022-02-14,16959,1174,6113,9464,31556547,12533258,602429,,11930829,6804607
2022-02-15,19321,1381,4737,11865,31575868,12534320,599063,,11935257,6816248
2022-02-16,26001,1762,7721,14943,31601869,12535786,593100,,11942686,6830991
2022-02-17,26737,1678,7515,14976,31628606,12537111,587254,,11949857,6845713
2022-02-18,23914,1351,6597,13666,31652520,12538146,581997,,11956149,6859170
2022-02-19,37810,1903,8329,26038,31690330,12539718,575566,,11964152,6884967
2022-02-20,32556,1492,7958,22799,31722886,12540911,569092,,11971819,6907563
2022-02-21,17492,914,3673,12753,31740378,12541531,566324,,11975207,6920105
2022-02-22,9085,427,1544,6945,31749463,12541669,565202,,11976467,6926840
2022-02-23,25313,1326,4784,17286,31774776,12542687,561737,,11980950,6943892
2022-02-24,24547,1394,5232,15469,31799323,12543761,557895,,11985866,6959119
2022-02-25,23080,1384,5131,14500,31822403,12544852,554141,,11990711,6973393
2022-02-26,25210,1383,5902,16547,31847613,12545926,549615,,11996311,6989715
2022-02-27,26934,1364,7359,17697,31874547,12547021,543609,,12003412,7007217
2022-02-28,10120,592,2525,6743,31884667,12547361,541668,,12005693,7013777
2022-03-01,13170,942,3141,8156,31897837,12547999,539459,,12008540,7021717
2022-03-02,15398,1160,3573,9609,31913235,12548899,537039,,12011860,7031149
2022-03-03,14285,1077,3220,8683,31927520,12549665,534889,,12014776,7039601
2022-03-04,14450,987,3437,8306,31941970,12550331,532435,,12017896,7047654
2022-03-05,18518,1276,4990,11179,31960488,12551300,528710,,12022590,7058611
2022-03-06,16500,1086,5520,9598,31976988,12552109,524270,,12027839,7068003
2022-03-07,5935,462,1852,3508,31982923,12552286,522873,,12029413,7071294
2022-03-08,7347,698,1932,4155,31990270,12552707,521632,,12031075,7075251
2022-03-09,11147,906,2734,6401,32001417,12553337,519798,,12033539,7081450
2022-03-10,12739,1039,3245,6829,32014156,12554099,517585,,12036514,7088066
2022-03-11,12874,902,3401,6860,32027030,12554713,515078,,12039635,7094711
2022-03-12,14666,1044,4170,8307,32041696,12555487,511949,,12043538,7102816
2022-03-13,14735,1088,4994,8329,32056431,12556288,508039,,12048249,7110911
2022-03-14,6318,446,2223,3492,32062749,12556465,506259,,12050206,7114190
2022-03-15,10188,789,2620,5972,32072937,12556964,504416,,12052548,7119948
2022-03-16,13043,928,3657,6949,32085980,12557604,501684,,12055920,7126667
2022-03-17,13162,1042,3950,6749,32099142,12558359,498769,,12059590,7133197
2022-03-18,11889,910,3138,6427,32111031,12558967,496531,,12062436,7139401
2022-03-19,14425,1001,4158,7895,32125456,12559690,493372,,12066318,7147078
2022-03-20,11722,989,3947,6360,32137178,12560409,490409,,12070000,7153230
2022-03-21,5051,413,1587,2812,32142229,12560564,489231,,12071333,7155840
2022-03-22,6693,550,1551,3886,32148922,12560830,488225,,12072605,7159513
2022-03-23,9956,782,2294,5191,32158878,12561298,486710,,12074588,7164463
2022-03-24,9279,720,2373,4605,32168157,12561754,485048,,12076706,7168864
2022-03-25,9205,781,2147,4743,32177362,12562272,483674,,12078598,7173395
2022-03-26,10911,930,2828,5501,32188273,12562929,481774,,12081155,7178681
2022-03-27,10214,909,3534,5296,32198487,12563579,479145,,12084434,7183766
2022-03-28,3577,319,1107,1986,32202064,12563661,478354,,12085307,7185560
2022-03-29,5329,501,1206,2682,32207393,12563880,477643,,12086237,7188021
2022-03-30,7835,747,1828,4114,32215228,12564349,476557,,12087792,7191911
2022-03-31,8642,689,1923,4410,32223870,12564753,475317,,12089436,7196103
2022-04-01,9289,801,1910,4883,32233159,12565263,474199,,12091064,7200748
2022-04-02,10425,891,2207,5560,32243584,12565868,472871,,12092997,7206091
2022-04-03,9190,877,2564,5062,32252774,12566492,471178,,12095314,7210955
2022-04-04,4191,387,1002,2405,32256965,12566618,470560,,12096058,7213157
2022-04-05,6058,597,1033,3048,32263023,12566879,470118,,12096761,7215933
2022-04-06,8363,715,1478,4370,32271386,12567304,469350,,12097954,7220077
2022-04-07,10324,732,1679,4834,32281710,12567737,468398,,12099339,7224669
2022-04-08,23979,810,1574,4834,32305689,12568271,467628,,12100643,7229288
2022-04-09,30464,968,1966,5892,32336153,12568942,466621,,12102321,7234958
2022-04-10,24842,978,2383,5329,32360995,12569663,465210,,12104453,7240087
2022-04-11,12567,385,874,2431,32373562,12569800,464717,,12105083,7242318
2022-04-12,28100,691,1013,3532,32401662,12570189,464388,,12105801,7245618
2022-04-13,37762,851,1552,4923,32439424,12570741,463683,,12107058,7250311
2022-04-14,37869,761,1605,4905,32477293,12571191,462836,,12108355,7254964
2022-04-15,43388,1230,2101,6724,32520681,12572124,461961,,12110163,7261452
2022-04-16,8083,357,646,1736,32528764,12572222,461670,,12110552,7262973
2022-04-17,20999,867,1923,4312,32549763,12572806,460607,,12112199,7267063
2022-04-18,5451,303,460,1287,32555214,12572825,460445,,12112380,7268112
2022-04-19,22644,615,770,3101,32577858,12573159,460281,,12112878,7270994
2022-04-20,40313,1062,1392,4613,32618171,12573897,459948,,12113949,7275344
2022-04-21,38736,940,1595,4676,32656907,12574543,459286,,12115257,7279786
2022-04-22,35603,1009,1425,4263,32692510,12575281,458863,,12116418,7283832
2022-04-23,34634,1003,1732,4710,32727144,12576004,458131,,12117873,7288306
2022-04-24,20800,1020,1879,3777,32747944,12576775,457269,,12119506,7291890
2022-04-25,8296,451,691,1707,32756240,12576959,457028,,12119931,7293382
2022-04-26,24597,732,939,3136,32780837,12577401,456815,,12120586,7296283
2022-04-27,33581,954,1365,3928,32814418,12578082,456396,,12121686,7299997
2022-04-28,32824,928,1411,3927,32847242,12578739,455905,,12122834,7303702
2022-04-29,32037,1096,1373,3907,32879279,12579539,455621,,12123918,7307381
2022-04-30,30261,920,1531,4017,32909540,12580166,455004,,12125162,7311164
2022-05-01,16743,767,1576,2969,32926283,12580638,454190,,12126448,7313891
2022-05-02,5930,307,524,1097,32932213,12580653,453969,,12126684,7314763
2022-05-03,20917,588,827,2344,32953130,12580936,453724,,12127212,7316868
2022-05-04,29401,799,1089,3290,32982531,12581428,453429,,12127999,7319911
2022-05-05,29085,872,1158,3121,33011616,12581990,453133,,12128857,7322790
2022-05-06,29076,1145,1279,2982,33040692,12582851,452996,,12129855,7325547
2022-05-07,28475,869,1260,3105,33069167,12583432,452600,,12130832,7328429
2022-05-08,15993,895,1307,2323,33085160,12584071,452186,,12131885,7330552
2022-05-09,5894,292,474,943,33091054,12584099,451998,,12132101,7331287
2022-05-10,21217,695,717,2117,33112271,12584478,451969,,12132509,7333146
2022-05-11,28932,835,1078,2651,33141203,12584989,451722,,12133267,7335531
2022-05-12,28228,800,1081,2510,33169431,12585495,451437,,12134058,7337802
2022-05-13,27585,879,1114,2466,33197016,12586068,451198,,12134870,7340015
2022-05-14,25679,809,1095,2605,33222695,12586566,450905,,12135661,7342368
2022-05-15,14841,751,1271,2054,33237536,12587047,450378,,12136669,7344205
2022-05-16,6378,325,532,1046,33243914,12587137,450167,,12136970,7345067
2022-05-17,19587,584,774,1737,33263501,12587414,449970,,12137444,7346561
2022-05-18,26535,877,1096,2271,33290036,12588030,449747,,12138283,7348618
2022-05-19,24420,681,1152,2156,33314456,12588444,449269,,12139175,7350557
2022-05-20,24253,799,1133,2214,33338709,12588982,448931,,12140051,7352557
2022-05-21,22389,692,1163,2343,33361098,12589369,448451,,12140918,7354662
2022-05-22,10552,551,887,1484,33371650,12589661,448110,,12141551,7355931
2022-05-23,4557,241,460,783,33376207,12589646,447889,,12141757,7356507
2022-05-24,2604,118,175,429,33378811,12589512,447830,,12141682,7356728
2022-05-25,19348,656,943,1950,33398159,12589909,447533,,12142376,7358472
2022-05-26,20628,661,948,1907,33418787,12590299,447240,,12143059,7360159
2022-05-27,21742,815,1055,2068,33440529,12590837,446997,,12143840,7362005
2022-05-28,19394,723,1162,2143,33459923,12591297,446555,,12144742,7363939
2022-05-29,12097,759,1279,1723,33472020,12591822,446028,,12145794,7365470
2022-05-30,4575,311,548,751,33476595,12591892,445788,,12146104,7366028
2022-05-31,13541,571,748,1663,33490136,12592167,445605,,12146562,7367455
2022-06-01,16601,702,969,1874,33506737,12592569,445337,,12147232,7369076
2022-06-02,14587,555,864,1667,33521324,12592818,445021,,12147797,7370507
2022-06-03,16086,697,1090,1808,33537410,12593245,444622,,12148623,7372102
2022-06-04,13301,648,1159,1838,33550711,12593641,444107,,12149534,7373742
2022-06-05,7864,587,1109,1430,33558575,12593985,443581,,12150404,7374984
2022-06-06,3293,206,444,641,33561868,12593946,443340,,12150606,7375427
2022-06-07,11202,474,724,1361,33573070,12594124,443085,,12151039,7376546
2022-06-08,14049,667,1012,1605,33587119,12594540,442735,,12151805,7377938
2022-06-09,13357,662,920,1666,33600476,12594920,442472,,12152448,7379376
2022-06-10,13834,683,1063,1691,33614310,12595325,442085,,12153240,7380842
2022-06-11,12968,613,1030,1862,33627278,12595663,441666,,12153997,7382489
2022-06-12,8088,643,1234,1498,33635366,12596056,441071,,12154985,7383787
2022-06-13,3184,283,422,708,33638550,12596080,440927,,12155153,7384292
2022-06-14,10120,510,666,1261,33648670,12596307,440765,,12155542,7385318
2022-06-15,13495,469,828,1620,33662165,12596489,440404,,12156085,7386707
2022-06-16,12524,491,852,1614,33674689,12596686,440038,,12156648,7388082
2022-06-17,11684,478,815,1652,33686373,12596881,439694,,12157187,7389501
2022-06-18,11440,436,874,1857,33697813,12597054,439253,,12157801,7391140
2022-06-19,6996,482,897,1419,33704809,12597296,438837,,12158459,7392357
2022-06-20,2285,147,301,642,33707094,12597231,438677,,12158554,7392837
2022-06-21,9531,358,614,1380,33716625,12597310,438416,,12158894,7393977
2022-06-22,13599,407,724,1696,33730224,12597449,438092,,12159357,7395452
2022-06-23,13690,399,771,1679,33743914,12597593,437718,,12159875,7396926
2022-06-24,15350,431,810,1669,33759264,12597772,437335,,12160437,7398385
2022-06-25,14460,424,850,1708,33773724,12597946,436899,,12161047,7399892
2022-06-26,8154,432,885,1278,33781878,12598127,436439,,12161688,7400962
2022-06-27,3209,171,363,592,33785087,12598064,436243,,12161821,7401357
2022-06-28,9607,370,554,1218,33794694,12598154,436055,,12162099,7402346
2022-06-29,13294,411,723,1626,33807988,12598283,435741,,12162542,7403739
2022-06-30,12215,481,844,1573,33820203,12598489,435376,,12163113,7405088
2022-07-01,13032,548,970,1946,33833235,12598789,434949,,12163840,7406836
2022-07-02,1604,108,114,361,33834839,12598628,434941,,12163687,7406971
2022-07-03,5154,261,491,956,33839993,12598647,434703,,12163944,7407725
2022-07-04,2754,131,278,614,33842747,12598537,434555,,12163982,7408147
2022-07-05,11138,372,598,1572,33853885,12598624,434322,,12164302,7409481
2022-07-06,15945,544,855,2006,33869830,12598881,434005,,12164876,7411252
2022-07-07,15648,521,830,1920,33885478,12599119,433695,,12165424,7412924
2022-07-08,17868,551,869,2240,33903346,12599378,433376,,12166002,7414922
2022-07-09,14130,450,598,1837,33917476,12599563,433227,,12166336,7416533
2022-07-10,8734,470,752,1499,33926210,12599794,432944,,12166850,7417832
2022-07-11,4092,199,331,870,33930302,12599738,432809,,12166929,7418490
2022-07-12,12094,411,523,1650,33942396,12599856,432692,,12167164,7419891
2022-07-13,16704,560,770,2140,33959100,12600132,432476,,12167656,7421799
2022-07-14,16848,485,672,2021,33975948,12600315,432278,,12168037,7423583
2022-07-15,28879,599,819,2177,34004827,12600621,432057,,12168564,7425523
2022-07-16,30276,584,768,2321,34035103,12600903,431866,,12169037,7427601
2022-07-17,22902,536,633,1871,34058005,12601209,431766,,12169443,7429284
2022-07-18,11386,187,254,851,34069391,12601137,431694,,12169443,7429919
2022-07-19,28935,593,590,2125,34098326,12601464,431694,,12169770,7431819
2022-07-20,37613,840,921,2582,34135939,12602037,431608,,12170429,7434173
2022-07-21,36334,736,807,2798,34172273,12602498,431530,,12170968,7436741
2022-07-22,35784,825,886,2678,34208057,12603051,431463,,12171588,7439194
2022-07-23,35114,814,911,2818,34243171,12603564,431358,,12172206,7441764
2022-07-24,21723,603,801,1767,34264894,12603917,431158,,12172759,7443312
2022-07-25,11923,308,305,1079,34276817,12603954,431157,,12172797,7444170
2022-07-26,26068,618,596,2204,34302885,12604301,431178,,12173123,7446138
2022-07-27,32451,809,842,2643,34335336,12604859,431143,,12173716,7448576
2022-07-28,31522,728,880,2596,34366858,12605302,430988,,12174314,7450931
2022-07-29,29969,1787,871,2636,34396827,12606809,431901,,12174908,7453324
2022-07-30,25798,2521,742,2425,34422625,12609068,433678,,12175390,7455532
2022-07-31,14280,1068,540,1551,34436905,12609879,434202,,12175677,7456866
2022-08-01,5906,336,222,678,34442811,12609964,434314,,12175650,7457328
2022-08-02,4461,305,131,594,34447272,12610011,434486,,12175525,7457707
2022-08-03,22921,2634,735,2231,34470193,12612387,436381,,12176006,7459718
2022-08-04,22211,2479,674,2126,34492404,12614559,438181,,12176378,7461591
2022-08-05,21780,2756,742,2063,34514184,12617048,440188,,12176860,7463436
2022-08-06,19636,2877,656,1988,34533820,12619636,442403,,12177233,7465184
2022-08-07,12686,2236,616,1413,34546506,12621614,444017,,12177597,7466391
2022-08-08,4763,570,188,603,34551269,12621914,444392,,12177522,7466771
2022-08-09,13993,1463,554,1587,34565262,12623100,445295,,12177805,7468124
2022-08-10,19113,2365,716,1982,34584375,12625198,446942,,12178256,7469884
2022-08-11,17065,2043,715,1848,34601440,12626984,448268,,12178716,7471515
2022-08-12,16970,2049,730,1848,34618410,12628755,449586,,12179169,7473144
2022-08-13,15938,2224,759,1799,34634348,12630708,451049,,12179659,7474713
2022-08-14,9516,1620,616,1079,34643864,12632052,452049,,12180003,7475566
2022-08-15,3866,388,268,476,34647730,12632201,452166,,12180035,7475847
2022-08-16,10791,1074,509,1354,34658521,12632987,452729,,12180258,7476961
2022-08-17,16080,1831,735,1773,34674601,12634543,453824,,12180719,7478508
2022-08-18,14915,1640,744,1682,34689516,12635881,454716,,12181165,7479936
2022-08-19,15286,1848,740,1541,34704802,12637470,455820,,12181650,7481258
2022-08-20,14269,1642,736,1541,34719071,12638832,456720,,12182112,7482568
2022-08-21,9892,1535,658,1159,34728963,12640116,457594,,12182522,7483520
2022-08-22,4160,482,269,560,34733123,12640317,457804,,12182513,7483840
2022-08-23,11111,1246,550,1485,34744234,12641277,458497,,12182780,7485087
2022-08-24,14740,1806,866,2182,34758974,12642824,459437,,12183387,7487046
2022-08-25,14019,1720,779,2117,34772993,12644274,460372,,12183902,7488932
2022-08-26,13917,1688,812,2088,34786910,12645687,461241,,12184446,7490786
2022-08-27,12403,1485,877,1992,34799313,12646863,461844,,12185019,7492524
2022-08-28,7917,1258,619,1395,34807230,12647876,462481,,12185395,7493710
2022-08-29,3392,504,282,680,34810622,12648127,462701,,12185426,7494175
2022-08-30,9900,1169,647,1853,34820522,12648966,463218,,12185748,7495749
2022-08-31,13503,1626,944,2309,34834025,12650323,463896,,12186427,7497831
2022-09-01,12893,1721,909,2136,34846918,12651768,464704,,12187064,7499739
2022-09-02,15034,1614,989,4917,34861952,12653123,465322,,12187801,7504441
2022-09-03,14702,1527,920,5508,34876654,12654399,465926,,12188473,7509740
2022-09-04,8660,1012,673,3234,34885314,12655175,466258,,12188917,7512772
2022-09-05,3549,321,229,1382,34888863,12655254,466347,,12188907,7513950
2022-09-06,2452,153,113,1124,34891315,12655178,466384,,12188794,7514884
2022-09-07,10915,1018,586,3488,34902230,12655922,466814,,12189108,7518138
2022-09-08,10854,1020,523,2786,34913084,12656654,467308,,12189346,7520679
2022-09-09,9577,1015,486,2499,34922661,12657402,467832,,12189570,7522958
2022-09-10,10649,1267,552,3162,34933310,12658427,468544,,12189883,7525912
2022-09-11,9398,986,667,3730,34942708,12659186,468857,,12190329,7529449
2022-09-12,3124,295,203,1079,34945832,12659228,468944,,12190284,7530313
2022-09-13,6009,542,281,1130,34951841,12659521,469197,,12190324,7531233
2022-09-14,14472,798,430,1842,34966313,12660036,469561,,12190475,7532835
2022-09-15,15735,779,406,1531,34982048,12660534,469931,,12190603,7534122
2022-09-16,17743,767,445,1688,34999791,12661068,470247,,12190821,7535612
2022-09-17,17595,723,454,1663,35017386,12661528,470512,,12191016,7537054
2022-09-18,11206,776,451,1686,35028592,12662079,470836,,12191243,7538548
2022-09-19,4975,402,287,670,35033567,12662247,470949,,12191298,7539029
2022-09-20,13743,437,325,939,35047310,12662406,471059,,12191347,7539730
2022-09-21,23017,645,405,1495,35070327,12662788,471295,,12191493,7541006
2022-09-22,22886,638,394,1375,35093213,12663144,471534,,12191610,7542139
2022-09-23,22928,728,598,1414,35116141,12663611,471660,,12191951,7543328
2022-09-24,21663,736,685,1496,35137804,12664088,471708,,12192380,7544611
2022-09-25,11305,595,701,1354,35149109,12664439,471598,,12192841,7545759
2022-09-26,4556,192,217,593,35153665,12664385,471569,,12192816,7546137
2022-09-27,37638,503,362,1496,35191303,12664653,471707,,12192946,7547434
2022-09-28,50937,733,664,1898,35242240,12665153,471775,,12193378,7549136
2022-09-29,47986,637,738,1836,35290226,12665515,471668,,12193847,7550731
2022-09-30,47261,679,806,1999,35337487,12665913,471539,,12194374,7552490
2022-10-01,34423,527,631,1542,35371910,12666183,471434,,12194749,7553809
2022-10-02,24233,737,1023,1710,35396143,12666673,471145,,12195528,7555304
2022-10-03,10860,240,230,611,35407003,12666679,471151,,12195528,7555720
2022-10-04,32175,476,457,1168,35439178,12666880,471166,,12195714,7556651
2022-10-05,40407,626,740,1558,35479585,12667243,471049,,12196194,7557985
2022-10-06,38665,608,651,1567,35518250,12667596,471006,,12196590,7559327
2022-10-07,42097,663,846,1741,35560347,12667970,470816,,12197154,7560811
2022-10-08,37377,788,1145,2120,35597724,12668483,470454,,12198029,7562700
2022-10-09,18807,551,726,1558,35616531,12668815,470277,,12198538,7564067
2022-10-10,6861,171,369,568,35623392,12668742,470077,,12198665,7564419
2022-10-11,4980,124,110,317,35628372,12668624,470088,,12198536,7564533
2022-10-12,35084,583,682,1424,35663456,12668935,469988,,12198947,7565712
2022-10-13,36742,643,857,1620,35700198,12669292,469772,,12199520,7567086
2022-10-14,36953,623,752,1537,35737151,12669660,469642,,12200018,7568402
2022-10-15,35433,714,1010,1624,35772584,12670151,469346,,12200805,7569828
2022-10-16,20649,652,1024,1593,35793233,12670590,468970,,12201620,7571237
2022-10-17,7349,206,478,538,35800582,12670583,468698,,12201885,7571587
2022-10-18,36405,461,497,1397,35836987,12670793,468659,,12202134,7572764
2022-10-19,49859,622,729,1981,35886846,12671181,468550,,12202631,7574544
2022-10-20,51256,623,648,2047,35938102,12671568,468524,,12203044,7576393
2022-10-21,52822,698,617,1938,35990924,12672019,468602,,12203417,7578120
2022-10-22,50844,751,904,2305,36041768,12672524,468445,,12204079,7580214
2022-10-23,30617,577,783,2118,36072385,12672867,468236,,12204631,7582134
2022-10-24,14125,235,270,979,36086510,12672862,468197,,12204665,7582903
2022-10-25,41330,477,487,1813,36127840,12673069,468185,,12204884,7584483
2022-10-26,51609,619,660,2123,36179449,12673429,468141,,12205288,7586386
2022-10-27,50083,609,767,2161,36229532,12673787,467979,,12205808,7588330
2022-10-28,49739,590,673,2092,36279271,12674105,467894,,12206211,7590178
2022-10-29,50567,739,778,2215,36329838,12674574,467852,,12206722,7592158
2022-10-30,28384,664,928,2034,36358222,12675022,467587,,12207435,7594000
2022-10-31,12434,202,234,775,36370656,12675020,467553,,12207467,7594600
2022-11-01,33057,342,194,1217,36403713,12675091,467696,,12207395,7595584
2022-11-02,44257,577,623,1902,36447970,12675422,467649,,12207773,7597261
2022-11-03,44160,542,603,1857,36492130,12675725,467586,,12208139,7598907
2022-11-04,44588,644,527,2021,36536718,12676136,467700,,12208436,7600727
2022-11-05,45170,647,752,2362,36581888,12676554,467593,,12208961,7602886
2022-11-06,26008,561,771,2095,36607896,12676852,467381,,12209471,7604748
2022-11-07,10706,243,235,876,36618602,12676897,467386,,12209511,7605458
2022-11-08,33459,488,396,1585,36652061,12677177,467475,,12209702,7606865
2022-11-09,40513,609,570,1959,36692574,12677559,467513,,12210046,7608627
2022-11-10,39125,627,547,1922,36731699,12677946,467593,,12210353,7610336
2022-11-11,43315,637,640,2204,36775014,12678348,467589,,12210759,7612336
2022-11-12,36824,640,593,2182,36811838,12678749,467632,,12211117,7614307
2022-11-13,24250,560,771,2272,36836088,12679093,467418,,12211675,7616391
2022-11-14,10957,233,204,1023,36847045,12679108,467446,,12211662,7617220
2022-11-15,33445,487,376,1687,36880490,12679330,467554,,12211776,7618680
2022-11-16,43504,806,581,2359,36923994,12679922,467778,,12212144,7620851
2022-11-17,38311,674,646,2241,36962305,12680337,467804,,12212533,7622867
2022-11-18,40579,725,531,2327,37002884,12680804,467997,,12212807,7624967
2022-11-19,39625,1020,1029,3073,37042509,12681563,467984,,12213579,7627808
2022-11-20,22403,664,715,2441,37064912,12682032,467932,,12214100,7630078
2022-11-21,8917,197,192,969,37073829,12682036,467934,,12214102,7630891
2022-11-22,26421,484,368,1507,37100250,12682243,468047,,12214196,7632153
2022-11-23,32041,687,663,2065,37132291,12682676,468069,,12214607,7633996
2022-11-24,31884,666,750,2077,37164175,12683106,467984,,12215122,7635868
2022-11-25,30729,767,829,1946,37194904,12683655,467917,,12215738,7637630
2022-11-26,30247,914,1189,2694,37225151,12684322,467636,,12216686,7640106
2022-11-27,18667,611,943,2086,37243818,12684704,467302,,12217402,7641988
2022-11-28,7533,190,280,785,37251351,12684672,467208,,12217464,7642577
2022-11-29,21008,423,449,1290,37272359,12684861,467179,,12217682,7643661
2022-11-30,27870,645,645,1839,37300229,12685285,467177,,12218108,7645302
2022-12-01,24775,595,681,1687,37325004,12685662,467089,,12218573,7646795
2022-12-02,25042,527,628,1771,37350046,12685956,466983,,12218973,7648360
2022-12-03,25529,588,779,1941,37375575,12686319,466786,,12219533,7650120
2022-12-04,15243,497,606,1697,37390818,12686589,466673,,12219916,7651614
2022-12-05,6866,170,156,740,37397684,12686550,466684,,12219866,7652173
2022-12-06,20318,421,351,1371,37418002,12686725,466753,,12219972,7653324
2022-12-07,24699,554,608,1667,37442701,12687071,466697,,12220374,7654811
2022-12-08,23130,563,523,1759,37465831,12687415,466736,,12220679,7656375
2022-12-09,23303,637,575,1629,37489134,12687821,466797,,12221024,7657806
2022-12-10,22555,511,598,1626,37511689,12688122,466709,,12221413,7659247
2022-12-11,14191,548,785,1567,37525880,12688490,466470,,12222020,7660654
2022-12-12,5506,151,157,592,37531386,12688444,466461,,12221983,7661081
2022-12-13,17752,380,365,1122,37549138,12688595,466476,,12222119,7662005
2022-12-14,21308,512,549,1450,37570446,12688927,466435,,12222492,7663295
2022-12-15,21917,532,597,1576,37592363,12689225,466369,,12222856,7664664
2022-12-16,16259,378,450,1026,37608622,12689377,466297,,12223080,7665495
2022-12-17,18677,561,505,1269,37627299,12689729,466352,,12223377,7666571
2022-12-18,12628,530,795,1302,37639927,12690068,466086,,12223982,7667699
2022-12-19,4585,134,115,447,37644512,12689978,466102,,12223876,7667946
2022-12-20,16192,502,449,1105,37660704,12690277,466152,,12224125,7668870
2022-12-21,18440,543,548,1296,37679144,12690635,466145,,12224490,7670000
2022-12-22,18559,578,586,1737,37697703,12691022,466137,,12224885,7671571
2022-12-23,15611,581,596,1711,37713314,12691381,466119,,12225262,7673095
2022-12-24,5321,221,168,670,37718635,12691397,466172,,12225225,7673576
2022-12-25,2439,153,152,480,37721074,12691363,466166,,12225197,7673893
2022-12-26,262,12,7,48,37721336,12691182,466168,,12225014,7673770
2022-12-27,2085,99,35,300,37723421,12691128,466230,,12224898,7673934
2022-12-28,8303,336,167,974,37731724,12691250,466397,,12224853,7674714
2022-12-29,13149,585,524,1601,37744873,12691641,466455,,12225186,7676145
2022-12-30,15807,674,658,1874,37760680,12692121,466469,,12225652,7677842
2022-12-31,11219,461,387,1352,37771899,12692353,466539,,12225814,7678994
2023-01-01,3882,204,213,558,37775781,12692379,466529,,12225850,7679397
2023-01-02,649,37,13,96,37776430,12692267,466553,,12225714,7679362
2023-01-03,8185,301,151,898,37784615,12692414,466700,,12225714,7680130
2023-01-04,14698,578,547,1543,37799313,12692836,466725,,12226111,7681538
2023-01-05,16077,658,530,1789,37815390,12693323,466851,,12226472,7683176
2023-01-06,18803,724,606,2035,37834193,12693888,466966,,12226922,7685070
2023-01-07,18483,710,637,2050,37852676,12694444,467036,,12227408,7686982
2023-01-08,11596,583,605,1629,37864272,12694893,467013,,12227880,7688492
2023-01-09,5288,216,196,664,37869560,12694968,467032,,12227936,7689031
2023-01-10,12148,424,313,777,37881708,12695226,467143,,12228083,7689657
2023-01-11,15498,460,369,1088,37897206,12695537,467233,,12228304,7690617
2023-01-12,14027,456,404,965,37911233,12695840,467285,,12228555,7691445
2023-01-13,14129,426,345,1034,37925362,12696141,467366,,12228775,7692364
2023-01-14,13345,480,453,1071,37938707,12696497,467392,,12229105,7693320
2023-01-15,9032,471,502,1047,37947739,12696836,467360,,12229476,7694257
2023-01-16,3735,150,128,478,37951474,12696865,467382,,12229483,7694624
2023-01-17,8812,272,177,645,37960286,12696998,467477,,12229521,7695148
2023-01-18,10207,355,273,753,37970493,12697241,467559,,12229682,7695797
2023-01-19,10537,326,318,751,37981030,12697442,467564,,12229878,7696437
2023-01-20,9764,323,271,710,37990794,12697664,467616,,12230048,7697053
2023-01-21,11250,365,395,900,38002044,12697950,467586,,12230364,7697883
2023-01-22,7545,349,403,812,38009589,12698229,467531,,12230698,7698631
2023-01-23,3370,146,131,287,38012959,12698318,467546,,12230772,7698868
2023-01-24,8233,234,163,542,38021192,12698471,467617,,12230854,7699343
2023-01-25,10240,352,296,653,38031432,12698761,467673,,12231088,7699942
2023-01-26,6677,242,205,456,38038109,12698953,467710,,12231243,7700355
2023-01-27,6812,254,196,476,38044921,12699190,467768,,12231422,7700815
2023-01-28,9237,314,336,677,38054158,12699492,467745,,12231747,7701481
2023-01-29,5911,240,338,676,38060069,12699731,467647,,12232084,7702156
2023-01-30,1891,98,79,206,38061960,12699829,467666,,12232163,7702362
2023-01-31,5729,161,150,403,38067689,12699981,467677,,12232304,7702757
2023-02-01,7143,256,247,478,38074832,12700237,467686,,12232551,7703235
2023-02-02,6082,297,231,464,38080914,12700534,467752,,12232782,7703699
