"report_date","previous_day_total_doses_administered","previous_day_at_least_one","previous_day_fully_vaccinated","previous_day_3doses","total_doses_administered","total_individuals_at_least_one","total_individuals_partially_vaccinated","total_doses_in_fully_vaccinated_individuals","total_individuals_fully_vaccinated","total_individuals_3doses"
2021-01-01,6252,6242,2,,32212,32157,32146,22,11,
2021-01-02,4615,4603,6,,36827,36708,36695,26,13,
2021-01-03,5396,5389,3,,42223,42097,42081,32,16,
2021-01-04,5996,5993,0,,48219,48089,48074,30,15,
2021-01-05,9687,9662,21,,57906,57749,57714,70,35,
2021-01-06,12793,12328,450,,70699,70074,69592,964,482,
2021-01-07,16219,15508,697,,86918,85581,84402,2358,1179,
2021-01-08,18039,17024,1002,,104957,102605,100424,4362,2181,
2021-01-09,19501,18424,1064,,124458,121028,117783,6490,3245,
2021-01-10,11373,11332,39,,135831,132352,129068,6568,3284,
2021-01-11,11712,11661,48,,147543,144013,140681,6664,3332,
2021-01-12,14469,14162,298,,162012,158167,154537,7260,3630,
2021-01-13,15437,13813,1594,,177449,171966,166744,10444,5222,
2021-01-14,19193,16740,2437,,196642,188700,181042,15316,7658,
2021-01-15,20076,18018,2038,,216718,206707,197011,19392,9696,
2021-01-16,17120,15936,1171,,233838,222627,211760,21734,10867,
2021-01-17,11261,10017,1237,,245099,232629,220527,24204,12102,
2021-01-18,6795,6712,73,,251894,239318,227146,24344,12172,
2021-01-19,11829,9721,2094,,263723,249018,234752,28532,14266,
2021-01-20,10804,7215,3572,,274527,256210,238373,35674,17837,
2021-01-21,10977,6856,4093,,285504,263050,241120,43860,21930,
2021-01-22,9038,4321,4697,,294542,267334,240709,53250,26625,
2021-01-23,7462,3044,4390,,302004,270348,239334,62028,31014,
2021-01-24,4390,1833,2536,,306394,272163,238613,67100,33550,
2021-01-25,5323,1049,4265,,311717,273180,235366,75628,37814,
2021-01-26,9393,2867,6498,,321110,276015,231704,88622,44311,
2021-01-27,9898,2866,7004,,331008,278852,227538,102628,51314,
2021-01-28,13120,5743,7335,,344128,284562,225913,117298,58649,
2021-01-29,10706,3291,7379,,354834,287822,221795,132054,66027,
2021-01-30,9192,2731,6424,,364026,290511,218063,144896,72448,
2021-01-31,3384,1570,1768,,367410,292047,217832,148430,74215,
2021-02-01,2126,489,1609,,369536,292502,216682,151640,75820,
2021-02-02,4419,1366,2996,,373955,293830,215018,157624,78812,
2021-02-03,6237,1717,4458,,380192,295506,212243,166526,83263,
2021-02-04,9094,1722,7293,,389286,297185,206635,181100,90550,
2021-02-05,8447,1469,6904,,397733,298614,201166,194896,97448,
2021-02-06,10669,1872,8737,,408402,300431,194255,212352,106176,
2021-02-07,7577,1729,5796,,415979,302120,190160,223920,111960,
2021-02-08,8221,3096,5081,,424200,305168,188140,234056,117028,
2021-02-09,15011,3860,11083,,439211,308986,180891,256190,128095,
2021-02-10,15514,4935,10518,,454725,313869,175281,277176,138588,
2021-02-11,16366,3899,12409,,471091,317716,166750,301932,150966,
2021-02-12,17678,2099,15528,,488769,319776,153302,332948,166474,
2021-02-13,16214,2446,13752,,504983,322177,141970,360414,180207,
2021-02-14,12883,924,11926,,517866,323053,130950,384206,192103,
2021-02-15,7862,486,7328,,525728,323491,124086,398810,199405,
2021-02-16,5995,1042,4903,,531723,324490,120205,408570,204285,
2021-02-17,10169,1610,8525,,541892,326056,113274,425564,212782,
2021-02-18,13874,2957,10873,,555766,328965,105340,447250,223625,
2021-02-19,18490,6213,12210,,574256,335126,99322,471608,235804,
2021-02-20,22631,11134,11444,,596887,346197,98987,494420,247210,
2021-02-21,17243,10386,6823,,614130,356523,102532,507982,253991,
2021-02-22,13588,8759,4777,,627718,365213,106494,517438,258719,
2021-02-23,17869,11126,6672,,645587,376283,110928,530710,265355,
2021-02-24,18578,13613,4884,,664165,389840,119643,540394,270197,
2021-02-25,20811,16490,4264,,684976,406264,131851,548826,274413,
2021-02-26,24910,21841,3007,,709886,428045,150662,554766,277383,
2021-02-27,27469,23586,3840,,737355,451567,170392,562350,281175,
2021-02-28,20586,19145,1406,,757941,470658,188119,565078,282539,
2021-03-01,18227,17030,1148,,776168,487626,203986,567280,283640,
2021-03-02,24692,22280,2327,,800860,509845,223924,571842,285921,
2021-03-03,30602,27966,2579,,831462,537760,249293,576934,288467,
2021-03-04,34698,32465,2147,,866160,570159,279595,581128,290564,
2021-03-05,40006,38171,1786,,906166,608282,315966,584632,292316,
2021-03-06,44157,41949,2170,,950323,650176,355731,588890,294445,
2021-03-07,32738,31559,1175,,983061,681661,386099,591124,295562,
2021-03-08,24040,22164,1861,,1007101,703757,406388,594738,297369,
2021-03-09,33297,29846,3423,,1040398,733537,432791,601492,300746,
2021-03-10,38347,34084,4218,,1078745,767547,462631,609832,304916,
2021-03-11,43984,40711,3234,,1122729,808192,500094,616196,308098,
2021-03-12,47716,46004,1689,,1170445,854132,544395,619474,309737,
2021-03-13,57936,55060,2849,,1228381,909121,596589,625064,312532,
2021-03-14,43422,42182,1222,,1271803,951220,637534,627372,313686,
2021-03-15,32814,31116,1682,,1304617,982277,666952,630650,315325,
2021-03-16,53962,51663,2282,,1358579,1033875,716311,635128,317564,
2021-03-17,61072,58531,2497,,1419651,1092340,772329,640022,320011,
2021-03-18,61558,59094,2436,,1481209,1151362,828968,644788,322394,
2021-03-19,64482,61150,3274,,1545691,1212434,886819,651230,325615,
2021-03-20,62576,59984,2560,,1608267,1272362,944235,656254,328127,
2021-03-21,44006,42480,1539,,1652273,1314777,985148,659258,329629,
2021-03-22,31002,30035,978,,1683275,1344724,1014173,661102,330551,
2021-03-23,54624,51850,2723,,1737899,1396479,1063268,666422,333211,
2021-03-24,76438,73256,3134,,1814337,1469645,1133357,672576,336288,
2021-03-25,82919,80338,2534,,1897256,1549904,1211139,677530,338765,
2021-03-26,87017,83487,3490,,1984273,1633310,1291107,684406,342203,
2021-03-27,80866,77912,2868,,2065139,1711119,1366113,690012,345006,
2021-03-28,67001,65411,1555,,2132140,1776440,1429936,693008,346504,
2021-03-29,51741,49050,2652,,2183881,1825410,1476300,698220,349110,
2021-03-30,73587,70175,3350,,2257468,1895508,1543089,704838,352419,
2021-03-31,93159,89507,3586,,2350627,1984917,1628965,711904,355952,
2021-04-01,89322,85443,3840,,2439949,2070262,1710523,719478,359739,
2021-04-02,93094,88865,4213,,2533043,2159041,1795141,727800,363900,
2021-04-03,61013,59333,1736,,2594056,2218283,1852698,731170,365585,
2021-04-04,72331,70676,1651,,2666387,2288848,1921670,734356,367178,
2021-04-05,53733,53262,470,,2720120,2342026,1974426,735200,367600,
2021-04-06,79589,77717,1888,,2799709,2419641,2050207,738868,369434,
2021-04-07,108016,104947,3056,,2907725,2524463,2152031,744864,372432,
2021-04-08,114084,110110,4028,,3021809,2634462,2258058,752808,376404,
2021-04-09,109857,105625,4303,,3131666,2739969,2359327,761284,380642,
2021-04-10,109251,105487,3854,,3240917,2845328,2460898,768860,384430,
2021-04-11,98632,95513,3259,,3339549,2940716,2553086,775260,387630,
2021-04-12,76074,75009,1158,,3415623,3015577,2626857,777440,388720,
2021-04-13,99478,96093,3402,,3515101,3111561,2719487,784148,392074,
2021-04-14,117051,113287,3649,,3632152,3224730,2829047,791366,395683,
2021-04-15,113566,109506,3898,,3745718,3334110,2934586,799048,399524,
2021-04-16,118090,113716,4194,,3863808,3447716,3044042,807348,403674,
2021-04-17,112427,107833,4454,,3976235,3555415,3147346,816138,408069,
2021-04-18,88748,86511,2102,,4064983,3641803,3231686,820234,410117,
2021-04-19,68976,67441,1453,,4133959,3709114,3297595,823038,411519,
2021-04-20,102120,98794,3120,,4236079,3807746,3393172,829148,414574,
2021-04-21,142054,137773,4045,,4378133,3945345,3526794,837102,418551,
2021-04-22,139506,135353,3911,,4517639,4080569,3658163,844812,422406,
2021-04-23,138224,131800,6176,,4655863,4212215,3783691,857048,428524,
2021-04-24,130300,126234,3891,,4786163,4338301,3905942,864718,432359,
2021-04-25,102022,98610,3180,,4888185,4436763,4001291,870944,435472,
2021-04-26,71008,69302,1558,,4959193,4505934,4068964,873940,436970,
2021-04-27,98519,95426,2900,,5057712,4601199,4161392,879614,439807,
2021-04-28,120587,115957,4437,,5178299,4716988,4272816,888344,444172,
2021-04-29,124494,119295,5050,,5302793,4836116,4386963,898306,449153,
2021-04-30,115832,110575,5015,,5418625,4946518,4492427,908182,454091,
2021-05-01,111311,107436,3653,,5529936,5053773,4596106,915334,457667,
2021-05-02,79147,76171,2863,,5609083,5129787,4669323,920928,460464,
2021-05-03,56796,55124,1599,,5665879,5184756,4722753,924006,462003,
2021-05-04,91938,88566,3284,,5757817,5273144,4807934,930420,465210,
2021-05-05,138009,133297,4620,,5895826,5406272,4936505,939534,469767,
2021-05-06,141842,136885,4818,,6037668,5542973,5068450,949046,474523,
2021-05-07,150295,145253,4837,,6187963,5688066,5208765,958602,479301,
2021-05-08,142474,137782,4440,,6330437,5825653,5341991,967324,483662,
2021-05-09,124818,121164,3483,,6455255,5946653,5459572,974162,487081,
2021-05-10,97817,95827,1885,,6553072,6042291,5553392,977798,488899,
2021-05-11,113547,108862,4497,,6666619,6150951,5657626,986650,493325,
2021-05-12,145061,138026,6886,,6811680,6288798,5788653,1000290,500145,
2021-05-13,142716,135322,7238,,6954396,6423945,5916636,1014618,507309,
2021-05-14,148877,138784,9922,,7103273,6562541,6045375,1034332,517166,
2021-05-15,159751,149701,9869,,7263024,6712055,6185095,1053920,526960,
2021-05-16,144366,136096,8063,,7407390,6847983,6313040,1069886,534943,
2021-05-17,114983,110885,3944,,7522373,6958679,6419868,1077622,538811,
2021-05-18,111352,100485,10664,,7633725,7058968,6509555,1098826,549413,
2021-05-19,149891,133474,16238,,7783616,7192290,6626713,1131154,565577,
2021-05-20,151582,131583,19778,,7935198,7323684,6738398,1170572,585286,
2021-05-21,165407,140897,24250,,8100605,7464400,6854941,1218918,609459,
2021-05-22,199456,172253,26975,,8300061,7636455,7000102,1272706,636353,
2021-05-23,139843,127472,12225,,8439904,7763749,7115233,1297032,648516,
2021-05-24,100301,93329,6827,,8540205,7856905,7201632,1310546,655273,
2021-05-25,90480,82993,7276,,8630685,7939735,7277253,1324964,662482,
2021-05-26,139797,113026,26507,,8770482,8052574,7363655,1377838,688919,
2021-05-27,152072,123052,28768,,8922554,8175469,7457851,1435236,717618,
2021-05-28,163880,132321,31250,,9086434,8307617,7558808,1497618,748809,
2021-05-29,153400,117138,36029,,9239834,8424605,7639823,1569564,784782,
2021-05-30,149733,119026,30479,,9389567,8543461,7728262,1630398,815199,
2021-05-31,99222,79827,19202,,9488789,8623118,7788781,1668674,834337,
2021-06-01,124216,90626,33251,,9613005,8713549,7846036,1735026,867513,
2021-06-02,145333,102163,42917,,9758338,8815531,7905170,1820722,910361,
2021-06-03,155385,99927,55177,,9913723,8915273,7949806,1930934,965467,
2021-06-04,181733,115547,65913,,10095456,9030621,7999329,2062584,1031292,
2021-06-05,172047,103446,68317,,10267503,9133869,8034345,2199048,1099524,
2021-06-06,163402,91875,71246,,10430905,9225566,8054866,2341400,1170700,
2021-06-07,119570,63063,56289,,10550475,9288432,8061518,2453828,1226914,
2021-06-08,161907,72462,89005,,10712382,9360705,8044866,2631678,1315839,
2021-06-09,181477,70815,110191,,10893859,9431343,8005394,2851898,1425949,
2021-06-10,185598,66433,118672,,11079457,9497573,7953043,3089060,1544530,
2021-06-11,204808,67528,136517,,11284265,9564915,7883950,3361930,1680965,
2021-06-12,199754,62688,136463,,11484019,9627421,7810085,3634672,1817336,
2021-06-13,190354,58901,130920,,11674373,9686147,7737971,3896352,1948176,
2021-06-14,137696,38701,98595,,11812069,9724652,7677986,4093332,2046666,
2021-06-15,189568,42624,146585,,12001637,9767057,7573903,4386308,2193154,
2021-06-16,206272,42440,163184,,12207909,9809301,7453066,4712470,2356235,
2021-06-17,210486,37950,171950,,12418395,9847036,7318943,5056186,2528093,
2021-06-18,217216,35372,181240,,12635611,9882218,7172977,5418482,2709241,
2021-06-19,215909,35507,179725,,12851520,9917519,7028665,5777708,2888854,
2021-06-20,186289,35579,150132,,13037809,9952900,6914022,6077756,3038878,
2021-06-21,120442,20834,99103,,13158251,9973539,6835650,6275778,3137889,
2021-06-22,204957,27530,176669,,13363208,10000875,6686426,6628898,3314449,
2021-06-23,230555,28640,201166,,13593763,10029315,6513808,7031014,3515507,
2021-06-24,227721,26685,200273,,13821484,10055804,6340134,7431340,3715670,
2021-06-25,251139,28001,222386,,14072623,10083603,6145666,7875874,3937937,
2021-06-26,261323,30020,230594,,14333946,10113397,5945007,8336780,4168390,
2021-06-27,205020,27803,176609,,14538966,10141018,5796129,8689778,4344889,
2021-06-28,199262,20957,177736,,14738228,10161777,5639277,9045000,4522500,
2021-06-29,250125,24498,224890,,14988353,10186034,5438798,9494472,4747236,
2021-06-30,275558,24182,250807,,15263911,10210013,5212099,9995828,4997914,
2021-07-01,271984,25315,246113,,15535895,10235110,4991222,10487776,5243888,
2021-07-02,144740,11596,132913,,15680635,10246532,4869833,10753398,5376699,
2021-07-03,216910,19937,196742,,15897545,10266247,4692955,11146584,5573292,
2021-07-04,196233,19468,176538,,16093778,10285529,4535818,11499422,5749711,
2021-07-05,148729,12449,136136,,16242507,10297788,4412069,11771438,5885719,
2021-07-06,220046,20001,199827,,16462553,10317573,4232173,12170800,6085400,
2021-07-07,246624,22973,223409,,16709177,10340320,4031659,12617322,6308661,
2021-07-08,231232,21371,209645,,16940409,10361485,3843314,13036342,6518171,
2021-07-09,227015,21516,205328,,17167424,10382799,3659432,13446734,6723367,
2021-07-10,209075,20543,188375,,17376499,10403138,3491533,13823210,6911605,
2021-07-11,171690,17589,153973,,17548189,10420526,3355095,14130862,7065431,
2021-07-12,123139,11445,111593,,17671328,10431782,3254895,14353774,7176887,
2021-07-13,178527,19042,159341,,17849855,10450602,3114529,14672146,7336073,
2021-07-14,180049,19308,160583,,18029904,10469695,2973202,14992986,7496493,
2021-07-15,167219,19593,147450,,18197123,10489077,2845298,15287558,7643779,
2021-07-16,169377,19922,149304,,18366500,10508797,2715867,15585860,7792930,
2021-07-17,173031,20277,152623,,18539531,10528825,2583464,15890722,7945361,
2021-07-18,133647,15944,117564,,18673178,10544585,2481808,16125554,8062777,
2021-07-19,91992,10422,81462,,18765170,10554794,2410730,16288128,8144064,
2021-07-20,133553,16961,116537,,18898723,10571515,2311090,16520850,8260425,
2021-07-21,140089,16987,123031,,19038812,10588287,2204993,16766588,8383294,
2021-07-22,125643,17662,107842,,19164455,10605725,2114766,16981918,8490959,
2021-07-23,120287,16999,103080,,19284742,10622483,2028643,17187680,8593840,
2021-07-24,126708,18337,108133,,19411450,10640617,1938807,17403620,8701810,
2021-07-25,103657,14871,88655,,19515107,10655264,1864980,17580568,8790284,
2021-07-26,66698,9892,56711,,19581805,10664939,1818124,17693630,8846815,
2021-07-27,92396,15323,76911,,19674201,10680001,1756492,17847018,8923509,
2021-07-28,93960,16477,77412,,19768161,10696243,1695513,18001460,9000730,
2021-07-29,89411,16709,72539,,19857572,10712720,1639639,18146162,9073081,
2021-07-30,84075,16106,67854,,19941647,10728598,1587851,18281494,9140747,
2021-07-31,83876,15737,67992,,20025523,10744117,1535568,18417098,9208549,
2021-08-01,61884,11325,50373,,20087407,10755216,1496485,18517462,9258731,
2021-08-02,42499,7422,34956,,20129906,10762440,1468919,18587042,9293521,
2021-08-03,33307,5962,27172,,20163213,10768169,1447686,18640966,9320483,
2021-08-04,61333,12379,48763,,20224546,10780313,1411265,18738096,9369048,
2021-08-05,59469,12557,46759,,20284015,10792662,1377019,18831286,9415643,
2021-08-06,56035,11861,43959,,20340050,10804263,1344890,18918746,9459373,
2021-08-07,62385,12137,50053,,20402435,10816139,1306931,19018416,9509208,
2021-08-08,48709,9282,39235,,20451144,10825193,1276955,19096476,9548238,
2021-08-09,30866,5941,24747,,20482010,10830920,1258122,19145596,9572798,
2021-08-10,49276,10518,38454,,20531286,10841158,1230152,19222012,9611006,
2021-08-11,48733,10769,37713,,20580019,10851680,1203177,19297006,9648503,
2021-08-12,49267,11209,37824,,20629286,10862638,1176520,19372236,9686118,
2021-08-13,49646,11740,37631,,20678932,10874137,1150599,19447076,9723538,
2021-08-14,51232,12139,38881,,20730164,10886026,1123831,19524390,9762195,
2021-08-15,41781,9859,31696,,20771945,10895683,1101964,19587438,9793719,
2021-08-16,26747,6190,20407,,20798692,10901650,1087721,19627858,9813929,
2021-08-17,40518,11064,29185,,20839210,10912464,1069576,19685776,9842888,
2021-08-18,41907,11977,29687,,20881117,10924199,1051834,19744730,9872365,
2021-08-19,45910,16543,29102,,20927027,10940491,1039247,19802488,9901244,
2021-08-20,46464,16303,29748,,20973491,10956538,1025775,19861526,9930763,
2021-08-21,47967,15154,32446,,21021458,10971432,1008450,19925964,9962982,
2021-08-22,34408,10812,23323,,21055866,10981997,995915,19972164,9986082,
2021-08-23,23228,7008,16001,,21079094,10988770,986901,20003738,10001869,
2021-08-24,37656,13376,23823,,21116750,11001892,976431,20050922,10025461,
2021-08-25,41367,14427,26329,,21158117,11016063,964510,20103106,10051553,
2021-08-26,39280,13558,24980,,21197397,11029345,953053,20152584,10076292,
2021-08-27,37685,12949,23690,,21235082,11042053,942285,20199536,10099768,
2021-08-28,40135,13427,25529,,21275217,11055201,930159,20250084,10125042,
2021-08-29,30566,10257,19947,,21305783,11065226,920450,20289552,10144776,
2021-08-30,18242,6142,11848,,21324025,11071120,914715,20312810,10156405,
2021-08-31,32720,11940,19625,,21356745,11082792,907002,20351580,10175790,
2021-09-01,36261,12953,21962,,21393006,11095512,897977,20395070,10197535,
2021-09-02,37793,15650,19675,,21430799,11110910,893927,20433966,10216983,
2021-09-03,46902,21102,22448,,21477701,11131763,892562,20478402,10239201,
2021-09-04,46887,20590,24781,,21524588,11152107,888348,20527518,10263759,
2021-09-05,33090,14210,18585,,21557678,11166073,883953,20564240,10282120,
2021-09-06,21723,9492,12039,,21579401,11175316,881389,20587854,10293927,
2021-09-07,15019,6732,8101,,21594420,11181791,880003,20603576,10301788,
2021-09-08,41155,17116,20939,,21635575,11198643,876162,20644962,10322481,
2021-09-09,41467,16986,19683,,21677042,11215352,873440,20683824,10341912,
2021-09-10,39662,15513,19014,,21716704,11230602,869921,20721362,10360681,
2021-09-11,42391,15939,23341,,21759095,11246262,862498,20767528,10383764,
2021-09-12,29975,11534,17872,,21789070,11257502,856130,20802744,10401372,
2021-09-13,16096,6407,9188,,21805166,11263675,853334,20820682,10410341,
2021-09-14,29918,11564,15297,,21835084,11274937,849574,20850726,10425363,
2021-09-15,39287,14025,19427,,21874371,11288702,844156,20889092,10444546,
2021-09-16,39356,13990,19250,,21913727,11302457,838873,20927168,10463584,
2021-09-17,38940,13614,19345,,21952667,11315828,833130,20965396,10482698,
2021-09-18,41266,14089,23553,,21993933,11329644,823645,21011998,10505999,
2021-09-19,30669,10829,18988,,22024602,11340214,815473,21049482,10524741,
2021-09-20,16737,6100,10179,,22041339,11346060,811371,21069378,10534689,
2021-09-21,31370,11218,16996,,22072709,11357013,805577,21102872,10551436,
2021-09-22,41821,14819,22931,,22114530,11371536,797444,21148184,10574092,
2021-09-23,47236,16139,26035,,22161766,11387410,787529,21199762,10599881,
2021-09-24,46329,15640,26665,,22208095,11402790,776485,21252610,10626305,
2021-09-25,48208,15258,29955,,22256303,11417795,761769,21312052,10656026,
2021-09-26,37518,12425,24498,,22293821,11429945,749675,21360540,10680270,
2021-09-27,19164,6532,12325,,22312985,11436223,743866,21384714,10692357,
2021-09-28,30966,11295,17888,,22343951,11447259,737261,21419996,10709998,
2021-09-29,37896,12477,21733,,22381847,11459465,727985,21462960,10731480,
2021-09-30,37353,11658,21378,,22419200,11470864,718246,21505236,10752618,
2021-10-01,30886,9811,18417,,22450086,11480448,709627,21541642,10770821,
2021-10-02,37145,11160,23592,,22487231,11491338,697177,21588322,10794161,
2021-10-03,27209,8165,18325,,22514440,11499262,687004,21624516,10812258,
2021-10-04,14869,4747,9803,,22529309,11503762,681930,21643664,10821832,
2021-10-05,26849,8601,15886,,22556158,11512102,674630,21674944,10837472,
2021-10-06,31676,9641,18519,,22587834,11521484,665744,21711480,10855740,
2021-10-07,30359,9402,17124,,22618193,11530635,658009,21745252,10872626,
2021-10-08,32848,10745,18857,,22651041,11541109,649883,21782452,10891226,
2021-10-09,34154,10668,21024,,22685195,11551514,639513,21824002,10912001,
2021-10-10,23421,7662,15091,,22708616,11558925,632072,21853706,10926853,
2021-10-11,12006,3839,7868,,22720622,11562514,628027,21868974,10934487,
2021-10-12,5125,1631,3276,,22725747,11563867,626367,21875000,10937500,
2021-10-13,29123,9193,18099,,22754870,11572770,617445,21910650,10955325,
2021-10-14,29024,8905,17754,,22783894,11581399,608586,21945626,10972813,
2021-10-15,29107,8833,18174,,22813001,11589969,599232,21981474,10990737,
2021-10-16,31144,8988,19873,,22844145,11598666,588335,22020662,11010331,
2021-10-17,23721,7264,15384,,22867866,11605676,580202,22050948,11025474,
2021-10-18,12311,3747,8151,,22880177,11609142,575786,22066712,11033356,
2021-10-19,21287,6631,12643,,22901464,11615490,569761,22091458,11045729,
2021-10-20,25678,7541,14928,,22927142,11622784,562361,22120846,11060423,
2021-10-21,23184,6684,13034,,22950326,11629199,556000,22146398,11073199,
2021-10-22,26136,7318,15122,,22976462,11636194,548180,22176028,11088014,
2021-10-23,28193,7606,17166,,23004655,11643538,538613,22209850,11104925,
2021-10-24,19357,5729,12605,,23024012,11649011,531725,22234572,11117286,
2021-10-25,9932,2710,6477,,23033944,11651452,527950,22247004,11123502,
2021-10-26,18930,5395,11108,,23052874,11656569,522228,22268682,11134341,
2021-10-27,22867,6082,13220,,23075741,11662396,515076,22294640,11147320,
2021-10-28,22311,5791,12648,,23098052,11667899,508208,22319382,11159691,
2021-10-29,22821,5733,13055,,23120873,11673330,500871,22344918,11172459,
2021-10-30,24127,6048,14624,,23145000,11679106,492283,22373646,11186823,
2021-10-31,16490,4596,10607,,23161490,11683408,486267,22394282,11197141,
2021-11-01,7875,2082,5056,,23169365,11685210,483280,22403860,11201930,
2021-11-02,15631,4364,7748,,23184996,11689285,479885,22418800,11209400,
2021-11-03,18636,5070,9608,,23203632,11694052,475337,22437430,11218715,
2021-11-04,19511,4875,10036,,23223143,11698651,470161,22456980,11228490,
2021-11-05,21475,4405,9526,,23244618,11702767,465026,22475482,11237741,
2021-11-06,25343,5209,12158,,23269961,11707707,458060,22499294,11249647,
2021-11-07,21457,4027,8926,,23291418,11711453,453149,22516608,11258304,
2021-11-08,11993,2111,4733,,23303411,11713269,450511,22525516,11262758,
2021-11-09,24135,3855,7654,,23327546,11716803,446702,22540202,11270101,
2021-11-10,28487,4510,9001,,23356033,11721037,442197,22557680,11278840,
2021-11-11,28773,4311,9103,,23384806,11725051,437396,22575310,11287655,
2021-11-12,26752,4166,8244,,23411558,11728926,433304,22591244,11295622,
2021-11-13,34321,5083,11416,,23445879,11733703,426962,22613482,11306741,
2021-11-14,23230,3901,8613,,23469109,11737341,422243,22630196,11315098,
2021-11-15,12703,2186,4496,,23481812,11739267,419925,22638684,11319342,
2021-11-16,26191,3934,7490,,23508003,11742945,416365,22653160,11326580,
2021-11-17,31183,4046,7831,,23539186,11746709,412570,22668278,11334139,
2021-11-18,32513,3868,7533,,23571699,11750270,408891,22682758,11341379,
2021-11-19,35487,3866,7759,,23607186,11753835,404986,22697698,11348849,
2021-11-20,40120,4382,8823,,23647306,11757936,400536,22714800,11357400,
2021-11-21,28127,3439,6952,,23675433,11761113,397009,22728208,11364104,
2021-11-22,14901,1951,3895,,23690334,11762787,395059,22735456,11367728,
2021-11-23,33062,3279,6012,,23723396,11765786,392318,22746936,11373468,
2021-11-24,42673,3762,6813,,23766069,11769244,389256,22759976,11379988,
2021-11-25,46049,3934,6578,,23812118,11772903,386609,22772588,11386294,
2021-11-26,52870,11348,6618,,23864988,11783980,391332,22785296,11392648,
2021-11-27,63531,22360,7043,,23928519,11806059,406639,22798840,11399420,
2021-11-28,51465,27742,5320,,23979984,11833509,429049,22808920,11404460,
2021-11-29,33531,18933,2886,,24013515,11852181,445085,22814192,11407096,
2021-11-30,56052,20690,5140,,24069567,11872590,460625,22823930,11411965,
2021-12-01,69549,26243,5642,,24139116,11898527,481212,22834630,11417315,
2021-12-02,71642,26489,5041,,24210758,11924718,502647,22844142,11422071,
2021-12-03,73434,25098,5175,,24284192,11949520,522564,22853912,11426956,
2021-12-04,81164,27784,6078,47282,24365356,11977010,544261,,11432749,807772
2021-12-05,62642,31932,4418,26270,24427998,12008647,571767,,11436880,833938
2021-12-06,38630,19144,2713,16758,24466628,12027501,588191,,11439310,850618
2021-12-07,60300,14853,4485,40948,24526928,12042082,598549,,11443533,891492
2021-12-08,73456,19058,4682,49713,24600384,12060863,612915,,11447948,941127
2021-12-09,74512,18279,4347,51866,24674896,12078833,626839,,11451994,992908
2021-12-10,77512,17589,4660,55251,24752408,12096141,639763,,11456378,1048078
2021-12-11,83201,20407,5841,56942,24835609,12116259,654315,,11461944,1104934
2021-12-12,60768,22699,4164,33862,24896377,12138678,672844,,11465834,1138707
2021-12-13,34941,11603,2415,20900,24931318,12149984,682022,,11467962,1159512
2021-12-14,101992,9002,3876,89070,25033310,12158675,687133,,11471542,1248462
2021-12-15,127706,12429,4516,110723,25161016,12170800,695036,,11475764,1359085
2021-12-16,139376,12468,4257,122634,25300392,12182982,703237,,11479745,1481620
2021-12-17,159185,12404,4526,142233,25459577,12195111,711106,,11484005,1623756
2021-12-18,175596,13523,4926,157101,25635173,12208340,719691,,11488649,1780762
2021-12-19,140446,18160,3936,118313,25775619,12226199,733907,,11492292,1898964
2021-12-20,106826,10305,2748,93726,25882445,12236236,741454,,11494782,1992592
2021-12-21,215406,12968,4325,198091,26097851,12248888,750090,,11498798,2190562
2021-12-22,237269,14427,5205,217754,26335120,12263015,759298,,11503717,2408198
2021-12-23,257792,11733,5093,240868,26592912,12274442,765932,,11508510,2648960
2021-12-24,223649,9465,4579,209537,26816561,12283610,770814,,11512796,2858381
2021-12-25,89737,3891,2513,83345,26906298,12287226,772187,,11515039,2941619
2021-12-26,11901,389,360,11142,26918199,12287323,772208,,11515115,2952631
2021-12-27,46946,1491,1116,44308,26965145,12288569,772576,,11515993,2996819
2021-12-28,144792,6101,4013,134615,27109937,12294376,774653,,11519723,3131303
2021-12-29,175477,9377,4586,161444,27285414,12303457,779440,,11524017,3292619
2021-12-30,200077,10135,5354,184546,27485491,12313289,784206,,11529083,3477031
2021-12-31,195222,10009,5809,179151,27680713,12323009,788397,,11534612,3656056
2022-01-01,96961,5384,3885,87365,27777674,12328084,789888,,11538196,3743272
2022-01-02,19453,944,931,17448,27797127,12328737,789892,,11538845,3760574
2022-01-03,88260,4774,4594,78811,27885387,12333201,790064,,11543137,3839232
2022-01-04,146384,6003,5325,135017,28031771,12338876,790729,,11548147,3974093
2022-01-05,177525,7636,7299,162416,28209296,12346158,791055,,11555103,4136349
2022-01-06,191558,7218,6790,177023,28400854,12353057,791472,,11561585,4313217
2022-01-07,191315,7971,7008,175522,28592169,12360684,792423,,11568261,4488566
2022-01-08,181700,8634,6647,165230,28773869,12368986,794397,,11574589,4653640
2022-01-09,131112,9871,7189,113959,28904981,12378535,797074,,11581461,4767439
2022-01-10,90564,5108,4489,80836,28995545,12383320,797683,,11585637,4848122
2022-01-11,138911,6167,6584,125454,29134456,12389140,797253,,11591887,4973386
2022-01-12,157050,8167,8063,138697,29291506,12396978,797352,,11599626,5111915
2022-01-13,162698,9216,9221,141551,29454204,12405832,797333,,11608499,5253283
2022-01-14,159906,10757,10389,136069,29614110,12416227,797696,,11618531,5389154
2022-01-15,161220,11017,11678,135891,29775330,12426872,797024,,11629848,5524852
2022-01-16,109794,9296,9679,89458,29885124,12435806,796634,,11639172,5614092
2022-01-17,65790,5940,6567,52642,29950914,12441410,795997,,11645413,5666549
2022-01-18,36130,2009,2138,31160,29987044,12443064,795857,,11647207,5697513
2022-01-19,101338,5589,6724,85965,30088382,12448253,794704,,11653549,5783251
2022-01-20,103615,6327,7008,85742,30191997,12454196,794015,,11660181,5868770
2022-01-21,102123,6237,8060,82514,30294120,12460029,792178,,11667851,5951056
2022-01-22,102606,8729,12078,78122,30396726,12468369,788822,,11679547,6028950
2022-01-23,76709,7310,14000,54800,30473435,12475336,782125,,11693211,6083528
2022-01-24,42269,3199,7936,30746,30515704,12478171,777370,,11700801,6114067
2022-01-25,62580,3760,8374,48125,30578284,12481549,772741,,11708808,6161972
2022-01-26,77899,4920,13172,55696,30656183,12486092,764484,,11721608,6217426
2022-01-27,78088,4899,13248,56055,30734271,12490619,756125,,11734494,6273244
2022-01-28,77298,4678,13678,53903,30811569,12494939,747112,,11747827,6326928
2022-01-29,84836,5532,17719,58121,30896405,12500107,734918,,11765189,6384804
2022-01-30,66516,5026,20633,40160,30962921,12504791,719297,,11785494,6424739
2022-01-31,34758,2179,9889,22351,30997679,12506651,711578,,11795073,6446901
2022-02-01,51359,3268,9665,36531,31049038,12509566,705171,,11804395,6483207
2022-02-02,57724,3850,12403,38683,31106762,12513085,696603,,11816482,6521690
2022-02-03,52589,3612,11513,34303,31159351,12516320,688690,,11827630,6555742
2022-02-04,43102,2946,10568,27286,31202453,12518954,681058,,11837896,6582833
2022-02-05,58735,3750,14475,37566,31261188,12522372,670321,,11852051,6620186
2022-02-06,49868,3643,16120,29574,31311056,12525692,657839,,11867853,6649536
2022-02-07,23246,1694,7812,13448,31334302,12527060,651708,,11875352,6662760
2022-02-08,33412,2362,7256,21975,31367714,12529092,646807,,11882285,6684502
2022-02-09,38897,2788,8925,24411,31406611,12531521,640664,,11890857,6708661
2022-02-10,37548,2766,8838,22558,31444159,12533950,634588,,11899362,6730988
2022-02-11,39454,2725,10296,23007,31483613,12536327,627007,,11909320,6753756
2022-02-12,42059,2961,11459,25321,31525672,12538954,618498,,11920456,6778853
2022-02-13,36331,2803,13148,19943,31562003,12541470,608150,,11933320,6798598
2022-02-14,16987,1177,6124,9475,31578990,12542372,603195,,11939177,6807873
2022-02-15,19372,1389,4759,11880,31598362,12543437,599815,,11943622,6819526
2022-02-16,26035,1768,7741,14949,31624397,12544908,593838,,11951070,6834274
2022-02-17,26776,1684,7528,14987,31651173,12546237,587985,,11958252,6849006
2022-02-18,23958,1355,6616,13682,31675131,12547275,582712,,11964563,6862479
2022-02-19,37846,1904,8344,26056,31712977,12548846,576267,,11972579,6888292
2022-02-20,32581,1499,7964,22807,31745558,12550044,569794,,11980250,6910894
2022-02-21,17506,914,3679,12759,31763064,12550662,567020,,11983642,6923441
2022-02-22,9114,431,1555,6958,31772178,12550803,565891,,11984912,6930188
2022-02-23,25347,1328,4800,17299,31797525,12551821,562412,,11989409,6947251
2022-02-24,24582,1402,5234,15486,31822107,12552901,558575,,11994326,6962494
2022-02-25,23113,1397,5138,14509,31845220,12554004,554827,,11999177,6976777
2022-02-26,25239,1386,5911,16560,31870459,12555080,550295,,12004785,6993111
2022-02-27,26963,1371,7373,17705,31897422,12556182,544282,,12011900,7010621
2022-02-28,10130,594,2531,6745,31907552,12556523,542337,,12014186,7017183
2022-03-01,13206,950,3152,8167,31920758,12557168,540125,,12017043,7025133
2022-03-02,15420,1164,3577,9622,31936178,12558070,537705,,12020365,7034577
2022-03-03,14305,1080,3228,8689,31950483,12558838,535549,,12023289,7043035
2022-03-04,14482,993,3446,8319,31964965,12559510,533092,,12026418,7051101
2022-03-05,18541,1278,5000,11187,31983506,12560478,529359,,12031119,7062064
2022-03-06,16521,1090,5526,9608,32000027,12561287,524917,,12036370,7071465
2022-03-07,5951,469,1862,3509,32005978,12561471,523517,,12037954,7074757
2022-03-08,7371,701,1944,4160,32013349,12561894,522267,,12039627,7078718
2022-03-09,11180,909,2741,6407,32024529,12562527,520429,,12042098,7084923
2022-03-10,12771,1046,3260,6842,32037300,12563296,518208,,12045088,7091552
2022-03-11,12894,905,3410,6867,32050194,12563912,515695,,12048217,7098203
2022-03-12,14694,1049,4190,8310,32064888,12564689,512551,,12052138,7106309
2022-03-13,14754,1091,4999,8336,32079642,12565489,508639,,12056850,7114408
2022-03-14,6337,451,2230,3500,32085979,12565669,506857,,12058812,7117694
2022-03-15,10202,793,2627,5974,32096181,12566172,505011,,12061161,7123454
2022-03-16,13073,936,3670,6954,32109254,12566818,502274,,12064544,7130177
2022-03-17,13203,1050,3965,6759,32122457,12567580,499352,,12068228,7136716
2022-03-18,11911,916,3148,6433,32134368,12568193,497110,,12071083,7142925
2022-03-19,14444,1005,4163,7903,32148812,12568918,493950,,12074968,7150609
2022-03-20,11754,992,3960,6374,32160566,12569638,490977,,12078661,7156775
2022-03-21,5059,415,1589,2814,32165625,12569794,489799,,12079995,7159386
2022-03-22,6717,552,1559,3894,32172342,12570058,488786,,12081272,7163064
2022-03-23,9976,789,2303,5195,32182318,12570531,487269,,12083262,7168018
2022-03-24,9299,723,2377,4615,32191617,12570990,485606,,12085384,7172429
2022-03-25,9233,782,2158,4754,32200850,12571509,484222,,12087287,7176971
2022-03-26,10934,938,2837,5506,32211784,12572170,482321,,12089849,7182258
2022-03-27,10229,912,3539,5301,32222013,12572822,479690,,12093132,7187348
2022-03-28,3584,322,1109,1987,32225597,12572903,478900,,12094003,7189140
2022-03-29,5352,500,1217,2692,32230949,12573118,478177,,12094941,7191610
2022-03-30,7859,748,1840,4124,32238808,12573587,477080,,12096507,7195509
2022-03-31,8657,690,1926,4415,32247465,12573988,475838,,12098150,7199702
2022-04-01,9318,802,1917,4889,32256783,12574498,474714,,12099784,7204352
2022-04-02,10447,885,2216,5573,32267230,12575096,473371,,12101725,7209708
2022-04-03,9213,880,2569,5067,32276443,12575719,471676,,12104043,7214573
2022-04-04,4204,388,1006,2407,32280647,12575845,471055,,12104790,7216776
2022-04-05,6084,601,1038,3054,32286731,12576105,470612,,12105493,7219554
2022-04-06,8384,715,1479,4384,32295115,12576529,469843,,12106686,7223711
2022-04-07,10356,733,1691,4837,32305471,12576962,468880,,12108082,7228305
2022-04-08,23999,812,1585,4837,32329470,12577496,468101,,12109395,7232926
2022-04-09,30502,970,1976,5894,32359972,12578168,467086,,12111082,7238597
2022-04-10,24872,976,2394,5336,32384844,12578885,465662,,12113223,7243731
2022-04-11,12577,386,877,2432,32397421,12579021,465167,,12113854,7245961
2022-04-12,28137,693,1024,3537,32425558,12579410,464829,,12114581,7249265
2022-04-13,37787,853,1562,4928,32463345,12579964,464116,,12115848,7253963
2022-04-14,37911,764,1619,4915,32501256,12580414,463258,,12117156,7258624
2022-04-15,43405,1234,2104,6726,32544661,12581350,462384,,12118966,7265113
2022-04-16,8097,357,651,1742,32552758,12581447,462088,,12119359,7266639
2022-04-17,21028,871,1925,4319,32573786,12582034,461027,,12121007,7270735
2022-04-18,5465,306,465,1290,32579251,12582053,460863,,12121190,7271784
2022-04-19,22662,615,775,3103,32601913,12582385,460694,,12121691,7274667
2022-04-20,40346,1063,1403,4620,32642259,12583122,460351,,12122771,7279023
2022-04-21,38759,943,1600,4683,32681018,12583769,459685,,12124084,7283472
2022-04-22,35639,1017,1437,4270,32716657,12584514,459258,,12125256,7287524
2022-04-23,34660,1005,1740,4714,32751317,12585235,458520,,12126715,7291999
2022-04-24,20817,1021,1890,3777,32772134,12586006,457648,,12128358,7295582
2022-04-25,8299,453,691,1707,32780433,12586190,457409,,12128781,7297073
2022-04-26,24625,734,948,3145,32805058,12586632,457189,,12129443,7299981
2022-04-27,33607,955,1372,3940,32838665,12587310,456764,,12130546,7303703
2022-04-28,32846,930,1420,3931,32871511,12587967,456265,,12131702,7307411
2022-04-29,32065,1098,1381,3909,32903576,12588767,455975,,12132792,7311091
2022-04-30,30294,926,1540,4025,32933870,12589395,455354,,12134041,7314880
2022-05-01,16758,770,1581,2970,32950628,12589867,454538,,12135329,7317606
2022-05-02,5937,309,526,1099,32956565,12589880,454317,,12135563,7318478
2022-05-03,20935,589,835,2347,32977500,12590164,454065,,12136099,7320586
2022-05-04,29418,800,1093,3290,33006918,12590654,453767,,12136887,7323627
2022-05-05,29102,872,1167,3125,33036020,12591213,453462,,12137751,7326507
2022-05-06,29103,1147,1287,2988,33065123,12592071,453317,,12138754,7329268
2022-05-07,28495,870,1266,3113,33093618,12592651,452916,,12139735,7332157
2022-05-08,16001,895,1309,2323,33109619,12593289,452500,,12140789,7334279
2022-05-09,5897,293,474,943,33115516,12593315,452312,,12141003,7335012
2022-05-10,21232,698,724,2120,33136748,12593695,452279,,12141416,7336872
2022-05-11,28956,837,1087,2656,33165704,12594200,452025,,12142175,7339257
2022-05-12,28247,799,1088,2515,33193951,12594702,451732,,12142970,7341531
2022-05-13,27599,879,1119,2469,33221550,12595270,451487,,12143783,7343743
2022-05-14,25695,807,1101,2610,33247245,12595764,451186,,12144578,7346099
2022-05-15,14853,751,1277,2058,33262098,12596243,450653,,12145590,7347938
2022-05-16,6387,326,533,1048,33268485,12596331,450442,,12145889,7348799
2022-05-17,19607,590,781,1743,33288092,12596605,450244,,12146361,7350293
2022-05-18,26549,877,1101,2277,33314641,12597217,450015,,12147202,7352354
2022-05-19,24447,684,1159,2164,33339088,12597634,449533,,12148101,7354301
2022-05-20,24272,801,1141,2218,33363360,12598164,449189,,12148975,7356299
2022-05-21,22407,692,1168,2351,33385767,12598546,448704,,12149842,7358407
2022-05-22,10562,549,892,1489,33396329,12598834,448356,,12150478,7359679
2022-05-23,4575,242,465,794,33400904,12598816,448131,,12150685,7360264
2022-05-24,2629,120,182,442,33403533,12598680,448067,,12150613,7360495
2022-05-25,19371,656,951,1954,33422904,12599069,447762,,12151307,7362238
2022-05-26,20654,664,953,1913,33443558,12599459,447467,,12151992,7363928
2022-05-27,21769,819,1063,2076,33465327,12599989,447220,,12152769,7365770
2022-05-28,19420,722,1168,2152,33484747,12600440,446771,,12153669,7367707
2022-05-29,12115,761,1285,1727,33496862,12600966,446240,,12154726,7369242
2022-05-30,4581,311,550,752,33501443,12601030,445997,,12155033,7369796
2022-05-31,13554,573,754,1668,33514997,12601301,445810,,12155491,7371224
2022-06-01,16619,704,976,1879,33531616,12601703,445536,,12156167,7372850
2022-06-02,14615,557,869,1679,33546231,12601948,445217,,12156731,7374288
2022-06-03,16112,699,1096,1818,33562343,12602367,444814,,12157553,7375886
2022-06-04,13327,647,1167,1845,33575670,12602756,444289,,12158467,7377529
2022-06-05,7870,587,1113,1432,33583540,12603094,443759,,12159335,7378769
2022-06-06,3295,207,446,641,33586835,12603052,443517,,12159535,7379208
2022-06-07,11227,475,729,1374,33598062,12603227,443258,,12159969,7380338
2022-06-08,14072,669,1013,1612,33612134,12603635,442909,,12160726,7381730
2022-06-09,13386,663,929,1678,33625520,12604010,442638,,12161372,7383176
2022-06-10,13858,686,1070,1699,33639378,12604408,442245,,12162163,7384645
2022-06-11,12987,616,1031,1847,33652365,12604738,441828,,12162910,7386269
2022-06-12,8100,643,1238,1504,33660465,12605122,441229,,12163893,7387566
2022-06-13,3191,284,422,713,33663656,12605138,441086,,12164052,7388069
2022-06-14,10132,513,666,1265,33673788,12605362,440927,,12164435,7389096
2022-06-15,13513,474,833,1622,33687301,12605539,440566,,12164973,7390479
2022-06-16,12553,498,858,1619,33699854,12605730,440200,,12165530,7391851
2022-06-17,11694,479,819,1653,33711548,12605920,439853,,12166067,7393266
2022-06-18,11456,438,876,1861,33723004,12606087,439412,,12166675,7394903
2022-06-19,7005,484,899,1420,33730009,12606317,438996,,12167321,7396107
2022-06-20,2287,147,301,643,33732296,12606240,438836,,12167404,7396580
2022-06-21,9548,358,616,1387,33741844,12606311,438573,,12167738,7397719
2022-06-22,13616,407,728,1705,33755460,12606446,438245,,12168201,7399199
2022-06-23,13707,404,776,1683,33769167,12606583,437870,,12168713,7400668
2022-06-24,15368,436,812,1675,33784535,12606759,437490,,12169269,7402128
2022-06-25,14473,427,852,1714,33799008,12606924,437054,,12169870,7403632
2022-06-26,8160,432,886,1280,33807168,12607094,436593,,12170501,7404695
2022-06-27,3214,171,365,594,33810382,12607015,436395,,12170620,7405081
2022-06-28,9620,369,559,1226,33820002,12607097,436201,,12170896,7406073
2022-06-29,13327,416,733,1635,33833329,12607222,435882,,12171340,7407468
2022-06-30,12234,482,848,1581,33845563,12607419,435514,,12171905,7408815
2022-07-01,13041,549,972,1949,33858604,12607710,435086,,12172624,7410558
2022-07-02,1620,111,118,366,33860224,12607545,435077,,12172468,7410692
2022-07-03,5167,260,495,963,33865391,12607546,434833,,12172713,7411438
2022-07-04,2758,132,279,615,33868149,12607431,434685,,12172746,7411856
2022-07-05,11149,372,600,1577,33879298,12607505,434449,,12173056,7413185
2022-07-06,15962,549,860,2010,33895260,12607757,434132,,12173625,7414951
2022-07-07,15671,521,832,1928,33910931,12607989,433820,,12174169,7416626
2022-07-08,17892,555,871,2248,33928823,12608239,433503,,12174736,7418625
2022-07-09,14152,451,597,1851,33942975,12608411,433356,,12175055,7420238
2022-07-10,8753,475,755,1506,33951728,12608636,433075,,12175561,7421536
2022-07-11,4094,199,331,871,33955822,12608568,432940,,12175628,7422185
2022-07-12,12111,410,525,1659,33967933,12608679,432820,,12175859,7423590
2022-07-13,16722,565,773,2144,33984655,12608946,432606,,12176340,7425489
2022-07-14,16862,483,676,2024,34001517,12609123,432402,,12176721,7427273
2022-07-15,28903,598,824,2187,34030420,12609420,432175,,12177245,7429218
2022-07-16,30305,586,775,2330,34060725,12609692,431978,,12177714,7431295
2022-07-17,22938,539,636,1895,34083663,12609992,431878,,12178114,7432994
2022-07-18,11398,189,255,857,34095061,12609912,431807,,12178105,7433628
2022-07-19,28963,593,592,2140,34124024,12610229,431805,,12178424,7435536
2022-07-20,37647,839,924,2598,34161671,12610787,431715,,12179072,7437895
2022-07-21,36368,734,812,2811,34198039,12611232,431630,,12179602,7440464
2022-07-22,35809,824,894,2688,34233848,12611766,431553,,12180213,7442914
2022-07-23,35158,821,914,2837,34269006,12612272,431452,,12180820,7445495
2022-07-24,21742,599,806,1779,34290748,12612608,431242,,12181366,7447049
2022-07-25,11939,307,311,1084,34302687,12612629,431233,,12181396,7447901
2022-07-26,26100,621,605,2215,34328787,12612965,431248,,12181717,7449872
2022-07-27,32482,810,850,2655,34361269,12613516,431206,,12182310,7452315
2022-07-28,31547,724,884,2612,34392816,12613941,431042,,12182899,7454674
2022-07-29,30002,1790,875,2649,34422818,12615437,431953,,12183484,7457071
2022-07-30,25840,2524,747,2441,34448658,12617679,433728,,12183951,7459278
2022-07-31,14320,1067,541,1572,34462978,12618476,434250,,12184226,7460621
2022-08-01,5917,337,223,684,34468895,12618553,434362,,12184191,7461082
2022-08-02,4489,306,138,607,34473384,12618588,434526,,12184062,7461466
2022-08-03,22951,2640,740,2244,34496335,12620951,436422,,12184529,7463474
2022-08-04,22240,2481,681,2136,34518575,12623103,438216,,12184887,7465345
2022-08-05,21802,2755,747,2072,34540377,12625576,440216,,12185360,7467188
2022-08-06,19654,2875,657,2000,34560031,12628138,442428,,12185710,7468928
2022-08-07,12712,2236,621,1425,34572743,12630098,444037,,12186061,7470134
2022-08-08,4766,570,188,603,34577509,12630379,444412,,12185967,7470499
2022-08-09,14023,1467,560,1600,34591532,12631557,445313,,12186244,7471857
2022-08-10,19135,2363,716,1998,34610667,12633645,446958,,12186687,7473625
2022-08-11,17085,2042,718,1860,34627752,12635411,448280,,12187131,7475252
2022-08-12,16987,2048,735,1853,34644739,12637170,449592,,12187578,7476876
2022-08-13,15956,2223,766,1809,34660695,12639106,451047,,12188059,7478442
2022-08-14,9531,1621,619,1087,34670226,12640437,452045,,12188392,7479293
2022-08-15,3876,388,271,482,34674102,12640568,452159,,12188409,7479565
2022-08-16,10811,1075,516,1356,34684913,12641341,452716,,12188625,7480669
2022-08-17,16110,1834,740,1787,34701023,12642885,453808,,12189077,7482219
2022-08-18,14937,1640,751,1698,34715960,12644200,454693,,12189507,7483645
2022-08-19,15320,1848,750,1552,34731280,12645769,455787,,12189982,7484963
2022-08-20,14288,1640,741,1547,34745568,12647116,456680,,12190436,7486270
2022-08-21,9908,1533,660,1166,34755476,12648383,457549,,12190834,7487219
2022-08-22,4166,481,271,563,34759642,12648559,457756,,12190803,7487522
2022-08-23,11141,1248,556,1500,34770783,12649498,458444,,12191054,7488769
2022-08-24,14766,1808,871,2190,34785549,12651034,459381,,12191653,7490727
2022-08-25,14029,1716,780,2124,34799578,12652460,460310,,12192150,7492604
2022-08-26,13930,1688,816,2094,34813508,12653850,461175,,12192675,7494448
2022-08-27,12420,1487,878,2001,34825928,12655009,461778,,12193231,7496182
2022-08-28,7927,1260,622,1398,34833855,12656007,462414,,12193593,7497359
2022-08-29,3401,503,286,684,34837256,12656228,462626,,12193602,7497808
2022-08-30,9908,1167,652,1857,34847164,12657036,463135,,12193901,7499361
2022-08-31,13517,1626,946,2317,34860681,12658368,463811,,12194557,7501432
2022-09-01,12909,1720,914,2143,34873590,12659792,464612,,12195180,7503329
2022-09-02,15049,1616,995,4917,34888639,12661131,465225,,12195906,7508018
2022-09-03,14723,1526,924,5518,34903362,12662370,465824,,12196546,7513299
2022-09-04,8669,1009,677,3238,34912031,12663112,466146,,12196966,7516315
2022-09-05,3556,321,229,1387,34915587,12663166,466235,,12196931,7517479
2022-09-06,2469,157,116,1132,34918056,12663066,466273,,12196793,7518401
2022-09-07,10929,1020,588,3494,34928985,12663785,466701,,12197084,7521641
2022-09-08,10873,1022,527,2791,34939858,12664477,467193,,12197284,7524154
2022-09-09,9584,1012,489,2504,34949442,12665200,467711,,12197489,7526421
2022-09-10,10637,1264,552,3168,34960079,12666184,468416,,12197768,7529353
2022-09-11,9412,980,667,3739,34969491,12666913,468723,,12198190,7532881
2022-09-12,3128,295,205,1080,34972619,12666923,468806,,12198117,7533723
2022-09-13,6019,545,284,1132,34978638,12667178,469058,,12198120,7534609
2022-09-14,14482,797,434,1844,34993120,12667655,469417,,12198238,7536186
2022-09-15,15761,782,412,1534,35008881,12668116,469782,,12198334,7537448
2022-09-16,17761,766,448,1693,35026642,12668619,470094,,12198525,7538917
2022-09-17,17623,723,458,1669,35044265,12669035,470355,,12198680,7540329
2022-09-18,11214,773,451,1688,35055479,12669544,470675,,12198869,7541791
2022-09-19,4979,404,288,670,35060458,12669674,470786,,12198888,7542246
2022-09-20,13774,443,332,948,35074232,12669802,470895,,12198907,7542931
2022-09-21,23044,647,410,1500,35097276,12670137,471127,,12199010,7544174
2022-09-22,22921,637,399,1382,35120197,12670464,471359,,12199105,7545293
2022-09-23,22952,727,603,1419,35143149,12670886,471478,,12199408,7546453
2022-09-24,21692,737,689,1499,35164841,12671328,471522,,12199806,7547716
2022-09-25,11320,595,702,1357,35176161,12671640,471409,,12200231,7548835
2022-09-26,4565,191,220,594,35180726,12671539,471374,,12200165,7549184
2022-09-27,37655,497,366,1498,35218381,12671765,471501,,12200264,7550454
2022-09-28,50972,730,670,1903,35269353,12672225,471560,,12200665,7552130
2022-09-29,48010,636,741,1838,35317363,12672536,471447,,12201089,7553688
2022-09-30,47274,677,807,2004,35364637,12672885,471315,,12201570,7555410
2022-10-01,34455,527,633,1549,35399092,12673102,471207,,12201895,7556691
2022-10-02,24247,736,1028,1713,35423339,12673540,470912,,12202628,7558150
2022-10-03,10871,238,231,613,35434210,12673485,470915,,12202570,7558524
2022-10-04,32199,477,460,1170,35466409,12673640,470928,,12202712,7559415
2022-10-05,40441,633,742,1561,35506850,12673948,470812,,12203136,7560708
2022-10-06,38697,610,653,1569,35545547,12674253,470767,,12203486,7562015
2022-10-07,42245,662,852,1742,35587792,12674567,470569,,12203998,7563455
2022-10-08,37400,782,1145,2120,35625192,12675016,470200,,12204816,7565299
2022-10-09,18814,549,727,1556,35644006,12675285,470019,,12205266,7566615
2022-10-10,6865,168,370,565,35650871,12675153,469814,,12205339,7566918
2022-10-11,4994,124,111,318,35655865,12674981,469822,,12205159,7566997
2022-10-12,35118,579,685,1429,35690983,12675224,469714,,12205510,7568134
2022-10-13,36763,643,859,1621,35727746,12675496,469494,,12206002,7569443
2022-10-14,36977,621,753,1541,35764723,12675781,469358,,12206423,7570702
2022-10-15,35454,714,1013,1628,35800177,12676201,469056,,12207145,7572079
2022-10-16,20663,654,1024,1593,35820840,12676582,468680,,12207902,7573439
2022-10-17,7356,206,477,541,35828196,12676498,468407,,12208091,7573736
2022-10-18,36431,454,503,1402,35864627,12676628,468353,,12208275,7574864
2022-10-19,49904,617,730,1983,35914531,12676941,468236,,12208705,7576595
2022-10-20,51293,621,650,2050,35965824,12677246,468204,,12209042,7578378
2022-10-21,52853,695,619,1937,36018677,12677611,468274,,12209337,7580045
2022-10-22,50868,750,904,2312,36069545,12678028,468115,,12209913,7582080
2022-10-23,30642,571,786,2121,36100187,12678281,467893,,12210388,7583936
2022-10-24,14134,232,271,978,36114321,12678207,467849,,12210358,7584653
2022-10-25,41376,473,489,1820,36155697,12678326,467830,,12210496,7586172
2022-10-26,51660,615,660,2124,36207357,12678603,467781,,12210822,7588014
2022-10-27,50119,603,768,2164,36257476,12678875,467608,,12211267,7589903
2022-10-28,49807,591,675,2095,36307283,12679102,467519,,12211583,7591687
2022-10-29,50606,734,779,2222,36357889,12679483,467470,,12212013,7593605
2022-10-30,28404,662,930,2038,36386293,12679855,467198,,12212657,7595395
2022-10-31,12440,200,234,777,36398733,12679770,467160,,12212610,7595934
2022-11-01,33094,338,197,1220,36431827,12679759,467295,,12212464,7596861
2022-11-02,44292,574,625,1903,36476119,12679997,467240,,12212757,7598461
2022-11-03,44195,540,606,1856,36520314,12680203,467169,,12213034,7600028
2022-11-04,44647,648,528,2030,36564961,12680543,467282,,12213261,7601801
2022-11-05,45210,646,753,2369,36610171,12680884,467172,,12213712,7603901
2022-11-06,26021,558,771,2098,36636192,12681097,466956,,12214141,7605698
2022-11-07,10711,242,235,877,36646903,12681044,466960,,12214084,7606331
2022-11-08,33490,486,397,1586,36680393,12681236,467046,,12214190,7607670
2022-11-09,40532,604,571,1965,36720925,12681515,467077,,12214438,7609359
2022-11-10,39180,620,547,1928,36760105,12681810,467144,,12214666,7611008
2022-11-11,43351,636,642,2209,36803456,12682124,467137,,12214987,7612938
2022-11-12,36854,638,593,2185,36840310,12682435,467174,,12215261,7614838
2022-11-13,24270,557,771,2278,36864580,12682691,466954,,12215737,7616858
2022-11-14,10968,232,205,1024,36875548,12682625,466980,,12215645,7617622
2022-11-15,33635,484,380,1695,36909183,12682737,467078,,12215659,7619002
2022-11-16,43543,799,584,2371,36952726,12683229,467287,,12215942,7621115
2022-11-17,38342,674,647,2241,36991068,12683559,467310,,12216249,7623063
2022-11-18,40629,723,530,2335,37031697,12683930,467499,,12216431,7625094
2022-11-19,39661,1005,1031,3060,37071358,12684583,467466,,12217117,7627845
2022-11-20,22425,658,719,2445,37093783,12684956,467401,,12217555,7630055
2022-11-21,8922,196,193,968,37102705,12684884,467399,,12217485,7630813
2022-11-22,26440,481,369,1513,37129145,12684995,467506,,12217489,7632003
2022-11-23,32090,686,668,2071,37161235,12685341,467521,,12217820,7633787
2022-11-24,31913,663,752,2086,37193148,12685683,467430,,12218253,7635605
2022-11-25,30754,763,827,1953,37223902,12686129,467360,,12218769,7637291
2022-11-26,30293,907,1193,2699,37254195,12686688,467065,,12219623,7639693
2022-11-27,18678,607,943,2088,37272873,12686981,466723,,12220258,7641517
2022-11-28,7541,190,282,788,37280414,12686863,466623,,12220240,7642037
2022-11-29,21028,421,454,1292,37301442,12686947,466586,,12220361,7643045
2022-11-30,27894,643,649,1841,37329336,12687262,466578,,12220684,7644601
2022-12-01,24808,593,682,1693,37354144,12687520,466485,,12221035,7646003
2022-12-02,25058,523,630,1776,37379202,12687706,466372,,12221334,7647489
2022-12-03,25559,588,781,1945,37404761,12687961,466169,,12221792,7649161
2022-12-04,15252,494,606,1702,37420013,12688112,466051,,12222061,7650563
2022-12-05,6877,167,157,746,37426890,12687979,466056,,12221923,7651055
2022-12-06,20355,419,353,1379,37447245,12688019,466116,,12221903,7652114
2022-12-07,24786,553,610,1673,37472031,12688244,466051,,12222193,7653508
2022-12-08,23164,564,520,1767,37495195,12688481,466093,,12222388,7654989
2022-12-09,23333,636,575,1633,37518528,12688775,466150,,12222625,7656338
2022-12-10,22580,508,602,1631,37541108,12688954,466053,,12222901,7657683
2022-12-11,14206,548,787,1567,37555314,12689226,465811,,12223415,7659014
2022-12-12,5507,149,156,595,37560821,12689075,465799,,12223276,7659363
2022-12-13,17799,375,371,1125,37578620,12689121,465801,,12223320,7660209
2022-12-14,21325,511,547,1454,37599945,12689327,465759,,12223568,7661410
2022-12-15,21976,530,603,1579,37621921,12689503,465684,,12223819,7662685
2022-12-16,16292,378,451,1031,37638213,12689550,465608,,12223942,7663437
2022-12-17,18702,556,510,1277,37656915,12689774,465652,,12224122,7664422
2022-12-18,12645,531,795,1307,37669560,12690015,465387,,12224628,7665469
2022-12-19,4587,131,116,450,37674147,12689802,465398,,12224404,7665626
2022-12-20,16216,499,450,1110,37690363,12689974,465439,,12224535,7666463
2022-12-21,18476,541,552,1303,37708839,12690202,465424,,12224778,7667493
2022-12-22,18608,574,591,1748,37727447,12690470,465407,,12225063,7668975
2022-12-23,15654,577,602,1716,37743101,12690681,465377,,12225304,7670387
2022-12-24,5339,224,172,674,37748440,12690581,465428,,12225153,7670771
2022-12-25,2445,153,154,480,37750885,12690420,465417,,12225003,7670981
2022-12-26,262,12,7,48,37751147,12690122,465417,,12224705,7670770
2022-12-27,2099,98,37,307,37753246,12689926,465474,,12224452,7670835
2022-12-28,8321,337,168,975,37761567,12689939,465638,,12224301,7671530
2022-12-29,13167,583,529,1601,37774734,12690176,465688,,12224488,7672833
2022-12-30,15824,667,658,1881,37790558,12690524,465694,,12224830,7674430
2022-12-31,11238,459,389,1356,37801796,12690618,465760,,12224858,7675472
2023-01-01,3910,201,219,562,37805706,12690496,465740,,12224756,7675752
2023-01-02,652,37,13,97,37806358,12690237,465763,,12224474,7675595
2023-01-03,8197,297,151,902,37814555,12690235,465903,,12224332,7676245
2023-01-04,14724,574,547,1547,37829279,12690515,465923,,12224592,7677535
2023-01-05,16119,643,535,1796,37845398,12690847,466023,,12224824,7679061
2023-01-06,18838,715,613,2047,37864236,12691255,466122,,12225133,7680843
2023-01-07,18524,701,639,2057,37882760,12691669,466179,,12225490,7682650
2023-01-08,11613,580,608,1632,37894373,12691985,466148,,12225837,7684051
2023-01-09,5299,215,196,664,37899672,12691885,466164,,12225721,7684449
2023-01-10,12163,415,317,786,37911835,12691984,466260,,12225724,7684960
2023-01-11,15546,458,370,1097,37927381,12692110,466342,,12225768,7685778
2023-01-12,14084,444,409,973,37941465,12692236,466376,,12225860,7686481
2023-01-13,14176,418,344,1041,37955641,12692388,466447,,12225941,7687289
2023-01-14,13394,471,451,1079,37969035,12692540,466461,,12226079,7688088
2023-01-15,9046,459,508,1055,37978081,12692705,466411,,12226294,7688895
2023-01-16,3746,146,130,479,37981827,12692565,466427,,12226138,7689122
2023-01-17,8855,265,179,654,37990682,12692483,466509,,12225974,7689483
2023-01-18,10268,349,273,762,38000950,12692526,466582,,12225944,7689972
2023-01-19,10593,315,318,761,38011543,12692535,466574,,12225961,7690476
2023-01-20,9839,319,273,717,38021382,12692556,466618,,12225938,7690931
2023-01-21,11311,354,401,905,38032693,12692598,466570,,12226028,7691574
2023-01-22,7570,343,405,819,38040263,12692668,466505,,12226163,7692154
2023-01-23,3380,143,131,288,38043643,12692562,466516,,12226046,7692223
2023-01-24,8291,226,166,553,38051934,12692464,466573,,12225891,7692494
2023-01-25,10312,346,299,664,38062246,12692531,466616,,12225915,7692924
2023-01-26,6727,236,205,469,38068973,12692462,466643,,12225819,7693138
2023-01-27,6912,237,197,498,38075885,12692380,466680,,12225700,7693364
2023-01-28,9354,314,339,695,38085239,12692394,466649,,12225745,7693802
2023-01-29,5973,234,341,694,38091212,12692341,466537,,12225804,7694241
2023-01-30,1900,88,80,215,38093112,12692132,466543,,12225589,7694197
2023-01-31,5884,156,151,414,38098996,12691967,466544,,12225423,7694327
2023-02-01,7304,248,250,494,38106300,12691951,466539,,12225412,7694598
2023-02-02,6485,297,241,503,38112785,12691965,466592,,12225373,7694872
2023-02-03,6551,197,194,463,38119336,12691889,466591,,12225298,7695095
2023-02-04,6731,233,307,544,38126067,12691848,466511,,12225337,7695405
2023-02-05,4178,199,291,485,38130245,12691759,466414,,12225345,7695653
2023-02-06,1834,90,98,212,38132079,12691543,466403,,12225140,7695595
2023-02-07,4967,160,182,384,38137046,12691388,466378,,12225010,7695717
2023-02-08,5771,212,206,430,38142817,12691311,466379,,12224932,7695897
2023-02-09,6124,211,244,439,38148941,12691238,466345,,12224893,7696095
2023-02-10,5092,159,208,372,38154033,12691159,466292,,12224867,7696261
2023-02-11,6056,186,261,458,38160089,12691051,466213,,12224838,7696453
2023-02-12,4085,220,342,409,38164174,12691013,466087,,12224926,7696634
2023-02-13,1483,57,87,146,38165657,12690812,466055,,12224757,7696563
2023-02-14,3947,131,179,310,38169604,12690651,466005,,12224646,7696612
2023-02-15,4541,119,191,286,38174145,12690490,465930,,12224560,7696660
2023-02-16,4917,175,284,400,38179062,12690377,465817,,12224560,7696812
2023-02-17,4983,179,210,344,38184045,12690297,465782,,12224515,7696936
2023-02-18,5118,232,294,487,38189163,12690255,465718,,12224537,7697190
2023-02-19,3354,132,244,373,38192517,12690112,465601,,12224511,7697334
2023-02-20,1424,63,54,158,38193941,12689912,465607,,12224305,7697270
2023-02-21,914,27,14,107,38194855,12689681,465616,,12224065,7697150
2023-02-22,4136,131,212,370,38198991,12689547,465529,,12224018,7697303
2023-02-23,4283,162,231,393,38203274,12689426,465453,,12223973,7697453
2023-02-24,3034,136,231,274,38206308,12689291,465354,,12223937,7697483
2023-02-25,5024,213,541,386,38211332,12689245,465024,,12224221,7697652
2023-02-26,3472,146,681,384,38214804,12689113,464485,,12224628,7697806
2023-02-27,1075,37,57,97,38215879,12688897,464460,,12224437,7697693
2023-02-28,2732,99,163,232,38218611,12688704,464394,,12224310,7697665
2023-03-01,3850,137,428,336,38222461,12688524,464097,,12224427,7697719
2023-03-02,4595,158,495,329,38227056,12688360,463749,,12224611,7697782
2023-03-03,4370,158,356,334,38231426,12688235,463548,,12224687,7697864
2023-03-04,4970,208,623,350,38236396,12688151,463130,,12225021,7697964
2023-03-05,2537,110,450,251,38238933,12687953,462789,,12225164,7697948
2023-03-06,1157,48,37,114,38240090,12687734,462797,,12224937,7697830
2023-03-07,3221,87,172,225,38243311,12687495,462707,,12224788,7697782
2023-03-08,4320,133,412,284,38247631,12687321,462426,,12224895,7697793
2023-03-09,4624,173,453,312,38252255,12687200,462140,,12225060,7697853
2023-03-10,3942,99,139,255,38256197,12687039,462097,,12224942,7697888
2023-03-11,4064,139,171,286,38260261,12686934,462061,,12224873,7697961
2023-03-12,2893,109,234,301,38263154,12686762,461927,,12224835,7698020
2023-03-13,862,29,32,106,38264016,12686539,461920,,12224619,7697906
2023-03-14,3080,100,109,257,38267096,12686354,461911,,12224443,7697921
2023-03-15,4099,138,163,313,38271195,12686230,461884,,12224346,7698004
2023-03-16,4027,176,234,277,38275222,12686077,461817,,12224260,7698010
2023-03-17,4292,168,202,311,38279514,12685938,461779,,12224159,7698048
2023-03-18,4363,144,194,298,38283877,12685797,461728,,12224069,7698096
2023-03-19,2722,128,233,256,38286599,12685691,461621,,12224070,7698140
2023-03-20,774,31,19,74,38287373,12685446,461631,,12223815,7697977
2023-03-21,2899,69,86,201,38290272,12685242,461609,,12223633,7697946
2023-03-22,3895,130,134,248,38294167,12685075,461602,,12223473,7697929
2023-03-23,3811,118,172,226,38297978,12684894,461542,,12223352,7697900
2023-03-24,3694,102,116,238,38301672,12684732,461526,,12223206,7697917
2023-03-25,4274,108,171,252,38305946,12684573,461456,,12223117,7697938
2023-03-26,2480,112,213,202,38308426,12684416,461349,,12223067,7697912
2023-03-27,915,48,32,68,38309341,12684232,461364,,12222868,7697775
2023-03-28,3107,87,79,203,38312448,12684029,461364,,12222665,7697731
2023-03-29,4172,125,136,225,38316620,12683868,461349,,12222519,7697710
2023-03-30,3838,108,164,211,38320458,12683699,461292,,12222407,7697671
2023-03-31,3987,140,109,222,38324445,12683560,461322,,12222238,7697657
2023-04-01,4195,135,147,225,38328640,12683423,461307,,12222116,7697653
2023-04-02,2182,59,122,172,38330822,12683184,461240,,12221944,7697569
2023-04-03,781,24,12,53,38331603,12682955,461250,,12221705,7697401
2023-04-04,3419,74,76,169,38335022,12682768,461246,,12221522,7697335
2023-04-05,4373,94,109,249,38339395,12682572,461228,,12221344,7697337
2023-04-06,3703,108,109,190,38343098,12682418,461225,,12221193,7697298
2023-04-07,4599,105,115,243,38347697,12682241,461212,,12221029,7697301
2023-04-08,836,23,11,54,38348533,12682012,461219,,12220793,7697139
2023-04-09,2441,81,103,161,38350974,12681865,461194,,12220671,7697108
2023-04-10,360,9,6,20,38351334,12681613,461191,,12220422,7696916
2023-04-11,2771,34,28,121,38354105,12681354,461196,,12220158,7696776
2023-04-12,6347,105,96,188,38360452,12681196,461198,,12219998,7696749
2023-04-13,6999,105,128,207,38367451,12681028,461167,,12219861,7696719
2023-04-14,6514,88,103,206,38373965,12680850,461144,,12219706,7696708
2023-04-15,6949,107,149,230,38380914,12680694,461100,,12219594,7696717
2023-04-16,3275,83,144,165,38384189,12680498,461035,,12219463,7696642
2023-04-17,864,12,13,49,38385053,12680278,461031,,12219247,7696499
2023-04-18,4786,101,77,161,38389839,12680099,461052,,12219047,7696417
2023-04-19,6568,117,99,177,38396407,12679938,461067,,12218871,7696351
2023-04-20,6391,102,153,210,38402798,12679789,461014,,12218775,7696344
2023-04-21,5774,85,76,133,38408572,12679605,461020,,12218585,7696248
2023-04-22,6392,95,91,180,38414964,12679439,461021,,12218418,7696211
2023-04-23,3301,119,147,170,38418265,12679319,460992,,12218327,7696172
2023-04-24,955,4,12,59,38419220,12679077,460982,,12218095,7696031
2023-04-25,4809,69,70,187,38424029,12678890,460981,,12217909,7695991
2023-04-26,6593,108,93,208,38430622,12678761,460995,,12217766,7695991
2023-04-27,6899,118,152,207,38437521,12678615,460956,,12217659,7695971
2023-04-28,6638,86,86,185,38444159,12678446,460954,,12217492,7695926
2023-04-29,6534,122,111,199,38450693,12678319,460961,,12217358,7695909
2023-04-30,2642,94,129,145,38453335,12678184,460925,,12217259,7695852
2023-05-01,1030,20,17,30,38454365,12677947,460923,,12217024,7695658
2023-05-02,4348,67,55,106,38458713,12677749,460930,,12216819,7695538
2023-05-03,5609,108,107,176,38464322,12677604,460925,,12216679,7695501
2023-05-04,8087,87,85,135,38472409,12677429,460924,,12216505,7695420
2023-05-05,13049,90,98,168,38485458,12677280,460913,,12216367,7695381
2023-05-06,15659,114,96,156,38501117,12677172,460929,,12216243,7695335
2023-05-07,6067,56,95,106,38507184,12677003,460886,,12216117,7695245
2023-05-08,2167,16,4,37,38509351,12676789,460895,,12215894,7695083
2023-05-09,12572,55,49,129,38521923,12676604,460898,,12215706,7695010
2023-05-10,14772,70,79,157,38536695,12676435,460887,,12215548,7694958
2023-05-11,13363,77,72,154,38550058,12676298,460891,,12215407,7694922
2023-05-12,13491,83,79,177,38563549,12676158,460893,,12215265,7694898
2023-05-13,11448,80,75,147,38574997,12675976,460894,,12215082,7694816
2023-05-14,4186,67,95,93,38579183,12675828,460863,,12214965,7694734
2023-05-15,1055,9,6,38,38580238,12675629,460860,,12214769,7694595
2023-05-16,8949,56,48,93,38589187,12675448,460862,,12214586,7694482
2023-05-17,11133,99,83,141,38600320,12675301,460875,,12214426,7694394
2023-05-18,10838,81,69,144,38611158,12675136,460886,,12214250,7694321
2023-05-19,10514,95,97,154,38621672,12674994,460880,,12214114,7694260
2023-05-20,9407,91,88,165,38631079,12674842,460882,,12213960,7694204
2023-05-21,3084,48,86,95,38634163,12674698,460842,,12213856,7694128
2023-05-22,971,14,11,30,38635134,12674497,460844,,12213653,7693968
2023-05-23,754,8,3,16,38635888,12674302,460848,,12213454,7693808
2023-05-24,8033,57,80,105,38643921,12674123,460824,,12213299,7693699
2023-05-25,9344,74,93,163,38653265,12673973,460803,,12213170,7693666
2023-05-26,7996,67,70,123,38661261,12673833,460800,,12213033,7693604
2023-05-27,8232,108,76,126,38669493,12673723,460830,,12212893,7693549
2023-05-28,2905,56,72,101,38672398,12673587,460811,,12212776,7693476
2023-05-29,972,13,11,30,38673370,12673389,460810,,12212579,7693314
2023-05-30,6072,61,50,112,38679442,12673225,460819,,12212406,7693225
2023-05-31,8173,91,95,122,38687615,12673086,460812,,12212274,7693153
2023-06-01,7403,70,91,125,38695018,12672941,460789,,12212152,7693087
2023-06-02,6342,52,49,121,38701360,12672771,460791,,12211980,7693005
2023-06-03,5491,70,63,123,38706851,12672609,460797,,12211812,7692924
2023-06-04,2051,47,78,77,38708902,12672460,460763,,12211697,7692825
2023-06-05,600,11,6,18,38709502,12672277,460766,,12211511,7692668
2023-06-06,4465,39,38,79,38713967,12672097,460764,,12211333,7692551
2023-06-07,5816,63,65,121,38719783,12671968,460758,,12211210,7692511
2023-06-08,5756,58,68,112,38725539,12671849,460745,,12211104,7692472
2023-06-09,6191,77,81,122,38731730,12671716,460740,,12210976,7692407
2023-06-10,5351,76,95,116,38737081,12671566,460716,,12210850,7692324
2023-06-11,2010,55,62,105,38739091,12671434,460704,,12210730,7692269
2023-06-12,691,11,7,38,38739782,12671274,460707,,12210567,7692156
2023-06-13,4228,54,58,104,38744010,12671126,460702,,12210424,7692090
2023-06-14,5469,72,83,117,38749479,12670977,460690,,12210287,7692019
2023-06-15,5108,70,75,121,38754587,12670812,460682,,12210130,7691934
2023-06-16,5695,70,64,121,38760282,12670671,460685,,12209986,7691871
2023-06-17,4121,63,62,114,38764403,12670519,460686,,12209833,7691794
2023-06-18,1561,41,61,98,38765964,12670361,460664,,12209697,7691721
2023-06-19,373,6,2,16,38766337,12670170,460666,,12209504,7691566
2023-06-20,3205,51,42,89,38769542,12669994,460672,,12209322,7691456
2023-06-21,3690,42,57,89,38773232,12669848,460653,,12209195,7691375
2023-06-22,3981,75,73,118,38777213,12669726,460653,,12209073,7691319
2023-06-23,4510,54,44,90,38781723,12669604,460661,,12208943,7691255
2023-06-24,3698,49,61,73,38785421,12669424,460646,,12208778,7691133
2023-06-25,1519,31,51,93,38786940,12669268,460624,,12208644,7691062
2023-06-26,510,12,9,23,38787450,12669113,460624,,12208489,7690932
2023-06-27,3119,80,45,91,38790569,12668983,460656,,12208327,7690844
2023-06-28,4074,69,60,91,38794643,12668859,460664,,12208195,7690760
2023-06-29,3975,64,72,83,38798618,12668749,460651,,12208098,7690693
2023-06-30,3834,74,61,128,38802452,12668634,460660,,12207974,7690649
2023-07-01,3219,51,88,118,38805671,12668482,460622,,12207860,7690595
2023-07-02,272,10,5,15,38805943,12668311,460626,,12207685,7690453
2023-07-03,379,6,5,26,38806322,12668159,460626,,12207533,7690343
2023-07-04,1244,18,14,49,38807566,12667986,460630,,12207356,7690220
2023-07-05,2387,56,40,70,38809953,12667865,460644,,12207221,7690141
2023-07-06,2535,38,69,85,38812488,12667707,460611,,12207096,7690056
2023-07-07,2823,53,46,71,38815311,12667599,460616,,12206983,7689986
2023-07-08,2419,64,43,94,38817730,12667476,460636,,12206840,7689914
2023-07-09,916,31,45,37,38818646,12667341,460622,,12206719,7689799
2023-07-10,289,4,2,15,38818935,12667148,460622,,12206526,7689641
2023-07-11,1793,34,20,59,38820728,12667000,460632,,12206368,7689548
2023-07-12,2320,51,52,84,38823048,12666881,460631,,12206250,7689480
2023-07-13,2285,52,68,67,38825333,12666759,460613,,12206146,7689400
2023-07-14,1945,65,48,59,38827278,12666667,460627,,12206040,7689323
2023-07-15,1945,52,56,77,38829223,12666559,460622,,12205937,7689260
2023-07-16,806,36,30,43,38830029,12666423,460628,,12205795,7689155
2023-07-17,193,5,1,11,38830222,12666279,460629,,12205650,7689036
2023-07-18,1308,42,44,56,38831530,12666150,460627,,12205523,7688944
2023-07-19,1793,55,51,56,38833323,12666050,460629,,12205421,7688870
2023-07-20,1603,77,57,61,38834926,12665972,460648,,12205324,7688785
2023-07-21,1733,54,40,50,38836659,12665878,460658,,12205220,7688702
2023-07-22,1509,39,62,75,38838168,12665777,460635,,12205142,7688643
2023-07-23,699,28,31,49,38838867,12665666,460631,,12205035,7688566
2023-07-24,235,11,2,15,38839102,12665545,460639,,12204906,7688463
2023-07-25,1080,48,25,51,38840182,12665424,460662,,12204762,7688360
2023-07-26,1345,49,49,41,38841527,12665336,460661,,12204675,7688275
2023-07-27,1285,68,47,55,38842812,12665277,460681,,12204596,7688215
2023-07-28,1444,46,47,58,38844256,12665176,460679,,12204497,7688143
2023-07-29,1307,50,49,69,38845563,12665092,460678,,12204414,7688094
2023-07-30,637,29,19,28,38846200,12664995,460687,,12204308,7688012
2023-07-31,229,6,4,15,38846429,12664886,460686,,12204200,7687926
2023-08-01,1113,47,32,35,38847542,12664811,460701,,12204110,7687852
2023-08-02,1434,73,55,56,38848976,12664741,460717,,12204024,7687792
2023-08-03,1113,61,38,47,38850089,12664674,460740,,12203934,7687722
2023-08-04,1284,48,48,59,38851373,12664600,460740,,12203860,7687669
2023-08-05,1311,47,50,48,38852684,12664530,460736,,12203794,7687612
2023-08-06,577,25,19,23,38853261,12664462,460742,,12203720,7687551
2023-08-07,243,7,4,9,38853504,12664375,460744,,12203631,7687479
2023-08-08,324,7,3,14,38853828,12664279,460745,,12203534,7687403
2023-08-09,1245,45,43,45,38855073,12664219,460746,,12203473,7687356
2023-08-10,1590,96,52,68,38856663,12664226,460789,,12203437,7687342
2023-08-11,1657,57,47,61,38858320,12664189,460799,,12203390,7687319
2023-08-12,1634,65,46,67,38859954,12664183,460818,,12203365,7687326
2023-08-13,792,28,31,32,38860746,12664141,460815,,12203326,7687295
2023-08-14,247,6,1,6,38860993,12664080,460818,,12203262,7687246
2023-08-15,1279,37,27,40,38862272,12664015,460828,,12203187,7687198
2023-08-16,1620,59,49,48,38863892,12664008,460837,,12203171,7687187
2023-08-17,1673,77,66,63,38865565,12664029,460847,,12203182,7687199
2023-08-18,1673,87,60,49,38867238,12664083,460873,,12203210,7687218
2023-08-19,1697,83,54,62,38868935,12664137,460901,,12203236,7687254
2023-08-20,829,57,44,31,38869764,12664161,460914,,12203247,7687256
2023-08-21,227,4,2,8,38869991,12664132,460916,,12203216,7687234
2023-08-22,1225,57,46,46,38871216,12664183,460927,,12203256,7687274
2023-08-23,1513,65,50,53,38872729,12664248,460942,,12203306,7687327
2023-08-24,1499,96,65,67,38874228,12664344,460973,,12203371,7687394
