"report_date","previous_day_total_doses_administered","previous_day_at_least_one","previous_day_fully_vaccinated","previous_day_3doses","total_doses_administered","total_individuals_at_least_one","total_individuals_partially_vaccinated","total_doses_in_fully_vaccinated_individuals","total_individuals_fully_vaccinated","total_individuals_3doses"
2021-01-01,6252,6242,2,,32202,32147,32136,22,11,
2021-01-02,4614,4602,6,,36816,36697,36684,26,13,
2021-01-03,5395,5388,3,,42211,42085,42069,32,16,
2021-01-04,5995,5993,0,,48206,48077,48062,30,15,
2021-01-05,9686,9661,20,,57892,57736,57702,68,34,
2021-01-06,12793,12328,450,,70685,70061,69580,962,481,
2021-01-07,16219,15508,697,,86904,85568,84390,2356,1178,
2021-01-08,18038,17023,1002,,104942,102591,100411,4360,2180,
2021-01-09,19500,18423,1064,,124442,121013,117769,6488,3244,
2021-01-10,11372,11332,38,,135814,132337,129055,6564,3282,
2021-01-11,11710,11660,48,,147524,143997,140667,6660,3330,
2021-01-12,14467,14160,298,,161991,158149,154521,7256,3628,
2021-01-13,15436,13813,1593,,177427,171948,166729,10438,5219,
2021-01-14,19191,16739,2436,,196618,188681,181027,15308,7654,
2021-01-15,20068,18010,2038,,216686,206680,196988,19384,9692,
2021-01-16,17118,15934,1171,,233804,222598,211735,21726,10863,
2021-01-17,11259,10015,1237,,245063,232598,220500,24196,12098,
2021-01-18,6794,6712,72,,251857,239287,227120,24334,12167,
2021-01-19,11829,9721,2094,,263686,248987,234726,28522,14261,
2021-01-20,10803,7214,3572,,274489,256178,238346,35664,17832,
2021-01-21,10973,6854,4091,,285462,263016,241093,43846,21923,
2021-01-22,9037,4320,4697,,294499,267299,240681,53236,26618,
2021-01-23,7457,3041,4388,,301956,270310,239305,62010,31005,
2021-01-24,4385,1828,2536,,306341,272120,238579,67082,33541,
2021-01-25,5322,1049,4264,,311663,273137,235333,75608,37804,
2021-01-26,9393,2867,6498,,321056,275972,231671,88602,44301,
2021-01-27,9896,2864,7004,,330952,278807,227503,102608,51304,
2021-01-28,13117,5740,7335,,344069,284514,225875,117278,58639,
2021-01-29,10696,3283,7379,,354765,287766,221749,132034,66017,
2021-01-30,9191,2730,6424,,363956,290454,218016,144876,72438,
2021-01-31,3383,1570,1768,,367339,291990,217785,148410,74205,
2021-02-01,2124,487,1609,,369463,292443,216633,151620,75810,
2021-02-02,4414,1361,2995,,373877,293766,214965,157602,78801,
2021-02-03,6235,1715,4458,,380112,295440,212188,166504,83252,
2021-02-04,9080,1709,7292,,389192,297106,206568,181076,90538,
2021-02-05,8445,1467,6904,,397637,298533,201097,194872,97436,
2021-02-06,10665,1869,8736,,408302,300347,194184,212326,106163,
2021-02-07,7575,1729,5796,,415877,302036,190089,223894,111947,
2021-02-08,8219,3095,5081,,424096,305083,188068,234030,117015,
2021-02-09,15008,3858,11082,,439104,308899,180818,256162,128081,
2021-02-10,15510,4931,10518,,454614,313778,175204,277148,138574,
2021-02-11,16366,3899,12409,,470980,317625,166673,301904,150952,
2021-02-12,17670,2098,15522,,488650,319684,153230,332908,166454,
2021-02-13,16212,2446,13751,,504862,322085,141899,360372,180186,
2021-02-14,12879,922,11925,,517741,322959,130878,384162,192081,
2021-02-15,7862,486,7328,,525603,323397,124014,398766,199383,
2021-02-16,5994,1041,4903,,531597,324395,120132,408526,204263,
2021-02-17,10166,1609,8523,,541763,325960,113202,425516,212758,
2021-02-18,13869,2955,10870,,555632,328867,105269,447196,223598,
2021-02-19,18489,6213,12209,,574121,335028,99252,471552,235776,
2021-02-20,22628,11132,11444,,596749,346097,98915,494364,247182,
2021-02-21,17239,10383,6822,,613988,356420,102458,507924,253962,
2021-02-22,13586,8759,4775,,627574,365110,106422,517376,258688,
2021-02-23,17865,11126,6668,,645439,376180,110860,530640,265320,
2021-02-24,18576,13611,4884,,664015,389735,119573,540324,270162,
2021-02-25,20809,16489,4263,,684824,406158,131781,548754,274377,
2021-02-26,24898,21835,3002,,709722,427933,150591,554684,277342,
2021-02-27,27463,23581,3840,,737185,451450,170316,562268,281134,
2021-02-28,20583,19142,1406,,757768,470538,188040,564996,282498,
2021-03-01,18223,17027,1148,,775991,487503,203904,567198,283599,
2021-03-02,24684,22274,2325,,800675,509716,223838,571756,285878,
2021-03-03,30597,27965,2578,,831272,537630,249207,576846,288423,
2021-03-04,34690,32460,2144,,865962,570024,279507,581034,290517,
2021-03-05,39998,38164,1785,,905960,608140,315872,584536,292268,
2021-03-06,44153,41945,2170,,950113,650030,355633,588794,294397,
2021-03-07,32734,31555,1175,,982847,681511,385997,591028,295514,
2021-03-08,24038,22162,1861,,1006885,703605,406284,594642,297321,
2021-03-09,33292,29842,3422,,1040177,733381,432684,601394,300697,
2021-03-10,38342,34080,4217,,1078519,767387,462521,609732,304866,
2021-03-11,43977,40704,3234,,1122496,808025,499977,616096,308048,
2021-03-12,47711,45999,1689,,1170207,853960,544273,619374,309687,
2021-03-13,57927,55051,2849,,1228134,908940,596458,624964,312482,
2021-03-14,43417,42179,1220,,1271551,951036,637402,627268,313634,
2021-03-15,32811,31113,1682,,1304362,982090,666817,630546,315273,
2021-03-16,53957,51658,2282,,1358319,1033683,716171,635024,317512,
2021-03-17,61062,58521,2497,,1419381,1092138,772179,639918,319959,
2021-03-18,61551,59093,2430,,1480932,1151159,828823,644672,322336,
2021-03-19,64473,61141,3274,,1545405,1212222,886665,651114,325557,
2021-03-20,62566,59976,2559,,1607971,1272142,944074,656136,328068,
2021-03-21,43998,42475,1537,,1651969,1314552,984984,659136,329568,
2021-03-22,31002,30035,978,,1682971,1344499,1014009,660980,330490,
2021-03-23,54621,51848,2722,,1737592,1396252,1063103,666298,333149,
2021-03-24,76431,73250,3133,,1814023,1469412,1133187,672450,336225,
2021-03-25,82911,80331,2533,,1896934,1549664,1210963,677402,338701,
2021-03-26,87012,83482,3490,,1983946,1633065,1290926,684278,342139,
2021-03-27,80858,77906,2867,,2064804,1710868,1365927,689882,344941,
2021-03-28,66990,65401,1554,,2131794,1776179,1429741,692876,346438,
2021-03-29,51734,49046,2651,,2183528,1825145,1476102,698086,349043,
2021-03-30,73582,70171,3350,,2257110,1895239,1542887,704704,352352,
2021-03-31,93150,89498,3586,,2350260,1984639,1628754,711770,355885,
2021-04-01,89316,85438,3840,,2439576,2069979,1710307,719344,359672,
2021-04-02,93082,88859,4207,,2532658,2158752,1794925,727654,363827,
2021-04-03,61007,59329,1735,,2593665,2217990,1852479,731022,365511,
2021-04-04,72329,70676,1650,,2665994,2288555,1921452,734206,367103,
2021-04-05,53731,53260,470,,2719725,2341731,1974206,735050,367525,
2021-04-06,79580,77713,1886,,2799305,2419342,2049985,738714,369357,
2021-04-07,108005,104940,3055,,2907310,2524157,2151803,744708,372354,
2021-04-08,114078,110105,4027,,3021388,2634151,2257826,752650,376325,
2021-04-09,109844,105620,4296,,3131232,2739653,2359097,761112,380556,
2021-04-10,109238,105477,3851,,3240470,2845002,2460661,768682,384341,
2021-04-11,98626,95509,3259,,3339096,2940386,2552845,775082,387541,
2021-04-12,76067,75003,1157,,3415163,3015241,2626611,777260,388630,
2021-04-13,99471,96089,3399,,3514634,3111221,2719240,783962,391981,
2021-04-14,117049,113285,3650,,3631683,3224388,2828797,791182,395591,
2021-04-15,113558,109502,3898,,3745241,3333764,2934332,798864,399432,
2021-04-16,118087,113713,4194,,3863328,3447367,3043785,807164,403582,
2021-04-17,112416,107825,4451,,3975744,3555058,3147084,815948,407974,
2021-04-18,88743,86506,2103,,4064487,3641441,3231418,820046,410023,
2021-04-19,68972,67440,1452,,4133459,3708751,3297327,822848,411424,
2021-04-20,102093,98770,3118,,4235552,3807359,3392882,828954,414477,
2021-04-21,142038,137764,4038,,4377590,3944949,3526502,836894,418447,
2021-04-22,139499,135349,3909,,4517089,4080169,3657869,844600,422300,
2021-04-23,138218,131797,6174,,4655307,4211812,3783396,856832,428416,
2021-04-24,130290,126228,3887,,4785597,4337892,3905645,864494,432247,
2021-04-25,102014,98604,3179,,4887611,4436348,4000989,870718,435359,
2021-04-26,71002,69297,1557,,4958613,4505514,4068658,873712,436856,
2021-04-27,98504,95420,2892,,5057117,4600773,4161088,879370,439685,
2021-04-28,120577,115953,4432,,5177694,4716558,4272513,888090,444045,
2021-04-29,124485,119291,5046,,5302179,4835682,4386660,898044,449022,
2021-04-30,115818,110565,5012,,5417997,4946074,4492117,907914,453957,
2021-05-01,111297,107431,3647,,5529294,5053324,4595797,915054,457527,
2021-05-02,79141,76165,2863,,5608435,5129332,4669008,920648,460324,
2021-05-03,56793,55123,1597,,5665228,5184300,4722439,923722,461861,
2021-05-04,91928,88559,3281,,5757156,5272681,4807616,930130,465065,
2021-05-05,137997,133290,4620,,5895153,5405802,4936180,939244,469622,
2021-05-06,141833,136879,4816,,6036986,5542497,5068121,948752,474376,
2021-05-07,150285,145244,4836,,6187271,5687581,5208428,958306,479153,
2021-05-08,142459,137774,4436,,6329730,5825160,5341650,967020,483510,
2021-05-09,124806,121157,3479,,6454536,5946153,5459228,973850,486925,
2021-05-10,97804,95820,1880,,6552340,6041784,5553046,977476,488738,
2021-05-11,113536,108856,4493,,6665876,6150438,5657278,986320,493160,
2021-05-12,145045,138018,6880,,6810921,6288277,5788303,999948,499974,
2021-05-13,142709,135319,7236,,6953630,6423421,5916285,1014272,507136,
2021-05-14,148867,138776,9920,,7102497,6562009,6045018,1033982,516991,
2021-05-15,159735,149691,9863,,7262232,6711513,6184734,1053558,526779,
2021-05-16,144357,136090,8060,,7406589,6847435,6312676,1069518,534759,
2021-05-17,114976,110880,3943,,7521565,6958126,6419500,1077252,538626,
2021-05-18,111331,100464,10665,,7632896,7058394,6509165,1098458,549229,
2021-05-19,149879,133467,16235,,7782775,7191709,6626319,1130780,565390,
2021-05-20,151570,131578,19776,,7934345,7323098,6738001,1170194,585097,
2021-05-21,165386,140882,24246,,8099731,7463799,6854533,1218532,609266,
2021-05-22,199438,172243,26967,,8299169,7635844,6999692,1272304,636152,
2021-05-23,139828,127459,12224,,8438997,7763125,7114811,1296628,648314,
2021-05-24,100297,93325,6827,,8539294,7856277,7201206,1310142,655071,
2021-05-25,90469,82984,7276,,8629763,7939098,7276818,1324560,662280,
2021-05-26,139780,113014,26503,,8769543,8051925,7363212,1377426,688713,
2021-05-27,152064,123044,28766,,8921607,8174812,7457402,1434820,717410,
2021-05-28,163866,132311,31248,,9085473,8306950,7558351,1497198,748599,
2021-05-29,153387,117125,36029,,9238860,8423925,7639353,1569144,784572,
2021-05-30,149722,119016,30479,,9388582,8542771,7727782,1629978,814989,
2021-05-31,99215,79821,19201,,9487797,8622422,7788296,1668252,834126,
2021-06-01,124199,90611,33250,,9611996,8712838,7845537,1734602,867301,
2021-06-02,145318,102154,42913,,9757314,8814811,7904666,1820290,910145,
2021-06-03,155370,99914,55175,,9912684,8914540,7949291,1930498,965249,
2021-06-04,181718,115534,65912,,10094402,9029875,7998802,2062146,1031073,
2021-06-05,172028,103435,68310,,10266430,9133112,8033814,2198596,1099298,
2021-06-06,163393,91868,71245,,10429823,9224802,8054329,2340946,1170473,
2021-06-07,119556,63050,56288,,10549379,9287655,8060969,2453372,1226686,
2021-06-08,161891,72449,89003,,10711270,9359915,8044306,2631218,1315609,
2021-06-09,181468,70810,110188,,10892738,9430548,8004832,2851432,1425716,
2021-06-10,185579,66422,118665,,11078317,9496767,7952477,3088580,1544290,
2021-06-11,204784,67515,136513,,11283101,9564096,7883375,3361442,1680721,
2021-06-12,199732,62676,136456,,11482833,9626590,7809505,3634170,1817085,
2021-06-13,190340,58889,130920,,11673173,9685304,7737379,3895850,1947925,
2021-06-14,137690,38697,98594,,11810863,9723805,7677391,4092828,2046414,
2021-06-15,189538,42616,146567,,12000401,9766202,7573318,4385768,2192884,
2021-06-16,206249,42434,163174,,12206650,9808440,7452485,4711910,2355955,
2021-06-17,210469,37942,171941,,12417119,9846167,7318363,5055608,2527804,
2021-06-18,217189,35356,181229,,12634308,9881333,7172392,5417882,2708941,
2021-06-19,215894,35497,179721,,12850202,9916624,7028074,5777100,2888550,
2021-06-20,186273,35569,150127,,13036475,9951995,6913426,6077138,3038569,
2021-06-21,120433,20829,99102,,13156908,9972629,6835050,6275158,3137579,
2021-06-22,204943,27520,176666,,13361851,9999955,6685819,6628272,3314136,
2021-06-23,230538,28633,201160,,13592389,10028388,6513200,7030376,3515188,
2021-06-24,227697,26674,200266,,13820086,10054866,6339522,7430688,3715344,
2021-06-25,251116,27988,222379,,14071202,10082653,6145048,7875210,3937605,
2021-06-26,261302,30007,230589,,14332504,10112434,5944381,8336106,4168053,
2021-06-27,204996,27784,176606,,14537500,10140036,5795487,8689098,4344549,
2021-06-28,199251,20955,177729,,14736751,10160793,5638640,9044306,4522153,
2021-06-29,250113,24493,224887,,14986864,10185045,5438159,9493772,4746886,
2021-06-30,275541,24177,250796,,15262405,10209019,5211466,9995106,4997553,
2021-07-01,271972,25309,246108,,15534377,10234110,4990588,10487044,5243522,
2021-07-02,144730,11590,132911,,15679107,10245526,4869195,10752662,5376331,
2021-07-03,216899,19932,196736,,15896006,10265236,4692318,11145836,5572918,
2021-07-04,196201,19439,176538,,16092207,10284489,4535152,11498674,5749337,
2021-07-05,148719,12442,136134,,16240926,10296741,4411398,11770686,5885343,
2021-07-06,220038,19996,199826,,16460964,10316521,4231498,12170046,6085023,
2021-07-07,246612,22966,223404,,16707576,10339261,4030982,12616558,6308279,
2021-07-08,231210,21357,209641,,16938786,10360412,3842627,13035570,6517785,
2021-07-09,226999,21510,205320,,17165785,10381720,3658747,13445946,6722973,
2021-07-10,209062,20538,188366,,17374847,10402054,3490852,13822404,6911202,
2021-07-11,171678,17583,153968,,17546525,10419436,3354413,14130046,7065023,
2021-07-12,123136,11445,111593,,17669661,10430692,3254213,14352958,7176479,
2021-07-13,178511,19028,159339,,17848172,10449498,3113835,14671326,7335663,
2021-07-14,180042,19305,160580,,18028214,10468588,2972508,14992160,7496080,
2021-07-15,167206,19584,147447,,18195420,10487961,2844598,15286726,7643363,
2021-07-16,169353,19905,149298,,18364773,10507664,2715156,15585016,7792508,
2021-07-17,173009,20265,152615,,18537782,10527680,2582749,15889862,7944931,
2021-07-18,133629,15931,117560,,18671411,10543427,2481084,16124686,8062343,
2021-07-19,91981,10418,81455,,18763392,10553632,2410009,16287246,8143623,
2021-07-20,133541,16951,116532,,18896933,10570343,2310364,16519958,8259979,
2021-07-21,140086,16986,123030,,19037019,10587114,2204267,16765694,8382847,
2021-07-22,125616,17645,107833,,19162635,10604535,2114032,16981006,8490503,
2021-07-23,120273,16993,103072,,19282908,10621287,2027911,17186752,8593376,
2021-07-24,126697,18332,108126,,19409605,10639416,1938077,17402678,8701339,
2021-07-25,103641,14865,88645,,19513246,10654057,1864254,17579606,8789803,
2021-07-26,66689,9889,56708,,19579935,10663728,1817398,17692660,8846330,
2021-07-27,92384,15317,76904,,19672319,10678784,1755767,17846034,8923017,
2021-07-28,93947,16467,77408,,19766266,10695016,1694782,18000468,9000234,
2021-07-29,89394,16702,72529,,19855660,10711486,1638911,18145150,9072575,
2021-07-30,84066,16104,67848,,19939726,10727362,1587127,18280470,9140235,
2021-07-31,83853,15721,67983,,20023579,10742865,1534837,18416056,9208028,
2021-08-01,61870,11321,50367,,20085449,10753960,1495756,18516408,9258204,
2021-08-02,42491,7417,34955,,20127940,10761179,1468186,18585986,9292993,
2021-08-03,33296,5957,27166,,20161236,10766903,1446954,18639898,9319949,
2021-08-04,61319,12373,48756,,20222555,10779041,1410534,18737014,9368507,
2021-08-05,59456,12547,46757,,20282011,10791380,1376280,18830200,9415100,
2021-08-06,56023,11858,43949,,20338034,10802978,1344158,18917640,9458820,
2021-08-07,62375,12135,50045,,20400409,10814852,1306205,19017294,9508647,
2021-08-08,48689,9273,39225,,20449098,10823897,1276230,19095334,9547667,
2021-08-09,30856,5937,24741,,20479954,10829620,1257399,19144442,9572221,
2021-08-10,49258,10511,38445,,20529212,10839851,1229431,19220840,9610420,
2021-08-11,48724,10765,37710,,20577936,10850369,1202455,19295828,9647914,
2021-08-12,49249,11196,37823,,20627185,10861314,1175786,19371056,9685528,
2021-08-13,49624,11727,37621,,20676809,10872800,1149862,19445876,9722938,
2021-08-14,51217,12131,38876,,20728026,10884681,1123091,19523180,9761590,
2021-08-15,41769,9853,31693,,20769795,10894332,1101221,19586222,9793111,
2021-08-16,26737,6183,20404,,20796532,10900292,1086974,19626636,9813318,
2021-08-17,40500,11056,29178,,20837032,10911098,1068828,19684540,9842270,
2021-08-18,41897,11971,29682,,20878929,10922827,1051085,19743484,9871742,
2021-08-19,45893,16533,29097,,20924822,10939109,1038493,19801232,9900616,
2021-08-20,46448,16291,29742,,20971270,10955144,1025015,19860258,9930129,
2021-08-21,47949,15142,32439,,21019219,10970026,1007685,19924682,9962341,
2021-08-22,34390,10805,23315,,21053609,10980585,995151,19970868,9985434,
2021-08-23,23220,7004,15999,,21076829,10987354,986135,20002438,10001219,
2021-08-24,37650,13374,23820,,21114479,11000474,975666,20049616,10024808,
2021-08-25,41347,14419,26318,,21155826,11014637,963748,20101778,10050889,
2021-08-26,39267,13552,24973,,21195093,11027913,952292,20151242,10075621,
2021-08-27,37671,12939,23687,,21232764,11040611,941517,20198188,10099094,
2021-08-28,40120,13423,25519,,21272884,11053755,929397,20248716,10124358,
2021-08-29,30553,10249,19944,,21303437,11063772,919683,20288178,10144089,
2021-08-30,18235,6139,11845,,21321672,11069663,913948,20311430,10155715,
2021-08-31,32714,11939,19622,,21354386,11081334,906237,20350194,10175097,
2021-09-01,36244,12945,21954,,21390630,11094046,897212,20393668,10196834,
2021-09-02,37773,15644,19663,,21428403,11109438,893168,20432540,10216270,
2021-09-03,46884,21092,22441,,21475287,11130281,891800,20476962,10238481,
2021-09-04,46877,20586,24775,,21522164,11150621,887588,20526066,10263033,
2021-09-05,33073,14203,18577,,21555237,11164580,883194,20562772,10281386,
2021-09-06,21714,9489,12033,,21576951,11173820,880633,20586374,10293187,
2021-09-07,15009,6728,8096,,21591960,11180291,879248,20602086,10301043,
2021-09-08,41147,17115,20934,,21633107,11197142,875411,20643462,10321731,
2021-09-09,41446,16973,19677,,21674553,11213838,872682,20682312,10341156,
2021-09-10,39647,15508,19007,,21714200,11229083,869165,20719836,10359918,
2021-09-11,42380,15934,23339,,21756580,11244738,861739,20765998,10382999,
2021-09-12,29965,11531,17867,,21786545,11255975,855373,20801204,10400602,
2021-09-13,16088,6406,9185,,21802633,11262147,852579,20819136,10409568,
2021-09-14,29904,11559,15288,,21832537,11273404,848823,20849162,10424581,
2021-09-15,39278,14021,19422,,21871815,11287165,843406,20887518,10443759,
2021-09-16,39350,13987,19248,,21911165,11300917,838122,20925590,10462795,
2021-09-17,38927,13611,19335,,21950092,11314285,832386,20963798,10481899,
2021-09-18,41250,14085,23541,,21991342,11328097,822909,21010376,10505188,
2021-09-19,30661,10829,18983,,22022003,11338667,814742,21047850,10523925,
2021-09-20,16729,6098,10176,,22038732,11344511,810641,21067740,10533870,
2021-09-21,31358,11213,16990,,22070090,11355459,804848,21101222,10550611,
2021-09-22,41813,14814,22928,,22111903,11369977,796713,21146528,10573264,
2021-09-23,47228,16137,26031,,22159131,11385851,786800,21198102,10599051,
2021-09-24,46309,15634,26651,,22205440,11401225,775764,21250922,10625461,
2021-09-25,48195,15255,29945,,22253635,11416227,761055,21310344,10655172,
2021-09-26,37500,12418,24489,,22291135,11428370,748963,21358814,10679407,
2021-09-27,19158,6530,12321,,22310293,11434646,743156,21382980,10691490,
2021-09-28,30957,11293,17881,,22341250,11445680,736556,21418248,10709124,
2021-09-29,37889,12475,21729,,22379139,11457884,727282,21461204,10730602,
2021-09-30,37342,11654,21373,,22416481,11469279,717544,21503470,10751735,
2021-10-01,30876,9810,18411,,22447357,11478863,708930,21539866,10769933,
2021-10-02,37137,11158,23584,,22484494,11489751,696486,21586530,10793265,
2021-10-03,27203,8163,18323,,22511697,11497673,686313,21622720,10811360,
2021-10-04,14867,4746,9802,,22526564,11502172,681239,21641866,10820933,
2021-10-05,26825,8595,15870,,22553389,11510506,673949,21673114,10836557,
2021-10-06,31660,9636,18508,,22585049,11519883,665069,21709628,10854814,
2021-10-07,30345,9394,17118,,22615394,11529026,657332,21743388,10871694,
2021-10-08,32838,10740,18852,,22648232,11539495,649206,21780578,10890289,
2021-10-09,34139,10663,21014,,22682371,11549895,638841,21822108,10911054,
2021-10-10,23410,7661,15082,,22705781,11557305,631408,21851794,10925897,
2021-10-11,12003,3839,7865,,22717784,11560894,627366,21867056,10933528,
2021-10-12,5110,1626,3267,,22722894,11562242,625710,21873064,10936532,
2021-10-13,29105,9190,18085,,22751999,11571142,616799,21908686,10954343,
2021-10-14,29013,8904,17748,,22781012,11579771,607945,21943652,10971826,
2021-10-15,29101,8832,18169,,22810113,11588340,598595,21979490,10989745,
2021-10-16,31138,8985,19871,,22841251,11597034,587697,22018674,11009337,
2021-10-17,23709,7262,15375,,22864960,11604042,579571,22048942,11024471,
2021-10-18,12305,3746,8146,,22877265,11607507,575159,22064696,11032348,
2021-10-19,21269,6626,12630,,22898534,11613851,569142,22089418,11044709,
2021-10-20,25668,7540,14921,,22924202,11621144,561748,22118792,11059396,
2021-10-21,23179,6682,13031,,22947381,11627557,555388,22144338,11072169,
2021-10-22,26120,7312,15113,,22973501,11634546,547571,22173950,11086975,
2021-10-23,28180,7605,17157,,23001681,11641889,538012,22207754,11103877,
2021-10-24,19348,5728,12598,,23021029,11647361,531130,22232462,11116231,
2021-10-25,9930,2710,6476,,23030959,11649802,527356,22244892,11122446,
2021-10-26,18910,5389,11099,,23049869,11654913,521637,22266552,11133276,
2021-10-27,22853,6079,13211,,23072722,11660737,514491,22292492,11146246,
2021-10-28,22303,5791,12643,,23095025,11666240,507628,22317224,11158612,
2021-10-29,22812,5731,13048,,23117837,11671669,500296,22342746,11171373,
2021-10-30,24116,6046,14615,,23141953,11677443,491715,22371456,11185728,
2021-10-31,16478,4595,10598,,23158431,11681744,485707,22392074,11196037,
2021-11-01,7869,2080,5054,,23166300,11683544,482720,22401648,11200824,
2021-11-02,15625,4363,7747,,23181925,11687618,479325,22416586,11208293,
2021-11-03,18623,5068,9603,,23200548,11692383,474780,22435206,11217603,
2021-11-04,19506,4874,10031,,23220054,11696981,469608,22454746,11227373,
2021-11-05,21467,4405,9521,,23241521,11701097,464478,22473238,11236619,
2021-11-06,25333,5206,12156,,23266854,11706034,457511,22497046,11248523,
2021-11-07,21450,4024,8923,,23288304,11709777,452600,22514354,11257177,
2021-11-08,11991,2110,4732,,23300295,11711592,449962,22523260,11261630,
2021-11-09,24125,3851,7649,,23324420,11715122,446154,22537936,11268968,
2021-11-10,28474,4508,8994,,23352894,11719353,441654,22555398,11277699,
2021-11-11,28762,4308,9098,,23381656,11723365,436855,22573020,11286510,
2021-11-12,26744,4164,8240,,23408400,11727238,432765,22588946,11294473,
2021-11-13,34313,5080,11412,,23442713,11732012,426424,22611176,11305588,
2021-11-14,23220,3898,8606,,23465933,11735647,421709,22627876,11313938,
2021-11-15,12700,2184,4494,,23478633,11737571,419391,22636360,11318180,
2021-11-16,26174,3930,7481,,23504807,11741245,415836,22650818,11325409,
2021-11-17,31170,4047,7820,,23535977,11745010,412053,22665914,11332957,
2021-11-18,32506,3866,7528,,23568483,11748570,408377,22680386,11340193,
2021-11-19,35473,3863,7753,,23603956,11752132,404475,22695314,11347657,
2021-11-20,40112,4381,8817,,23644068,11756233,400030,22712406,11356203,
2021-11-21,28117,3435,6946,,23672185,11759406,396505,22725802,11362901,
2021-11-22,14898,1950,3894,,23687083,11761079,394555,22733048,11366524,
2021-11-23,33049,3274,6007,,23720132,11764073,391814,22744518,11372259,
2021-11-24,42656,3757,6804,,23762788,11767526,388756,22757540,11378770,
2021-11-25,46043,3932,6574,,23808831,11771183,386111,22770144,11385072,
2021-11-26,52866,11348,6614,,23861697,11782261,390838,22782846,11391423,
2021-11-27,63520,22355,7038,,23925217,11804335,406145,22796380,11398190,
2021-11-28,51455,27740,5313,,23976672,11831783,428560,22806446,11403223,
2021-11-29,33526,18933,2881,,24010198,11850455,444601,22811708,11405854,
2021-11-30,56037,20684,5135,,24066235,11870858,460140,22821436,11410718,
2021-12-01,69539,26243,5635,,24135774,11896795,480734,22832122,11416061,
2021-12-02,71631,26487,5037,,24207405,11922984,502171,22841626,11420813,
2021-12-03,73419,25096,5169,,24280824,11947784,522092,22851384,11425692,
2021-12-04,81156,27784,6071,47281,24361980,11975275,543796,,11431479,807682
2021-12-05,62629,31927,4412,26268,24424609,12006907,571303,,11435604,833846
2021-12-06,38626,19143,2712,16756,24463235,12025761,587727,,11438034,850524
2021-12-07,60287,14851,4475,40947,24523522,12040340,598093,,11442247,891397
2021-12-08,73451,19055,4680,49713,24596973,12059118,612458,,11446660,941032
2021-12-09,74500,18273,4346,51861,24671473,12077082,626377,,11450705,992808
2021-12-10,77498,17590,4657,55241,24748971,12094391,639305,,11455086,1047968
2021-12-11,83182,20405,5827,56938,24832153,12114507,653869,,11460638,1104820
2021-12-12,60754,22697,4156,33858,24892907,12136924,672404,,11464520,1138589
2021-12-13,34935,11603,2409,20900,24927842,12148230,681588,,11466642,1159394
2021-12-14,101979,9001,3867,89067,25029821,12156920,686707,,11470213,1248341
2021-12-15,127696,12427,4512,110719,25157517,12169043,694612,,11474431,1358960
2021-12-16,139359,12463,4251,122629,25296876,12181220,702814,,11478406,1481490
2021-12-17,159171,12402,4518,142229,25456047,12193347,710689,,11482658,1623622
2021-12-18,175588,13523,4923,157096,25631635,12206576,719277,,11487299,1780623
2021-12-19,140438,18159,3930,118312,25772073,12224434,733498,,11490936,1898824
2021-12-20,106822,10305,2745,93725,25878895,12234471,741048,,11493423,1992451
2021-12-21,215388,12962,4315,198089,26094283,12247117,749688,,11497429,2190419
2021-12-22,237258,14424,5203,217747,26331541,12261241,758895,,11502346,2408048
2021-12-23,257770,11722,5087,240863,26589311,12272658,765524,,11507134,2648805
2021-12-24,223608,9455,4570,209515,26812919,12281816,770405,,11511411,2858204
2021-12-25,89729,3888,2510,83343,26902648,12285429,771778,,11513651,2941440
2021-12-26,11896,388,358,11140,26914544,12285525,771800,,11513725,2952450
2021-12-27,46944,1491,1117,44305,26961488,12286771,772167,,11514604,2996635
2021-12-28,144783,6100,4012,134610,27106271,12292577,774244,,11518333,3131114
2021-12-29,175465,9377,4580,161438,27281736,12301658,779037,,11522621,3292424
2021-12-30,200061,10132,5348,184539,27481797,12311487,783806,,11527681,3476829
2021-12-31,195206,10006,5804,179143,27677003,12321204,787999,,11533205,3655846
2022-01-01,96953,5383,3880,87363,27773956,12326278,789494,,11536784,3743060
2022-01-02,19445,942,928,17446,27793401,12326929,789499,,11537430,3760360
2022-01-03,88253,4773,4591,78808,27881654,12331392,789673,,11541719,3839015
2022-01-04,146368,6001,5319,135008,28028022,12337065,790342,,11546723,3973867
2022-01-05,177509,7630,7295,162411,28205531,12344341,790666,,11553675,4136118
2022-01-06,191535,7207,6788,177013,28397066,12351229,791074,,11560155,4312976
2022-01-07,191291,7963,7003,175512,28588357,12358848,792022,,11566826,4488315
2022-01-08,181673,8624,6639,165223,28770030,12367140,793994,,11573146,4653382
2022-01-09,131102,9866,7184,113959,28901132,12376684,796671,,11580013,4767181
2022-01-10,90559,5107,4489,80832,28991691,12381469,797279,,11584190,4847860
2022-01-11,138886,6156,6576,125448,29130577,12387278,796846,,11590432,4973118
2022-01-12,157031,8161,8055,138692,29287608,12395110,796947,,11598163,5111642
2022-01-13,162684,9211,9216,141547,29450292,12403959,796928,,11607031,5253006
2022-01-14,159893,10756,10383,136062,29610185,12414353,797296,,11617057,5388870
2022-01-15,161207,11013,11674,135886,29771392,12424995,796624,,11628371,5524563
2022-01-16,109785,9294,9675,89456,29881177,12433927,796236,,11637691,5613801
2022-01-17,65786,5937,6567,52641,29946963,12439528,795596,,11643932,5666257
2022-01-18,36113,2003,2132,31154,29983076,12441176,795456,,11645720,5697215
2022-01-19,101321,5582,6720,85957,30084397,12446358,794300,,11652058,5782945
2022-01-20,103601,6322,7006,85735,30187998,12452296,793608,,11658688,5868457
2022-01-21,102109,6231,8058,82507,30290107,12458123,791767,,11666356,5950736
2022-01-22,102579,8712,12075,78114,30392686,12466446,788397,,11678049,6028622
2022-01-23,76701,7307,13996,54799,30469387,12473410,781701,,11691709,6083199
2022-01-24,42266,3196,7935,30746,30511653,12476242,776944,,11699298,6113738
2022-01-25,62564,3757,8370,48118,30574217,12479620,772316,,11707304,6161637
2022-01-26,77889,4915,13172,55692,30652106,12484158,764054,,11720104,6217087
2022-01-27,78078,4895,13244,56052,30730184,12488681,755695,,11732986,6272902
2022-01-28,77287,4673,13676,53898,30807471,12492996,746679,,11746317,6326581
2022-01-29,84823,5529,17714,58117,30892294,12498161,734487,,11763674,6384453
2022-01-30,66507,5024,20631,40157,30958801,12502843,718866,,11783977,6424385
2022-01-31,34747,2175,9884,22349,30993548,12504699,711148,,11793551,6446545
2022-02-01,51351,3265,9664,36527,31044899,12507611,704739,,11802872,6482847
2022-02-02,57710,3847,12397,38680,31102609,12511127,696174,,11814953,6521327
2022-02-03,52581,3610,11510,34301,31155190,12514360,688262,,11826098,6555377
2022-02-04,43094,2946,10561,27286,31198284,12516995,680637,,11836358,6582469
2022-02-05,58724,3746,14473,37564,31257008,12520409,669898,,11850511,6619820
2022-02-06,49859,3641,16116,29572,31306867,12523727,657418,,11866309,6649168
2022-02-07,23235,1690,7811,13441,31330102,12525091,651284,,11873807,6662385
2022-02-08,33397,2355,7252,21972,31363499,12527116,646380,,11880736,6684124
2022-02-09,38885,2784,8920,24410,31402384,12529541,640238,,11889303,6708282
2022-02-10,37539,2765,8837,22552,31439923,12531970,634162,,11897808,6730604
2022-02-11,39449,2724,10293,23005,31479372,12534348,626584,,11907764,6753371
2022-02-12,42049,2958,11456,25318,31521421,12536972,618075,,11918897,6778465
2022-02-13,36321,2800,13143,19943,31557742,12539485,607729,,11931756,6798210
2022-02-14,16979,1176,6121,9473,31574721,12540386,602776,,11937610,6807483
2022-02-15,19355,1384,4752,11879,31594076,12541446,599398,,11942048,6819135
2022-02-16,26020,1767,7730,14948,31620096,12542916,593431,,11949485,6833882
2022-02-17,26767,1684,7525,14985,31646863,12544245,587581,,11956664,6848612
2022-02-18,23943,1354,6609,13677,31670806,12545282,582314,,11962968,6862080
2022-02-19,37835,1903,8338,26052,31708641,12546854,575874,,11970980,6887891
2022-02-20,32577,1498,7963,22806,31741218,12548051,569401,,11978650,6910492
2022-02-21,17502,913,3678,12757,31758720,12548669,566627,,11982042,6923038
2022-02-22,9112,430,1555,6957,31767832,12548809,565497,,11983312,6929784
2022-02-23,25336,1326,4795,17296,31793168,12549825,562021,,11987804,6946844
2022-02-24,24573,1401,5233,15484,31817741,12550904,558184,,11992720,6962085
2022-02-25,23108,1394,5137,14509,31840849,12552004,554434,,11997570,6976368
2022-02-26,25233,1386,5909,16557,31866082,12553080,549904,,12003176,6992699
2022-02-27,26958,1370,7370,17704,31893040,12554181,543893,,12010288,7010208
2022-02-28,10130,594,2531,6745,31903170,12554522,541948,,12012574,7016770
2022-03-01,13201,948,3152,8166,31916371,12555165,539734,,12015431,7024719
2022-03-02,15418,1164,3578,9619,31931789,12556068,537313,,12018755,7034161
2022-03-03,14299,1077,3227,8689,31946088,12556833,535155,,12021678,7042619
2022-03-04,14477,993,3445,8316,31960565,12557505,532699,,12024806,7050682
2022-03-05,18533,1277,4998,11183,31979098,12558473,528967,,12029506,7061641
2022-03-06,16518,1090,5525,9605,31995616,12559282,524526,,12034756,7071039
2022-03-07,5950,469,1861,3509,32001566,12559466,523127,,12036339,7074331
2022-03-08,7363,699,1943,4158,32008929,12559887,521876,,12038011,7078290
2022-03-09,11158,908,2736,6406,32020087,12560519,520042,,12040477,7084494
2022-03-10,12767,1045,3258,6841,32032854,12561287,517822,,12043465,7091122
2022-03-11,12891,904,3409,6865,32045745,12561902,515309,,12046593,7097771
2022-03-12,14684,1047,4183,8310,32060429,12562677,512170,,12050507,7105877
2022-03-13,14747,1091,4999,8332,32075176,12563477,508258,,12055219,7113972
2022-03-14,6333,450,2228,3499,32081509,12563656,506477,,12057179,7117257
2022-03-15,10197,792,2625,5972,32091706,12564158,504632,,12059526,7123015
2022-03-16,13063,934,3667,6953,32104769,12564803,501896,,12062907,7129737
2022-03-17,13198,1048,3962,6758,32117967,12565563,498975,,12066588,7136275
2022-03-18,11906,914,3146,6432,32129873,12566174,496733,,12069441,7142483
2022-03-19,14443,1005,4163,7902,32144316,12566899,493573,,12073326,7150166
2022-03-20,11747,990,3958,6372,32156063,12567618,490600,,12077018,7156330
2022-03-21,5057,414,1589,2814,32161120,12567773,489421,,12078352,7158941
2022-03-22,6712,552,1558,3893,32167832,12568037,488409,,12079628,7162618
2022-03-23,9970,785,2299,5195,32177802,12568506,486892,,12081614,7167572
2022-03-24,9296,724,2377,4611,32187098,12568966,485230,,12083736,7171979
2022-03-25,9225,781,2154,4752,32196323,12569484,483849,,12085635,7176519
2022-03-26,10928,937,2834,5506,32207251,12570144,481950,,12088194,7181806
2022-03-27,10226,910,3538,5301,32217477,12570794,479318,,12091476,7186896
2022-03-28,3584,322,1109,1987,32221061,12570875,478528,,12092347,7188688
2022-03-29,5347,499,1212,2692,32226408,12571089,477809,,12093280,7191158
2022-03-30,7854,748,1837,4122,32234262,12571558,476715,,12094843,7195055
2022-03-31,8652,689,1925,4413,32242914,12571958,475473,,12096485,7199246
2022-04-01,9313,801,1916,4889,32252227,12572467,474349,,12098118,7203896
2022-04-02,10446,887,2215,5571,32262673,12573067,473009,,12100058,7209250
2022-04-03,9209,880,2569,5065,32271882,12573690,471314,,12102376,7214113
2022-04-04,4203,388,1006,2406,32276085,12573817,470693,,12103124,7216316
2022-04-05,6078,601,1036,3052,32282163,12574078,470252,,12103826,7219093
2022-04-06,8380,714,1478,4383,32290543,12574501,469483,,12105018,7223249
2022-04-07,10344,733,1687,4836,32300887,12574934,468524,,12106410,7227842
2022-04-08,23995,811,1583,4836,32324882,12575467,467746,,12107721,7232462
2022-04-09,30495,969,1974,5894,32355377,12576138,466732,,12109406,7238133
2022-04-10,24864,976,2390,5333,32380241,12576855,465312,,12111543,7243264
2022-04-11,12570,385,876,2431,32392811,12576990,464817,,12112173,7245493
2022-04-12,28129,693,1020,3537,32420940,12577379,464483,,12112896,7248797
2022-04-13,37782,853,1561,4927,32458722,12577933,463771,,12114162,7253494
2022-04-14,37904,761,1616,4913,32496626,12578381,462913,,12115468,7258154
2022-04-15,43401,1232,2104,6725,32540027,12579315,462037,,12117278,7264642
2022-04-16,8095,357,650,1741,32548122,12579412,461742,,12117670,7266167
2022-04-17,21020,871,1925,4319,32569142,12579999,460681,,12119318,7270263
2022-04-18,5459,306,463,1289,32574601,12580018,460519,,12119499,7271311
2022-04-19,22655,615,773,3103,32597256,12580350,460352,,12119998,7274194
2022-04-20,40337,1062,1398,4619,32637593,12581086,460013,,12121073,7278549
2022-04-21,38756,943,1600,4682,32676349,12581733,459347,,12122386,7282997
2022-04-22,35632,1016,1434,4268,32711981,12582477,458922,,12123555,7287047
2022-04-23,34654,1006,1736,4712,32746635,12583199,458189,,12125010,7291520
2022-04-24,20815,1021,1888,3777,32767450,12583970,457319,,12126651,7295103
2022-04-25,8299,453,691,1707,32775749,12584154,457080,,12127074,7296594
2022-04-26,24622,733,948,3146,32800371,12584595,456859,,12127736,7299503
2022-04-27,33601,955,1369,3938,32833972,12585274,456437,,12128837,7303224
2022-04-28,32838,928,1414,3931,32866810,12585929,455942,,12129987,7306932
2022-04-29,32060,1098,1379,3911,32898870,12586729,455654,,12131075,7310614
2022-04-30,30287,924,1536,4025,32929157,12587356,455035,,12132321,7314404
2022-05-01,16752,769,1579,2970,32945909,12587827,454220,,12133607,7317130
2022-05-02,5936,309,526,1098,32951845,12587840,453999,,12133841,7318001
2022-05-03,20928,588,831,2347,32972773,12588123,453750,,12134373,7320109
2022-05-04,29417,799,1092,3291,33002190,12588612,453452,,12135160,7323151
2022-05-05,29098,872,1163,3125,33031288,12589172,453151,,12136021,7326032
2022-05-06,29097,1147,1285,2987,33060385,12590031,453008,,12137023,7328792
2022-05-07,28493,870,1266,3113,33088878,12590611,452607,,12138004,7331681
2022-05-08,15998,895,1308,2323,33104876,12591249,452192,,12139057,7333803
2022-05-09,5897,293,474,943,33110773,12591276,452005,,12139271,7334536
2022-05-10,21228,696,720,2120,33132001,12591654,451974,,12139680,7336396
2022-05-11,28950,836,1084,2655,33160951,12592158,451722,,12140436,7338780
2022-05-12,28240,799,1084,2513,33189191,12592660,451433,,12141227,7341052
2022-05-13,27594,877,1118,2469,33216785,12593226,451187,,12142039,7343264
2022-05-14,25693,807,1099,2610,33242478,12593717,450888,,12142829,7345619
2022-05-15,14851,751,1276,2058,33257329,12594196,450356,,12143840,7347458
2022-05-16,6384,326,532,1047,33263713,12594284,450146,,12144138,7348318
2022-05-17,19605,590,780,1742,33283318,12594558,449949,,12144609,7349811
2022-05-18,26546,878,1101,2274,33309864,12595172,449721,,12145451,7351870
2022-05-19,24442,683,1155,2164,33334306,12595588,449242,,12146346,7353817
2022-05-20,24271,801,1140,2218,33358577,12596119,448899,,12147220,7355815
2022-05-21,22405,691,1167,2350,33380982,12596500,448414,,12148086,7357922
2022-05-22,10560,549,890,1489,33391542,12596788,448068,,12148720,7359194
2022-05-23,4574,242,465,793,33396116,12596770,447843,,12148927,7359778
2022-05-24,2624,119,179,441,33398740,12596635,447781,,12148854,7360009
2022-05-25,19367,656,948,1953,33418107,12597025,447479,,12149546,7361752
2022-05-26,20645,663,949,1911,33438752,12597414,447187,,12150227,7363440
2022-05-27,21763,818,1061,2078,33460515,12597944,446941,,12151003,7365285
2022-05-28,19410,722,1166,2149,33479925,12598395,446494,,12151901,7367219
2022-05-29,12111,760,1282,1726,33492036,12598920,445965,,12152955,7368753
2022-05-30,4580,311,550,751,33496616,12598985,445723,,12153262,7369306
2022-05-31,13551,573,752,1667,33510167,12599256,445538,,12153718,7370733
2022-06-01,16614,704,972,1879,33526781,12599658,445268,,12154390,7372359
2022-06-02,14608,557,867,1676,33541389,12599903,444951,,12154952,7373794
2022-06-03,16105,698,1096,1815,33557494,12600322,444547,,12155775,7375390
2022-06-04,13323,647,1165,1845,33570817,12600711,444024,,12156687,7377033
2022-06-05,7868,587,1111,1432,33578685,12601049,443496,,12157553,7378273
2022-06-06,3294,206,445,641,33581979,12601006,443254,,12157752,7378712
2022-06-07,11221,475,727,1370,33593200,12601181,442997,,12158184,7379838
2022-06-08,14068,667,1013,1611,33607268,12601588,442646,,12158942,7381230
2022-06-09,13377,663,925,1676,33620645,12601963,442379,,12159584,7382674
2022-06-10,13852,685,1068,1698,33634497,12602362,441988,,12160374,7384142
2022-06-11,12985,616,1031,1846,33647482,12602692,441571,,12161121,7385765
2022-06-12,8098,643,1236,1504,33655580,12603077,440974,,12162103,7387062
2022-06-13,3189,284,422,712,33658769,12603094,440831,,12162263,7387565
2022-06-14,10129,512,666,1264,33668898,12603317,440671,,12162646,7388591
2022-06-15,13510,472,832,1621,33682408,12603493,440309,,12163184,7389974
2022-06-16,12544,495,856,1617,33694952,12603682,439943,,12163739,7391344
2022-06-17,11693,479,818,1653,33706645,12603874,439597,,12164277,7392761
2022-06-18,11452,436,876,1860,33718097,12604039,439154,,12164885,7394397
2022-06-19,7003,483,899,1419,33725100,12604269,438737,,12165532,7395601
2022-06-20,2286,147,301,643,33727386,12604192,438577,,12165615,7396074
2022-06-21,9545,358,616,1385,33736931,12604263,438314,,12165949,7397211
2022-06-22,13612,407,725,1703,33750543,12604398,437989,,12166409,7398689
2022-06-23,13704,401,775,1683,33764247,12604532,437612,,12166920,7400158
2022-06-24,15366,435,811,1675,33779613,12604707,437232,,12167475,7401618
2022-06-25,14471,427,852,1713,33794084,12604873,436796,,12168077,7403122
2022-06-26,8159,432,886,1280,33802243,12605043,436335,,12168708,7404185
2022-06-27,3213,171,365,594,33805456,12604965,436137,,12168828,7404572
2022-06-28,9620,369,558,1226,33815076,12605048,435944,,12169104,7405565
2022-06-29,13317,415,731,1632,33828393,12605173,435626,,12169547,7406957
2022-06-30,12233,482,847,1581,33840626,12605370,435259,,12170111,7408304
2022-07-01,13040,550,972,1949,33853666,12605662,434832,,12170830,7410047
2022-07-02,1615,110,115,365,33855281,12605496,434825,,12170671,7410180
2022-07-03,5161,260,494,960,33860442,12605498,434582,,12170916,7410924
2022-07-04,2757,132,279,614,33863199,12605383,434434,,12170949,7411341
2022-07-05,11144,372,599,1575,33874343,12605457,434199,,12171258,7412668
2022-07-06,15960,549,859,2009,33890303,12605710,433883,,12171827,7414434
2022-07-07,15667,521,832,1927,33905970,12605942,433571,,12172371,7416108
2022-07-08,17887,555,869,2245,33923857,12606192,433256,,12172936,7418104
2022-07-09,14145,451,597,1847,33938002,12606365,433109,,12173256,7419713
2022-07-10,8749,475,755,1504,33946751,12606592,432828,,12173764,7421011
2022-07-11,4094,199,331,871,33950845,12606526,432693,,12173833,7421662
2022-07-12,12110,412,524,1656,33962955,12606639,432576,,12174063,7423064
2022-07-13,16722,564,773,2144,33979677,12606906,432361,,12174545,7424964
2022-07-14,16861,483,675,2024,33996538,12607083,432158,,12174925,7426748
2022-07-15,28898,599,822,2187,34025436,12607382,431934,,12175448,7428694
2022-07-16,30301,586,773,2328,34055737,12607653,431738,,12175915,7430769
2022-07-17,22933,538,636,1892,34078670,12607954,431637,,12176317,7432467
2022-07-18,11397,189,255,856,34090067,12607875,431566,,12176309,7433101
2022-07-19,28958,592,592,2137,34119025,12608192,431563,,12176629,7435006
2022-07-20,37640,840,923,2594,34156665,12608753,431475,,12177278,7437363
2022-07-21,36358,734,812,2809,34193023,12609199,431390,,12177809,7439931
2022-07-22,35802,824,892,2685,34228825,12609734,431315,,12178419,7442378
2022-07-23,35152,821,912,2835,34263977,12610240,431216,,12179024,7444957
2022-07-24,21737,599,804,1777,34285714,12610576,431008,,12179568,7446509
2022-07-25,11937,308,311,1081,34297651,12610599,431000,,12179599,7447359
2022-07-26,26091,619,604,2212,34323742,12610933,431014,,12179919,7449327
2022-07-27,32471,808,847,2650,34356213,12611483,430973,,12180510,7451766
2022-07-28,31540,724,884,2609,34387753,12611910,430809,,12181101,7454124
2022-07-29,29994,1790,875,2646,34417747,12613408,431720,,12181688,7456520
2022-07-30,25833,2525,747,2436,34443580,12615652,433496,,12182156,7458722
2022-07-31,14312,1068,541,1565,34457892,12616451,434019,,12182432,7460059
2022-08-01,5915,336,223,683,34463807,12616527,434130,,12182397,7460519
2022-08-02,4482,306,138,602,34468289,12616563,434294,,12182269,7460899
2022-08-03,22940,2637,738,2238,34491229,12618924,436189,,12182735,7462901
2022-08-04,22234,2482,679,2133,34513463,12621079,437986,,12183093,7464771
2022-08-05,21797,2755,747,2069,34535260,12623552,439986,,12183566,7466611
2022-08-06,19646,2875,657,1995,34554906,12626115,442198,,12183917,7468347
2022-08-07,12706,2236,620,1422,34567612,12628076,443808,,12184268,7469551
2022-08-08,4766,570,188,603,34572378,12628357,444183,,12184174,7469916
2022-08-09,14014,1468,558,1594,34586392,12629537,445087,,12184450,7471268
2022-08-10,19131,2364,718,1993,34605523,12631627,446731,,12184896,7473032
2022-08-11,17077,2040,717,1858,34622600,12633391,448052,,12185339,7474657
2022-08-12,16985,2048,734,1852,34639585,12635150,449365,,12185785,7476280
2022-08-13,15954,2223,765,1808,34655539,12637088,450821,,12186267,7477847
2022-08-14,9530,1621,619,1086,34665069,12638419,451819,,12186600,7478697
2022-08-15,3873,388,271,479,34668942,12638554,451933,,12186621,7478967
2022-08-16,10807,1073,516,1356,34679749,12639326,452488,,12186838,7480071
2022-08-17,16097,1833,739,1782,34695846,12640871,453581,,12187290,7481617
2022-08-18,14930,1641,748,1693,34710776,12642187,454470,,12187717,7483038
2022-08-19,15317,1846,749,1551,34726093,12643755,455563,,12188192,7484355
2022-08-20,14285,1641,740,1546,34740378,12645104,456458,,12188646,7485662
2022-08-21,9905,1533,660,1165,34750283,12646372,457327,,12189045,7486610
2022-08-22,4163,481,271,561,34754446,12646548,457534,,12189014,7486911
2022-08-23,11135,1248,555,1495,34765581,12647488,458223,,12189265,7488153
2022-08-24,14760,1808,871,2187,34780341,12649024,459160,,12189864,7490108
2022-08-25,14028,1716,780,2123,34794369,12650451,460089,,12190362,7491985
2022-08-26,13929,1688,816,2093,34808298,12651842,460954,,12190888,7493828
2022-08-27,12415,1486,876,1999,34820713,12653000,461558,,12191442,7495560
2022-08-28,7925,1258,622,1398,34828638,12653997,462192,,12191805,7496738
2022-08-29,3399,502,286,684,34832037,12654217,462403,,12191814,7497187
2022-08-30,9906,1169,650,1855,34841943,12655028,462916,,12192112,7498739
2022-08-31,13512,1627,946,2314,34855455,12656364,463593,,12192771,7500810
2022-09-01,12906,1721,912,2141,34868361,12657788,464397,,12193391,7502704
2022-09-02,15044,1616,991,4917,34883405,12659129,465014,,12194115,7507395
2022-09-03,14717,1525,923,5515,34898122,12660371,465613,,12194758,7512675
2022-09-04,8666,1009,676,3237,34906788,12661114,465937,,12195177,7515690
2022-09-05,3555,321,229,1386,34910343,12661168,466026,,12195142,7516853
2022-09-06,2468,157,115,1132,34912811,12661070,466065,,12195005,7517776
2022-09-07,10925,1019,587,3491,34923736,12661790,466493,,12195297,7521015
2022-09-08,10869,1022,527,2790,34934605,12662483,466985,,12195498,7523528
2022-09-09,9582,1011,488,2503,34944187,12663205,467503,,12195702,7525794
2022-09-10,10634,1265,552,3165,34954821,12664192,468209,,12195983,7528725
2022-09-11,9410,982,667,3736,34964231,12664924,468518,,12196406,7532251
2022-09-12,3125,294,204,1079,34967356,12664935,468601,,12196334,7533093
2022-09-13,6017,544,283,1132,34973373,12665192,468853,,12196339,7533982
2022-09-14,14483,798,434,1844,34987856,12665671,469213,,12196458,7535560
2022-09-15,15753,779,409,1532,35003609,12666130,469578,,12196552,7536821
2022-09-16,17759,766,447,1693,35021368,12666635,469891,,12196744,7538292
2022-09-17,17618,722,457,1668,35038986,12667052,470152,,12196900,7539705
2022-09-18,11213,773,451,1688,35050199,12667564,470472,,12197092,7541169
2022-09-19,4979,404,288,670,35055178,12667696,470583,,12197113,7541625
2022-09-20,13770,442,332,947,35068948,12667823,470691,,12197132,7542309
2022-09-21,23038,646,409,1498,35091986,12668158,470923,,12197235,7543551
2022-09-22,22916,636,398,1379,35114902,12668486,471155,,12197331,7544668
2022-09-23,22948,725,602,1418,35137850,12668911,471273,,12197638,7545831
2022-09-24,21691,737,689,1499,35159541,12669353,471317,,12198036,7547094
2022-09-25,11318,595,702,1355,35170859,12669666,471204,,12198462,7548212
2022-09-26,4563,192,218,594,35175422,12669568,471172,,12198396,7548563
2022-09-27,37651,497,365,1497,35213073,12669794,471300,,12198494,7549832
2022-09-28,50968,731,671,1900,35264041,12670256,471359,,12198897,7551506
2022-09-29,48005,637,740,1836,35312046,12670572,471248,,12199324,7553065
2022-09-30,47270,677,806,2003,35359316,12670921,471117,,12199804,7554786
2022-10-01,34449,527,633,1546,35393765,12671139,471009,,12200130,7556065
2022-10-02,24245,736,1028,1711,35418010,12671579,470714,,12200865,7557523
2022-10-03,10869,238,230,612,35428879,12671525,470718,,12200807,7557897
2022-10-04,32196,478,458,1169,35461075,12671684,470734,,12200950,7558790
2022-10-05,40438,631,740,1561,35501513,12671997,470618,,12201379,7560089
2022-10-06,38693,610,653,1567,35540206,12672302,470573,,12201729,7561394
2022-10-07,42241,661,852,1742,35582447,12672616,470374,,12202242,7562835
2022-10-08,37395,783,1144,2120,35619842,12673068,470007,,12203061,7564680
2022-10-09,18813,549,727,1556,35638655,12673339,469826,,12203513,7565998
2022-10-10,6865,168,370,565,35645520,12673207,469621,,12203586,7566301
2022-10-11,4994,124,111,318,35650514,12673035,469629,,12203406,7566380
2022-10-12,35116,579,685,1428,35685630,12673281,469521,,12203760,7567519
2022-10-13,36757,643,858,1620,35722387,12673559,469302,,12204257,7568831
2022-10-14,36977,621,753,1541,35759364,12673848,469167,,12204681,7570092
2022-10-15,35451,714,1013,1627,35794815,12674269,468865,,12205404,7571469
2022-10-16,20663,654,1024,1593,35815478,12674653,468489,,12206164,7572832
2022-10-17,7356,206,477,541,35822834,12674575,468216,,12206359,7573133
2022-10-18,36426,457,500,1398,35859260,12674712,468168,,12206544,7574258
2022-10-19,49902,619,730,1981,35909162,12675030,468054,,12206976,7575989
2022-10-20,51290,622,649,2050,35960452,12675338,468024,,12207314,7577774
2022-10-21,52849,696,619,1935,36013301,12675707,468095,,12207612,7579441
2022-10-22,50864,750,904,2310,36064165,12676128,467936,,12208192,7581478
2022-10-23,30639,571,785,2122,36094804,12676382,467715,,12208667,7583335
2022-10-24,14133,232,271,978,36108937,12676312,467671,,12208641,7584056
2022-10-25,41368,473,489,1818,36150305,12676434,467652,,12208782,7585576
2022-10-26,51658,615,660,2124,36201963,12676715,467603,,12209112,7587420
2022-10-27,50112,605,768,2163,36252075,12676995,467432,,12209563,7589313
2022-10-28,49798,590,675,2095,36301873,12677228,467342,,12209886,7591101
2022-10-29,50598,733,779,2221,36352471,12677612,467292,,12210320,7593021
2022-10-30,28400,661,930,2038,36380871,12677990,467019,,12210971,7594816
2022-10-31,12439,200,234,777,36393310,12677913,466982,,12210931,7595360
2022-11-01,33093,339,197,1220,36426403,12677909,467118,,12210791,7596288
2022-11-02,44288,575,625,1903,36470691,12678152,467064,,12211088,7597892
2022-11-03,44191,541,605,1856,36514882,12678365,466996,,12211369,7599464
2022-11-04,44643,647,528,2029,36559525,12678709,467108,,12211601,7601239
2022-11-05,45205,645,753,2369,36604730,12679054,466997,,12212057,7603342
2022-11-06,26019,558,771,2097,36630749,12679274,466781,,12212493,7605145
2022-11-07,10710,243,235,876,36641459,12679234,466786,,12212448,7605786
2022-11-08,33482,486,397,1585,36674941,12679432,466872,,12212560,7607128
2022-11-09,40530,605,571,1964,36715471,12679722,466904,,12212818,7608824
2022-11-10,39175,620,547,1929,36754646,12680020,466971,,12213049,7610476
2022-11-11,43344,634,641,2209,36797990,12680337,466963,,12213374,7612410
2022-11-12,36848,637,591,2184,36834838,12680650,467001,,12213649,7614311
2022-11-13,24269,558,770,2277,36859107,12680918,466783,,12214135,7616340
2022-11-14,10966,232,204,1024,36870073,12680855,466810,,12214045,7617106
2022-11-15,33624,483,380,1693,36903697,12680974,466907,,12214067,7618492
2022-11-16,43540,798,583,2370,36947237,12681474,467116,,12214358,7620612
2022-11-17,38340,674,647,2241,36985577,12681810,467139,,12214671,7622564
2022-11-18,40623,726,531,2329,37026200,12682192,467330,,12214862,7624594
2022-11-19,39658,1005,1031,3061,37065858,12682853,467298,,12215555,7627352
2022-11-20,22422,659,718,2442,37088280,12683233,467235,,12215998,7629565
2022-11-21,8923,197,193,969,37097203,12683166,467234,,12215932,7630327
2022-11-22,26440,481,369,1513,37123643,12683286,467342,,12215944,7631525
2022-11-23,32086,685,669,2069,37155729,12683642,467356,,12216286,7633315
2022-11-24,31908,664,751,2085,37187637,12683993,467267,,12216726,7635138
2022-11-25,30752,763,828,1952,37218389,12684446,467196,,12217250,7636829
2022-11-26,30289,908,1191,2698,37248678,12685015,466904,,12218111,7639238
2022-11-27,18675,608,944,2087,37267353,12685321,466563,,12218758,7641069
2022-11-28,7538,190,280,787,37274891,12685219,466465,,12218754,7641601
2022-11-29,21023,421,453,1292,37295914,12685311,466429,,12218882,7642615
2022-11-30,27892,643,650,1842,37323806,12685638,466420,,12219218,7644182
2022-12-01,24805,593,682,1692,37348611,12685905,466328,,12219577,7645590
2022-12-02,25056,523,630,1775,37373667,12686102,466215,,12219887,7647083
2022-12-03,25558,588,781,1945,37399225,12686371,466012,,12220359,7648768
2022-12-04,15252,494,606,1702,37414477,12686534,465895,,12220639,7650178
2022-12-05,6877,167,157,746,37421354,12686410,465900,,12220510,7650677
2022-12-06,20350,419,352,1378,37441704,12686462,465962,,12220500,7651743
2022-12-07,24780,553,609,1672,37466484,12686698,465899,,12220799,7653143
2022-12-08,23161,562,521,1764,37489645,12686949,465938,,12221011,7654633
2022-12-09,23326,635,574,1632,37512971,12687256,465995,,12221261,7655991
2022-12-10,22572,507,602,1631,37535543,12687446,465897,,12221549,7657345
2022-12-11,14204,548,786,1566,37549747,12687730,465656,,12222074,7658685
2022-12-12,5506,149,156,595,37555253,12687589,465644,,12221945,7659041
2022-12-13,17796,374,370,1124,37573049,12687643,465646,,12221997,7659893
2022-12-14,21320,511,547,1454,37594369,12687865,465604,,12222261,7661107
2022-12-15,21967,531,603,1579,37616336,12688054,465530,,12222524,7662391
2022-12-16,16287,378,451,1031,37632623,12688109,465454,,12222655,7663150
2022-12-17,18697,556,508,1276,37651320,12688342,465500,,12222842,7664141
2022-12-18,12638,529,794,1306,37663958,12688590,465234,,12223356,7665195
2022-12-19,4585,131,116,449,37668543,12688390,465245,,12223145,7665359
2022-12-20,16207,498,449,1110,37684750,12688573,465287,,12223286,7666203
2022-12-21,18472,541,552,1303,37703222,12688815,465272,,12223543,7667244
2022-12-22,18601,574,591,1747,37721823,12689092,465255,,12223837,7668731
2022-12-23,15645,574,599,1716,37737468,12689311,465225,,12224086,7670152
2022-12-24,5338,224,172,673,37742806,12689227,465276,,12223951,7670548
2022-12-25,2444,153,153,480,37745250,12689075,465267,,12223808,7670764
2022-12-26,262,12,7,48,37745512,12688792,465267,,12223525,7670561
2022-12-27,2097,98,36,307,37747609,12688605,465325,,12223280,7670631
2022-12-28,8320,337,168,975,37755929,12688634,465489,,12223145,7671337
2022-12-29,13165,582,529,1601,37769094,12688891,465538,,12223353,7672656
2022-12-30,15820,666,658,1881,37784914,12689254,465543,,12223711,7674267
2022-12-31,11233,460,387,1355,37796147,12689361,465612,,12223749,7675318
2023-01-01,3907,201,219,563,37800054,12689256,465593,,12223663,7675614
2023-01-02,652,36,14,97,37800706,12689010,465614,,12223396,7675466
2023-01-03,8196,297,151,902,37808902,12689028,465754,,12223274,7676131
2023-01-04,14720,574,547,1546,37823622,12689317,465775,,12223542,7677428
2023-01-05,16118,643,535,1796,37839740,12689661,465875,,12223786,7678965
2023-01-06,18829,715,610,2046,37858569,12690084,465977,,12224107,7680758
2023-01-07,18524,702,639,2056,37877093,12690503,466035,,12224468,7682569
2023-01-08,11612,580,608,1633,37888705,12690831,466004,,12224827,7683982
2023-01-09,5299,215,196,664,37894004,12690744,466021,,12224723,7684390
2023-01-10,12158,415,317,786,37906162,12690859,466117,,12224742,7684915
2023-01-11,15544,458,370,1095,37921706,12690998,466202,,12224796,7685739
2023-01-12,14066,444,409,973,37935772,12691137,466236,,12224901,7686451
2023-01-13,14173,421,344,1041,37949945,12691304,466310,,12224994,7687269
2023-01-14,13387,473,451,1078,37963332,12691472,466327,,12225145,7688078
2023-01-15,9046,460,507,1055,37972378,12691662,466279,,12225383,7688905
2023-01-16,3746,146,130,479,37976124,12691536,466295,,12225241,7689141
2023-01-17,8851,267,179,653,37984975,12691468,466379,,12225089,7689511
2023-01-18,10263,349,272,761,37995238,12691523,466453,,12225070,7690007
2023-01-19,10593,316,318,761,38005831,12691546,466446,,12225100,7690520
2023-01-20,9834,317,272,717,38015665,12691581,466489,,12225092,7690986
2023-01-21,11305,355,398,904,38026970,12691642,466445,,12225197,7691643
2023-01-22,7567,343,405,817,38034537,12691724,466381,,12225343,7692227
2023-01-23,3380,143,131,288,38037917,12691635,466392,,12225243,7692310
2023-01-24,8288,226,166,550,38046205,12691557,466450,,12225107,7692594
2023-01-25,10306,346,297,663,38056511,12691634,466495,,12225139,7693030
2023-01-26,6721,236,203,469,38063232,12691584,466526,,12225058,7693256
2023-01-27,6910,236,197,498,38070142,12691520,466562,,12224958,7693498
2023-01-28,9350,312,339,695,38079492,12691545,466530,,12225015,7693944
2023-01-29,5967,234,341,692,38085459,12691502,466418,,12225084,7694390
2023-01-30,1899,88,79,215,38087358,12691309,466425,,12224884,7694359
2023-01-31,5883,156,150,414,38093241,12691159,466428,,12224731,7694500
2023-02-01,7302,248,249,493,38100543,12691153,466424,,12224729,7694774
2023-02-02,6483,296,239,502,38107026,12691181,466478,,12224703,7695058
2023-02-03,6550,197,194,463,38113576,12691118,466477,,12224641,7695293
2023-02-04,6729,232,306,543,38120305,12691092,466397,,12224695,7695615
2023-02-05,4177,199,291,484,38124482,12691013,466300,,12224713,7695870
2023-02-06,1834,90,98,212,38126316,12690815,466289,,12224526,7695829
2023-02-07,4965,161,182,385,38131281,12690680,466266,,12224414,7695967
2023-02-08,5769,212,206,430,38137050,12690620,466270,,12224350,7696159
2023-02-09,6124,211,244,439,38143174,12690570,466236,,12224334,7696378
2023-02-10,5089,159,207,372,38148263,12690508,466186,,12224322,7696555
2023-02-11,6053,186,260,458,38154316,12690412,466108,,12224304,7696759
2023-02-12,4082,219,342,409,38158398,12690387,465982,,12224405,7696950
2023-02-13,1483,57,87,146,38159881,12690202,465950,,12224252,7696894
2023-02-14,3944,131,179,309,38163825,12690056,465900,,12224156,7696956
2023-02-15,4539,119,191,286,38168364,12689909,465825,,12224084,7697013
2023-02-16,4916,175,284,400,38173280,12689819,465712,,12224107,7697183
2023-02-17,4982,181,210,342,38178262,12689755,465680,,12224075,7697316
2023-02-18,5115,232,294,487,38183377,12689726,465616,,12224110,7697579
2023-02-19,3354,132,244,373,38186731,12689600,465500,,12224100,7697736
2023-02-20,1424,63,54,158,38188155,12689416,465506,,12223910,7697684
2023-02-21,913,26,14,107,38189068,12689207,465516,,12223691,7697579
2023-02-22,4134,131,212,369,38193202,12689087,465429,,12223658,7697742
2023-02-23,4282,162,231,392,38197484,12688987,465353,,12223634,7697906
2023-02-24,3033,136,230,274,38200517,12688876,465255,,12223621,7697958
2023-02-25,5024,213,541,386,38205541,12688846,464926,,12223920,7698140
2023-02-26,3472,146,681,384,38209013,12688738,464387,,12224351,7698309
2023-02-27,1074,37,57,97,38210087,12688548,464364,,12224184,7698215
2023-02-28,2729,99,163,232,38212816,12688368,464298,,12224070,7698196
2023-03-01,3849,137,428,335,38216665,12688218,464003,,12224215,7698273
2023-03-02,4589,158,494,328,38221254,12688084,463658,,12224426,7698358
2023-03-03,4367,159,357,334,38225621,12687984,463458,,12224526,7698457
2023-03-04,4967,208,623,350,38230588,12687927,463040,,12224887,7698578
2023-03-05,2536,110,449,251,38233124,12687758,462700,,12225058,7698582
2023-03-06,1156,48,37,114,38234280,12687562,462709,,12224853,7698484
2023-03-07,3221,87,172,225,38237501,12687350,462621,,12224729,7698457
2023-03-08,4315,133,412,283,38241816,12687207,462340,,12224867,7698491
2023-03-09,4615,173,453,312,38246431,12687111,462055,,12225056,7698573
2023-03-10,3942,100,139,254,38250373,12686983,462014,,12224969,7698631
2023-03-11,4064,140,171,285,38254437,12686904,461980,,12224924,7698723
2023-03-12,2883,109,234,301,38257320,12686761,461846,,12224915,7698801
2023-03-13,862,29,32,106,38258182,12686569,461839,,12224730,7698715
2023-03-14,3078,100,109,257,38261260,12686419,461830,,12224589,7698757
2023-03-15,4099,139,163,312,38265359,12686334,461804,,12224530,7698871
2023-03-16,4020,176,234,277,38269379,12686222,461741,,12224481,7698906
2023-03-17,4290,168,202,310,38273669,12686117,461703,,12224414,7698971
2023-03-18,4361,144,194,298,38278030,12686009,461652,,12224357,7699047
2023-03-19,2722,128,233,256,38280752,12685941,461547,,12224394,7699121
2023-03-20,774,31,19,74,38281526,12685736,461559,,12224177,7698992
2023-03-21,2898,70,86,200,38284424,12685580,461539,,12224041,7698997
2023-03-22,3893,130,132,248,38288317,12685466,461534,,12223932,7699026
2023-03-23,3808,118,171,226,38292125,12685351,461476,,12223875,7699049
2023-03-24,3692,102,115,238,38295817,12685238,461462,,12223776,7699102
2023-03-25,4273,108,171,251,38300090,12685120,461394,,12223726,7699156
2023-03-26,2472,112,212,202,38302562,12685025,461291,,12223734,7699177
2023-03-27,915,48,32,68,38303477,12684891,461307,,12223584,7699085
2023-03-28,3104,86,78,202,38306581,12684748,461309,,12223439,7699085
2023-03-29,4170,127,136,224,38310751,12684636,461297,,12223339,7699098
2023-03-30,3838,108,164,211,38314589,12684519,461240,,12223279,7699103
2023-03-31,3987,140,109,222,38318576,12684428,461270,,12223158,7699125
2023-04-01,4190,135,147,225,38322766,12684346,461257,,12223089,7699161
2023-04-02,2180,58,122,173,38324946,12684160,461189,,12222971,7699120
2023-04-03,781,24,12,53,38325727,12683973,461200,,12222773,7698988
2023-04-04,3417,75,73,168,38329144,12683832,461201,,12222631,7698958
2023-04-05,4368,94,108,249,38333512,12683696,461185,,12222511,7699011
2023-04-06,3701,107,109,190,38337213,12683589,461182,,12222407,7699008
2023-04-07,4597,105,115,242,38341810,12683463,461169,,12222294,7699052
2023-04-08,835,22,11,54,38342645,12683291,461176,,12222115,7698940
2023-04-09,2441,81,103,161,38345086,12683199,461152,,12222047,7698952
2023-04-10,360,9,6,20,38345446,12683013,461149,,12221864,7698810
2023-04-11,2771,34,28,121,38348217,12682804,461154,,12221650,7698711
2023-04-12,6344,104,96,188,38354561,12682708,461160,,12221548,7698728
2023-04-13,6996,105,128,207,38361557,12682594,461134,,12221460,7698739
2023-04-14,6514,88,103,206,38368071,12682472,461116,,12221356,7698765
2023-04-15,6948,107,149,229,38375019,12682369,461072,,12221297,7698812
2023-04-16,3274,83,144,165,38378293,12682235,461009,,12221226,7698789
2023-04-17,864,12,13,49,38379157,12682063,461005,,12221058,7698680
2023-04-18,4781,101,77,160,38383938,12681956,461027,,12220929,7698656
2023-04-19,6566,117,98,177,38390504,12681857,461045,,12220812,7698639
2023-04-20,6382,99,151,210,38396886,12681753,460992,,12220761,7698668
2023-04-21,5773,85,75,133,38402659,12681632,461000,,12220632,7698620
2023-04-22,6387,92,91,180,38409046,12681517,460998,,12220519,7698628
2023-04-23,3299,119,147,170,38412345,12681448,460970,,12220478,7698632
2023-04-24,954,4,12,58,38413299,12681276,460961,,12220315,7698545
2023-04-25,4809,69,70,187,38418108,12681147,460960,,12220187,7698551
2023-04-26,6566,107,93,208,38424674,12681073,460974,,12220099,7698598
2023-04-27,6873,118,152,207,38431547,12680989,460936,,12220053,7698628
2023-04-28,6613,86,86,184,38438160,12680865,460935,,12219930,7698618
2023-04-29,6528,125,109,197,38444688,12680799,460950,,12219849,7698648
2023-04-30,2637,95,127,145,38447325,12680714,460917,,12219797,7698634
2023-05-01,1030,20,17,30,38448355,12680547,460918,,12219629,7698497
2023-05-02,4327,67,55,105,38452682,12680421,460927,,12219494,7698433
2023-05-03,5597,108,107,176,38458279,12680336,460926,,12219410,7698443
2023-05-04,8082,88,85,133,38466361,12680225,460928,,12219297,7698409
2023-05-05,13047,90,98,168,38479408,12680129,460917,,12219212,7698410
2023-05-06,15637,112,96,154,38495045,12680076,460933,,12219143,7698409
2023-05-07,6060,56,95,106,38501105,12679958,460890,,12219068,7698361
2023-05-08,2165,16,4,37,38503270,12679809,460900,,12218909,7698251
2023-05-09,12558,55,49,129,38515828,12679686,460903,,12218783,7698229
2023-05-10,14757,71,78,157,38530585,12679580,460894,,12218686,7698229
2023-05-11,13356,77,71,154,38543941,12679503,460899,,12218604,7698252
2023-05-12,13480,86,79,176,38557421,12679425,460904,,12218521,7698275
2023-05-13,11439,80,74,146,38568860,12679308,460906,,12218402,7698247
2023-05-14,4183,67,95,93,38573043,12679216,460877,,12218339,7698203
2023-05-15,1053,9,6,38,38574096,12679070,460876,,12218194,7698111
2023-05-16,8944,56,47,93,38583040,12678958,460881,,12218077,7698059
2023-05-17,11098,99,83,141,38594138,12678880,460895,,12217985,7698037
2023-05-18,10829,82,69,144,38604967,12678780,460908,,12217872,7698017
2023-05-19,10406,95,96,151,38615373,12678695,460905,,12217790,7698006
2023-05-20,9352,90,88,163,38624725,12678599,460906,,12217693,7697997
2023-05-21,3083,48,86,95,38627808,12678503,460867,,12217636,7697959
2023-05-22,970,15,11,29,38628778,12678365,460871,,12217494,7697851
2023-05-23,752,7,3,16,38629530,12678221,460875,,12217346,7697737
2023-05-24,8013,57,80,105,38637543,12678100,460851,,12217249,7697679
2023-05-25,9342,75,93,162,38646885,12678020,460831,,12217189,7697703
2023-05-26,7990,70,69,121,38654875,12677951,460832,,12217119,7697700
2023-05-27,8126,108,76,125,38663001,12677919,460862,,12217057,7697704
2023-05-28,2906,56,73,101,38665907,12677844,460843,,12217001,7697685
2023-05-29,971,13,11,30,38666878,12677725,460843,,12216882,7697595
2023-05-30,5924,60,49,112,38672802,12677622,460853,,12216769,7697559
2023-05-31,8146,91,94,122,38680948,12677566,460848,,12216718,7697552
2023-06-01,7267,73,95,118,38688215,12677487,460824,,12216663,7697537
2023-06-02,6317,49,48,121,38694532,12677399,460824,,12216575,7697536
2023-06-03,5473,71,59,121,38700005,12677338,460836,,12216502,7697540
2023-06-04,2048,47,78,77,38702053,12677288,460804,,12216484,7697528
2023-06-05,598,12,6,17,38702651,12677188,460810,,12216378,7697444
2023-06-06,4444,38,38,78,38707095,12677110,460807,,12216303,7697415
2023-06-07,5766,63,66,119,38712861,12677067,460801,,12216266,7697441
2023-06-08,5660,57,68,111,38718521,12677037,460789,,12216248,7697479
2023-06-09,6156,76,81,121,38724677,12677017,460784,,12216233,7697517
2023-06-10,5249,73,94,113,38729926,12676988,460763,,12216225,7697536
2023-06-11,2000,56,62,105,38731926,12676966,460755,,12216211,7697569
2023-06-12,670,11,7,38,38732596,12676915,460759,,12216156,7697552
2023-06-13,4156,57,58,100,38736752,12676882,460757,,12216125,7697574
2023-06-14,5445,76,82,116,38742197,12676870,460750,,12216120,7697618
2023-06-15,5024,70,73,118,38747221,12676871,460747,,12216124,7697672
2023-06-16,5526,75,62,111,38752747,12676894,460759,,12216135,7697737
2023-06-17,3970,64,60,107,38756717,12676924,460763,,12216161,7697815
2023-06-18,1546,44,61,92,38758263,12676937,460746,,12216191,7697880
2023-06-19,349,7,2,11,38758612,12676926,460751,,12216175,7697876
2023-06-20,3078,52,42,86,38761690,12676972,460761,,12216211,7697956
2023-06-21,3450,43,56,81,38765140,12677015,460748,,12216267,7698037
2023-06-22,3683,77,73,108,38768823,12677092,460752,,12216340,7698145
